ሐልዮ	ኀልዮ 	
ሓያ	ኻያ 	
ሕብር	ኅብር	
መሣሣት 	መሳሳት 	
መርሕብ 	መርኅብ 	
መንጎል 	መንጐል 	
መአት 	መዓት 	
ምሁር 	ምሑር 	
ሠለቀ 	ሰለቀ 	
ሠመረ 	ሰመረ 	
ሠማ 	ሰማ 	
ሠረቀ 	ሰረቀ 	
ሠረበ 	ሰረበ 	
ሠረየ 	ሰረየ 	
ሠረገ 	ሰረገ 	
ሠራን 	ሰራን 	
ሠራዊት 	ሰራዊት 	
ሠባ 	ሰባ 	
ሠነየ 	ሰነየ 	
ሠየመ 	ሰየመ 	
ሣለ 	ሳለ 	
ሣቅ 	ሳቅ 	
ሣይ 	ሳይ 	
ሣጠራ 	ሳጠራ 	
ሣጥን 	ሳጥን 	
ሥብሐት 	ስብሐት 	
ሥንበጣ 	ስንበጣ 	
ሥንጠራ 	ስንጠራ 	
ሥንጠቃ 	ስንጠቃ 	
ሥንጥር 	ስንጥር 	
ቀረጸ 	ቀረፀ 	
ቅሥም 	ቅስም 	
ብልኅ 	ብልኽ 	
ብሥል 	ብስል 	
ተሠቃይ 	ተሰቃይ 	
ትስብእት 	ትስብዕት 	
አለለ 	ዐለለ 	
አለት 	ዐለት 	
አላቢ 	ዐላቢ 	
አልቅት 	ዐልቅት 	
አልባ 	ዐልባ 	
አልቦ 	ዐላባ 	
አመመ 	ዐመመ 	
አመተ  	ዐመተ 	ዓመተ 
አማች	ዐማች	
አማጭ 	ዐማጭ 	
አምና  	ዓምና 	
አሠመረ 	አሰመረ 	
አሠር 	ዐሠር 	
አሠቃይ 	አሰቃይ 	
አሣሽ  	ዐሣሽ 	ዓሣሽ 
አረረ 	ዐረረ 	
አረገ 	ዐረገ 	
አራሪ 	ዐራሪ 	
አራራ 	ዐራራ 	
አራሽ 	ዐራሽ 	
አራቂ 	ዐራቂ 	
አራቢ 	ዐራቢ 	
አራጊ 	ዐራጊ 	
አርባ 	ዐርባ 	
አሰላ 	ዐሰላ 	
አሰረ 	ዐሠረ 	
አሳማ	ዐሣማ 	ዓሣማ 
አሳራችን 	ዐሳራችን 	
አሻሚ 	ዐሻሚ 	
አሽተኽ 	ዐሽተኽ 	
አበላ 	ዐበላ 	
አበዛ 	ዐበዛ 	
አባ 	ዐባ 	
አባሽ 	ዐባሽ 	
አባይ 	ዐባይ 	
አተላ 	ዐተላ 	
አተተ 	ዐተተ 	
አከለ 	ዐከለ 	
አዋቂ 	ዐዋቂ 	
አዘዘ 	ዐዘዘ 	
አዛባ 	ዐዛባ 	
አዞ 	ዐዞ 	
አያት 	ዐያት 	
አደመ 	ዐደመ 	
አደራ 	ዐደራ 	
አደገ 	ዐደገ 	
አደፈ 	ዐደፈ 	
አዳይ 	ዐዳይ 	
አጋች 	ዐጋች 	
አጋይ 	ዐጋይ 	
አጠራ 	ዐጠራ 	
አጠባ 	ዐጠባ 	
አጠና 	ዐጠና 	
አጣሪ 	ዐጣሪ 	
አፍላ 	ዐፍላ 	
አፍራ 	ዐፍራ 	
አፍሶ 	ዐፍሦ 	
እልፍ 	ዕልፍ 	
እሩቅ 	ዕሩቅ 	
እክል 	ዕክል 	
እዝ 	ዕዝ 	
እዝነ-ልቦና 	ዕዝነ-ልቦና 	
ከሠሠ 	ከሰሰ 	
ከሣሽ 	ከሳሽ 	
ከሣች 	ከሳች 	
ውሑዳን 	ውኁዳን 	
ውሕደት 	ውኅደት 	
ዐላቦ 	ዐልቦ 	
ግእዝ	ግዕዝ 	
ፈሣ 	ፈሳ 	
