#Amharic Name	Latin Transcription	Alternative Amharic Spelling
ሀልዮ	Hälleyo	
ሀመልማል	Hämälmal	
ሀመረ	Hämärä	
ሀሙሲት	Hämusit	
ሀሙስ	Hämus	
ሀሙድ	Hämud	
ሀሚድ	Hämid	
ሀማሴን	Hämasén	
ሀሜት	Hämét	
ሀምሌ	Hämlé	ሐምሌ
ሀምሌው	Hämléw	
ሀምራዊ	Hämrawi	
ሀምስ	Hämes	
ሀምዛ	Hämza	
ሀረር	Härär	ሐረር
ሀረገ	Härägä-	ሐረገ
ሀረጉ	Härägu	ሐረጉ
ሀረግ	Häräg	ሐረግ
ሀረግ ሬሳ	HärägRésa	ሐረግ ሬሳ
ሀረጐት	Härägot	ሀረጎት
ሀረጓ	Härägʷ	ሐረጓ
ሀሩር	Härur	ሐሩር
ሀራ	Hära	
ሀራማት	Häramat	
ሀራዋጫ	Härawač̣a	
ሀራጅ	Härraj	
ሀር	Härr	
ሀርቤ	Härbé	
ሀሰተኛ	Hässätänna	
ሀሰት	Hässät	
ሀሰን	Häsän	
ሀሳሳውያን	Hässabaweyan	
ሀሳባዊ	Hässabawi	
ሀሳባዊነት	Hässabawinnät	
ሀሳባውያን	Hässabaweyan	
ሀሳብ	Hässab	
ሀሳዊ	Hässawi	
ሀሴት	Hässét	
ሀሺም	Häsim	
ሀቀኛ	Häqqäñña	
ሀቂቃ	Häqiqa	
ሀቅ	Häqq	
ሀበሻ	Häbäša	
ሀቢብ	Häbib	
ሀብለ	Häblä-	
ሀብል	Häbl	
ሀብተ	Häbtä-	
ሀብቱ	Häbtu	
ሀብታሙ	Häbtamu	
ሀብታም	Häbtam	
ሀብታይ	Häbtay	
ሀብቴ	Häbté	
ሀብት	Häbt	
ሀብትህ	Häbteh	
ሀቲታ	Hätita	
ሀቲታዊ	Hätitawi	
ሀቲት	Hätit	
ሀች	Häčč	
ሀና	Hänna	
ሀኪም	Häkim	
ሀኪተኛ	Häkétäñña	
ሀኬተኛ	Häkétäñña	
ሀኬት	Häkét	
ሀዋ	Häwwa	
ሀዋላ	Häwwala	
ሀዋሪያ	Häwareya	ሐዋሪያ
ሀዋሪያት	Häwareyat	ሐዋሪያት
ሀዋርያ	Häwareya	ሐዋርያ
ሀዋርያት	Häwareyat	ሐዋርያት
ሀዋዝ	Häwaz	
ሀውልት	Häwet	
ሀይሎም	Häylom	
ሀይመቴ	Häymäté	
ሀይቅ	Häyq	
ሀይኮታ	Häykota	
ሀይዞ	Häyzo	
ሀይደር	Häydär	
ሀደራ	Hädära	
ሀደሮ	Hädäro	
ሀዲስ	Häddis	
ሀዲድ	Hädid	
ሀዳር	Hädar	
ሀዳስ	Häddas	
ሀድያ	Hädeyya	
ሀድጉ	Hädgu	
ሀድጐ	Hädgo	
ሀገረ	Hägärä-	ሐረግ
ሀገር	Hägär	
ሀገርሽ	Hägäreš	
ሀጋይ	Hägay	
ሀጐሳ	Hägosa	ሐጐሳ
ሀጐስ	Hägos	ሐጐስ
ሀጢአተኛ	Haṭi'ätäñña	
ሀጢአት	Häṭi'ät	
ሀጥአን	Häṭe'än	
ሁለላ	Huläla	
ሁለመና	Hullämäna	
ሁለተኛ	Hulättäñña	
ሁለት	Hulätt	
ሁለንተና	Hulläntäna	
ሁለንተኛ	Hulläntäna	
ሁሉ አገርሽ	HulluÄgäreš	
ሁሉቃ	Huluqa	
ሁላላ	Hulala	
ሁመራ	Humära	
ሁምና	Humna	
ሁረታ	Huräta	
ሁሩሙ	Hurumu	
ሁሩታ	Hurruta	
ሁሪሳ	Hurrisa	
ሁር	Hurr	
ሁሴን	Husén	
ሁነኛ	Hunäñña	
ሁነኛው	Hunäññaw	
ሁኒማት	Hunimat	
ሁኔማት	Hunimat	
ሁኔታ	Hunéta	
ሁኔታዎች	Hunétawočč	
ሁንዴ	Hundé	
ሁከት	Hukät	
ሁክት	Hukät	
ሁዳዴ	Hudadé	
ሁዳድ	Hudad	
ሂሩት	Hirut	
ሂርና	Hirna	
ሂርጳ	Hirp̣a	
ሂስ	His	
ሂቡ	Hibu	
ሂደት	Hidät	
ሃሊ	Hallé	
ሃሌ	Hallé	
ሃሌ ሉያ	Hallé Luya	
ሃምሳ	Hamsa	
ሃሳባዊ	Hässabawi	
ሃያ	Haya	
ሃያላን	Hayyalan	
ሃይለ	Haylä-	
ሃይለኛ	Hayläñña	
ሃይሉ	Haylu	
ሃይላኛ	Hayläñña	
ሃይሌ	Haylé	
ሃይል	Hayl	
ሃይሎም	Haylom	
ሃይመቴ	Haymäté	
ሃይማኖተ	Haymanotä-	
ሃይማኖት	Haymanot	
ሄለና	Héläna	
ሄለን	Hélän	
ሄርጌይ	Hérgéy	
ሄኖክ	Hénok	
ሄዋን	Héwan	
ህሊና	Hellina	
ህሊናዊ	Hellinawi	
ህሊናውያን	Hellinaweyan	
ህላዊ	Hellawi	
ህላዌ	Hellawé	
ህልሽት	Beleššet	
ህልውና	Hellewenna	
ህማማት	Hemamat	
ህሩይ	Heruy	
ህርጊጐ	Hergiggo	
ህቡእ	Hebu'e	
ህብረ	Hebrä	
ህብረተ ሰብ	Hebrätä-Säb	ሕብረተ ሰብ
ህብረተ ሰብአዊ	Hebrätä-Säb'äwi	ሕብረተ ሰብአዊ
ህብረተ ሰብአዊት	Hebrätä-Säb'äwit	ሕብረተ ሰብአዊት
ህብረተ ሰብአዊንት	Hebrätä-Säb'äwinnät	ሕብረተ ሰብአዊንት
ህብረተ ስብአዊነት	Hebrätä-Säb'äwinnät	ሕብረተ ስብአዊነት
ህብረት	Hebrät	ሕብረት
ህብስተ	Hebestä-	
ህብስቴ	Hebesté	
ህብስት	Hebest	
ህትመት	Hetmät	
ህንደኬ	Hendäké	
ህንጻ	Henṣa	
ህክምና	Hekmenna	
ህዋ	Hewa	
ህዋሳታዊ	Hewasatawi	
ህዋሳት	Hewasat	
ህዋስ	Hewas	
ህዝቅኤል	Hezqe'él	
ህዝቅያስ	Hezqeyas	
ህዝባዊ	Hezbawi	
ህዝባዊት	Hezbawit	
ህዝብ	Hezb	
ህያብ	Heyab	
ህይወት	Heywät	
ህደጐ	Hedägo	
ህዳር	Hedar	
ህዳግ	Heddag	
ህዳጐ	Hedago	ህዳጎ
ህድረት	Hedrät	
ህድአት	Hed'ät	
ህገ	Heggä-	
ህጋዊ	Heggawi	
ህግ	Hegg	
ህግጋት	Heggegat	
ህጸጽ	Heṣaṣ	
ህጻናት	Heṣanat	
ህጻን	Heṣan	
ህጻጽ	Heṣaṣ	
ሆሄ	Hohé	
ሆሄያት	Hohéyat	
ሆለታ	Holäta	
ሆምጣጤ	Homṭaṭé	
ሆራ	Hora	
ሆሳ	Hosa	
ሆሳእና	Hosa'ena	
ሆቴሌች	Hotéločč	
ሆቴሎች	Hotéločč	
ሆይ	Hoy	
ሆደ ባሻ	Hodä-Bašša	
ሆጃ	Hoja	
ሆጄሌ	Hojélé	
ሆጤ	Hoṭé	
ለሀጭ	Lähäč̣	
ለሆሳስ	Lähosas	
ለሆቴ	Lähoté	
ለማ	Lämma	
ለማሽ	Lämmaš	
ለማኝ	Lämmaññ	
ለሜሳ	Lämméssa	
ለሜቻ	Lämméčča	
ለምለም	Lämläm	
ለምባዳ	Lämbadda	
ለምድ	Lämd	
ለምጻም	Lämṣam	
ለምጽ	Lämṣ	
ለሳኝ	Lässañ	
ለሴ	Lässé	
ለስላሳ	Läslassa	
ለቀማ	Läqäma	
ለቅሶ	Läqso	
ለበስ	Läbbäs	
ለበቅ	Läbäq	
ለባሲ	Läbasi	
ለባዊት	Läbbawit	
ለቤ	Läbbé	
ለብላቢ	Läblabi	
ለተ	Lätä	
ለቱ	Lätu	
ለታ	Läta	
ለታይ	Lätay	
ለንቋጣ	Länqʷṭa	
ለንጨጭ	Länč̣äč̣	
ለከት	Läkkät	
ለዘብተኛ	Läzzäbtäñña	
ለዛ	Läzza	
ለይስሙላ	Lä-Yesmulla	
ለይኩን	Läyekun	
ለገሰ	Läggäsä	
ለገሰች	Läggäsäčč	
ለገደች	Läggäsäčč	
ለጊ	Läggi	
ለጋ	Läga	
ለጋስ	Läggas	
ለግላጋ	Läglagga	
ለጥ ይበሉ	Läṭṭ-Yebälu	
ለፍቶ አደር	Läfto-Äddär	
ለፍቶ አዳሪ	Läfto-Ädari	
ለፍዳዳ	Läfdadda	
ሉሉ	Lulu	
ሉሊተ	Lulit	
ሉሊቱ	Lulit	
ሉሊት	Lulit	
ሉላ	Lula	
ሉላደይ	Luladäy	
ሉላዳይ	Luladäy	
ሉሌ	Lulé	
ሉል	Lul	
ሉቦ	Lubo	
ሉካንዳ	Lukanda	
ሉክ	Luk	
ሉጫ	Luč̣č̣a	
ሊሙ	Limmu	
ሊማሊሞ	Limalimo	
ሊስትሮ	Listero	
ሊሻን	Lišan	
ሊቀ	Liqä-	
ሊቃውንት	Liqawent	
ሊቅ	Liq	
ሊባቦ	Libabo	
ሊጋባ	Ligaba	
ላሁጫ	Lahuč̣č̣a	
ላሊበላ	Lalibäla	
ላል ይበላ	Lal-Yebäla	
ላሎ	Lalo	
ላሜዳ	Laméda	
ላም	Lam	
ላም እነት	LamEnät	
ላምሮት	Lamrot	
ላምባ	Lamba	
ላምባ ዲና	LambaDina	
ላምፋ	Lamfa	
ላስቲክ	Lastik	
ላቀ	Laqä	
ላቀህ	Laqäh	
ላቀች	Laqäčč	
ላቀው	Laqäw	
ላብ አደር	Lab Äddär	
ላንቲካ	Lantika	
ላንጋኖ	Langano	
ላንፊያ	Lanfiya	
ላእላይ	La'elay	ላዕላይ
ላእከ	La'ekä	ላዕከ
ላኪ	Laki	
ላዛ	Laza	
ላይዳ	Layda	
ላዳን	Ladan	
ላጲሶ	Lap̣p̣iso	
ላፒሶ	Lappiso	
ሌማት	Lémat	
ሌባ	Léba	
ሌንጫ	Lénč̣a	
ሌዊ	Léwi	
ሌዋውያን	Léwaweyan	
ሌጣ	Léṭa	
ሌጦ	Léṭo	
ልመነው	Lemänäw	
ልመንህ	Lemäneh	
ልሙጥ	Lemuṭṭ	
ልማት	Lemat	
ልማድ	Lemad	
ልምጭ	Lemmeč̣č̣	
ልሳነ	Lessanä-	
ልሳኑ	Lessanu	
ልሳን	Lessan	
ልቃሚ	Leqqami	
ልቃቂት	Leqqaqit	
ልቅ	Leqq	
ልበ	Lebbä-	
ልቡና	Lebbuna	
ልቡናዊ	Lebbunawi	
ልባስ	Lebas	
ልባብ	Lebab	
ልባንጃ	Lebanjja	
ልባዊ	Lebbawi	
ልቤ	Lebbé	
ልብሰ ተክህኖ	Lebsä-Täkheno	
ልብስ ሰፊ	LebsSäfi	
ልብነ ድንግል	Lebnä-Dengel	
ልት	Lett	
ልትት	Lett	
ልኡል	Le'ul	ልዑል
ልኡካን	Le'ukan	ልዑካን
ልእልት	Le'elt	ልዕልት
ልእልና	Le'elenna	ልዕልና
ልኬ	Lekké	
ልክ የለሽ	Lekk-Yälläš	
ልኳንዳ	Lekʷnda	
ልዋጭ	Lewwač̣	
ልውውጥ	Lewewweṭ	
ልዝብ	Lezzeb	
ልየው	Leyäw	
ልዩ	Leyyu	
ልይህ	Leyeh	
ልደታ	Ledäta	
ልደት	Ledät	
ልጃገረድ	Lejagäräd	
ልጅ	Lej	
ልጅቱ	Lejetu	
ልጅነት	Lejennät	
ልጆች	Lejočč	
ልገሳ	Leggäsa	
ልግመኛ	Legmäñña	
ልጓም	Legʷm	
ልጣጭ	Leṭṭač̣	
ልጨኛ	Leč̣č̣äñña	
ልፈፋ	Leffäfa	
ልፊያ	Leffiya	
ልፋት	Lefat	
ልፍስፍስ	Lefesfes	
ልፍቶ አደር	Läfto-Äddär	
ሎሌ	Lolé	
ሎቲ	Lotti	
ሎጊያ	Logiya	
መሀለቅ	Mähälläq	
መሀሉ	Mähälu	
መሀላ	Mähälla	
መሀል	Mähäl	
መሀል ሜዳ	MähälMéda	
መሀል ሰፋሪ	MähälSäfari	
መሀመድ	Mähämmäd	
መሀሙዲ	Mähämmudé	
መሀሙዴ	Mähämmudé	
መሀረኝ	Mähäräññ	
መሀሪ	Mähäri	
መሀንዲስ	Mähändis	
መሀከለኛ	Mähäkkäläñña	
መሀከል	Mähäkkäl	
መሃይም	Mähayyem	
መሄኦ	Mähé'o	
መህረተ አብ	Mehrätä-Äb	
መህን	Mähn	
መሆዶ	Mähodo	
መለሎ	Mälälo	
መለሰ	Mälläsä	
መለሰች	Mälläsäčč	
መለሱ	Mälläsu	
መለስ	Mälläs	
መለስተኛ	Mällästäñña	
መለከት	Mäläkät	
መለኪያ	Mäläkkiya	
መለኮታዊ	Mäläkotawi	
መለኮታዊነት	Mäläkotawinnät	
መለኮታውያን	Mäläkotaweyan	
መለኮት	Mäläkot	
መለዋወጫ	Mäläwawäč̣a	
መለያ	Mälläya	
መለዮ	Mälläyyo	
መላ ምት	MälaMet	
መላሂ	Mälahi	
መላላጫ	Mällalač̣a	
መላሰኛ	Mälasäñña	
መላተ ወርቅ	Mäla-Ṭa-Wärq	
መላእክት	Mäla'ekt	
መላኩ	Mälaku	
መላክ ሰገድ	MälakSäggäd	
መላክ ነሽ	MälakNäš	
መላጊያ	Mälagiya	
መላጣ	Mälaṭa	
መልህቅ	Mälheq	
መልአከ	Mäl'äkä-	
መልአክ	Mäle'äk	
መልእል	Mäle'el	
መልእክተኛ	Mäle'ektäñña	
መልእክት	Mäle'ekt	
መልከ	Mälkä-	
መልከ ጼዴቅ	Mälkä-Ṣédéq	
መልከኛ	Mälkäñña	
መልከአ ምድር	Mälk'äMeder	
መልካ	Mälka	
መልካ ቦሎ	MälkaBollo	
መልካሙ	Mälkamu	
መልካሜ	Mälkamé	
መልካም	Mälkam	
መልካም ነሽ	MälkamNäš	
መልካሟ	Mälkamʷ	
መልካረፉ	Mälkaräru	
መልካሰዲ	Mälkasädi	
መልካሳ	Mälkasa	
መልኬ	Mälké	
መልክ	Mälk	
መልክአ ምድር	Mälke'äMeder	
መሎቲ	Mälotti	
መመህራን	Mämheran	
መመሪያ	Mämmäriya	
መመኪያ	Mämmäkiya	
መመዘኛ	Mämäzzäñña	
መመዝገቢያ	Mämäzgäbiya	
መመደቢያ	Mämäddäbiya	
መማክርት	Mämakert	
መምህራን	Mämheran	
መምህር	Mämher	
መምሪያ	Mämriya	
መምቻ	Mämča	
መረሬ	Märäré	
መረርቱ	Märärtu	
መረቅ	Märäq	
መረባ	Märäbba	
መረብ	Märäb	
መረን	Märän	
መረዋ	Märäwwa	
መረጃ	Märräja	
መረግድ	Märägd	
መሪ	Märi	
መራ	Märra	
መራሄ	Märahé	
መራራ	Märara	
መራቤቴ	Märrabété	
መራዊ	Märawi	
መራው	Märraw	
መራጃ	Märraja	
መሬት	Märét	
መርሃ	Märha-	
መርህ	Märh	
መርሆ	Märho	
መርሞሌ	Bärmolé	
መርሲ	Märsé	
መርሳ	Märsa	
መርሴ	Märsé	
መርስኤ	Märse'é	
መርሶ	Märso	
መርሻ	Märša	
መርቆሬዎስ	Märqoréwos	
መርቆርዮስ	Märqoreyos	
መርኔ	Märrené	
መርአዊ	Mär'äwi	መርዓዊ
መርእድ	Mär'ed	መርዕድ
መርከበኛ	Märkäbäñña	
መርከብ	Märkäb	
መርከቦች	Märkäbočč	
መርዘኛ	Märzäñña	
መርዝ	März	
መርዳሳ	Märdasa	
መርዶ	Märdo	
መርዶፋ	Märdofa	
መርገጫ	Märgäč̣a	
መርገፍ	Märgäf	
መርጊያ	Märgiya	
መርጋ	Märga	
መርግ	Märg	
መርጡለ	Märtulä-	
መርጡለ ማርያም	Märṭulä-Maryam	
መርፌ	Märfé	
መሮ	Märo	
መሰለ	Mässäl	
መሰለች	Mässäläčč	
መሰሉ	Mässälu	
መሰላል	Mäsälal	
መሰል	Mässäl	
መሰረተ	Mäsärätä-	
መሰረታዊ	Mäsärätawi	
መሰረት	Mäsärät	
መሰሪ	Mäsärri	
መሰርሰሪያ	Mäsärsäriya	
መሰቅሰቂያ	Mäsäqsäqiya	
መሰብሰቢያ	Mässäbsäbiya	
መሰናክል	Mäsänakel	
መሰናዶ	Mässänado	
መሰንቆ	Mäsänqo	
መሰዊያ	Mäsäwwiya	
መሱድ	Mäsud	
መሲህ	Mäsih	
መሳሪያ	Mässariya	
መሳይ	Mäsay	
መሳደኛ	Mäsaddäñña	
መሳፍቻ	Mässafečča	
መሳፍንታዊ	Mäsafentawi	
መሳፍንት	Mäsafent	
መስል	Mässäl	
መስመር	Mäsmär	
መስሪ	Mäsärri	
መስሪያ	Mäsriya	
መስራች	Mäsrač	
መስቀሌ	Mäsqälé	
መስቀል	Mäsqäl	
መስቀያ	Mäsqäya	
መስቃ	Mäsqa	
መስተንግዶ	Mästängedo	
መስተዋት	Mästäwat	
መስተዋድድ	Mästäwaded	
መስተጻምር	Mästäṣamer	
መስኖ	Mäsno	
መስከረም	Mäskäräm	
መስክ	Mäsk	
መስዋእት	Mäswa'et	
መስጊድ	Mäsgid	
መስፈሪያ	Mäsfäriya	
መስፊያ	Mäsfiya	
መስፍነ	Mäsfenä-	
መስፍን	Mäsfen	
መስፍያ	Mäsfiya	
መሶበ	Mäsobä	
መሶብ	Mäsob	
መሸሻ	Mäšäša	
መሸተኛ	Mäšätäñña	
መሸታ	Mäšäta	
መሸጋገሪያ	Mäššägagäriya	
መሽከርከሪያ	Mäškärkäriya	
መሿለኪያ	Mäššʷläkiya	
መቀሌ	Mäqälé	
መቀመቅ	Mäqämäq	
መቀመጫ	Mäqqämäč̣a	
መቀራቅርት	Mäqäraqert	
መቀበያ	Mäqqäbäya	
መቀናጆ	Mäqqänajo	
መቀንጠቢያ	Mäqäntäbiya	
መቀጣጫ	Mäqqäṭač̣a	
መቀጫ	Mäqqäč̣a	
መቁረርት	Mäqurärt	
መቁረጫ	Mäquräč̣a	
መቁነን	Mäqunän	
መቁጠሪያ	Mäquṭäriya	
መቂ	Mäqi	
መቂናት	Mäqinat	
መቂናጥ	Mäqinat	
መቃ	Mäqa	
መቃ ልቅም	MäqaLeqem	
መቃርዮስ	Mäqareyos	
መቃብር	Mäqaber	
መቃን	Mäqan	
መቃጥን	Mäqaṭen	
መቅመቆ	Mäqmäqqo	
መቅረዝ	Mäqräz	
መቅረጅ	Mäqräj	
መቅሰፍት	Mäqsäft	
መቅን	Mäqen	
መቅዘፊያ	Mäqzäfiya	
መቅደሴ	Mäqdäsé	
መቅደስ	Mäqdäs	
መቅድም	Mäqdem	
መቆሚያ	Mäqomiya	
መቆሚያ  	Mäqomiya	
መቆስቆሻ	Mäqosqoša	
መቆናቁን	Mäqonaqun	
መቆንጠጫ	Mäqonṭäča	
መቆያ	Mäqoyya	
መቆጣጠሪያ	Mäqqoṭaṭäriya	
መቆፈሪያ	Mäqoffäriya	
መቋቋሚያ	Mäqqʷqʷmiya	
መቋደሻ	Mäqqʷdäša	
መበለት	Mäbällät	
መባለግ	Mäbaläg	
መባቻ	Mäbača	
መብረቅ	Mäbräq	
መብራህቱ	Mäbrahetu	
መብራቱ	Mäbratu	
መብራቴ	Mäbraté	
መብራት	Mäbrat	
መብርሃቱ	Mäbrahetu	
መብት	Mäbet	
መብኣ	Mäb'a	
መተሀራ	Mätähära	
መተላለፊያ	Mättälaläfiya	
መተመኛ	Mätämmäñña	
መተማመኛ	Mättämamäñña	
መተርኮሻ	Mätärkoša	
መተተኛ	Mätätäñña	
መተት	Mätät	
መተከል	Mätäkkäl	
መተያያ	Mättäyaya	
መተዳደሪያ	Mättädadäriya	
መቱ	Mättu	
መታረሪያ	Mättaräriya	
መታሰቢያ	Mättasäbiya	
መታጠቢያ	Mättaṭäbiya	
መታጠፊያ	Mättaṭäfiya	
መታፈሪያ	Mättafäriya	
መት	Mät	
መትረየስ	Mäträyyäs	
መቶ	Mäto	
መቸንከሪያ	Mäčänkäriya	
መቻል	Mäčal	
መቻራ	Mäččara	
መቻሬ	Mäččaré	
መነሻ	Männäša	
መነሾ	Männäšo	
መነን	Mänän	
መነኩሴ	Mänäkusé	
መነኮሳት	Mänäkosat	
መነጋገሪያ	Männägagäriya	
መነጽር	Mänäṣṣer	
መና	Männa	
መናብ	Mänab	
መናገሻ	Männagäša	
መናፈሻ	Männafäša	
መናፍስት	Mänafest	
መናፍቅ	Mänafeq	
መን	Män	
መንሱር	Mänsur	
መንሽ	Mänš	
መንቀል	Mänqäl	
መንቀሳቀሻ	Mänqäsaqäša	
መንበረ	Mänbärä-	
መንበር	Mänbär	
መንታ	Mänta	
መንትያ	Mänteyya	
መንእስ	Män'es	
መንክር	Mänker	
መንክሮስ	Mänkeros	
መንኮራኩር	Mänkorakur	
መንደረተኛ	Mändärätäñña	
መንደረታኛ	Mändärätäñña	
መንደረኛ	Mändäräñña	
መንደሪን	Mändärin	
መንደር	Mändär	
መንደርደሪያ	Mändärdäriya	
መንደሮች	Mändäročč	
መንደፈራ	Mändäfära	
መንዲ	Mändi	
መንዲል	Mändil	
መንዲስ	Mändis	
መንዲዳ	Mändidda	
መንገሻ	Mängäša	
መንገደኛ	Mängädäñña	
መንገድ	Mängäd	
መንጋ	Mänga	
መንጋጋ	Mängaga	
መንግስተ	Mängestä-	
መንግስቱ	Mängestu	
መንግስታት	Mängestat	
መንግስታዊ	Mängestawi	
መንግስቴ	Mängesté	
መንግስት	Mängest	
መንጐል	Mängol	
መንጠቆ	Mänṭäqqo	
መንጦላእት	Mänṭola'et	
መንፈሳዊ	Mänfäsawi	
መንፈስ	Mänfäs	
መንፈቅ	Mänfäq	
መንፈያ	Mänfiya	
መንፊያ	Mänfiya	
መኖ	Männo	
መኖሪያ	Männoriya	
መአሾ	Mä'äšo	
መኣተኛ	Mä'atäñña	መዓተኛ
መኣት	Mä'at	መዓት
መኣዊ	Mä'awi	መአዊ
መኣዛ	Mä'aza	መዓዛ
መኣዛሽ	Mä'azaš	መዓዛሽ
መከላከያ	Mäkkälakäya	
መከር	Mäk̃är	
መከታ	Mäkäta	
መከት	Mäkket	
መከኮታዊነት	Mäläkotawinnät	
መከዳ	Mäkkädda	
መኩሪያ	Mäkuriya	
መካ	Mäkka	
መካለያ	Mäkkaläya	
መካሻ	Mäkaša	
መካነ	Mäkanä-	
መካከለኛ	Mäkakkäläñña	
መካከል	Mäkakkäl	
መክሊት	Mäklit	
መክረጅ	Mäkräj	
መክሰስ	Mäksäs	
መክብብ	Mäkbeb	
መክት	Mäkket	
መክፈቻ	Mäkfäča	
መክፈያ	Mäkfäya	
መኮንን	Mäkonnen	
መኮንኖች	Mäkonnenočč	
መኳስ	Mäkʷs	
መኳንንታዊ	Mäkʷnentawi	
መኳንንት	Mäkʷnent	
መኸር	Mäk̃är	
መወርወሪያ	Mäwärwäriya	
መወጠሪያ	Mäwäṭṭäriya	
መዋስእት	Mäwas'et	
መዋቅር	Mäwaqer	
መዋእለ	Mäwa'elä-	
መዋጥ	Mäwaṭ	
መዋጮ	Mäwwač̣o	
መውለጃ	Mäweäja	
መውሊድ	Mäwlid	
መውረጃ	Mäwräja	
መውዜር	Mäwzér	
መውጪያ	Mäwč̣iya	
መዘምር	Mäzämmer	
መዘራዘር	Mäzärazer	
መዘንግእ	Mäzänge'e	
መዘክር	Mäzäkker	
መዘውር	Mäzäwwer	
መዘዞ	Mäzäzo	
መዛግብት	Mäzagebt	
መዝለቂያ	Mäzläqiya	
መዝሙረ	Mäzmurä-	
መዝሙር	Mäzmur	
መዝራእተ	Mäzra'etä-	
መዝናኛ	Mäznañña	
መዝገበ	Mäzgäbä-	
መዝገብ	Mäzgäb	
መዝገቦች	Mäzgäbočč	
መዝጊያ	Mäzgiya	
መዥገር	Mäz̃gär	
መይረማ	Mäyräma	
መደለያ	Mädälläya	
መደምደሚያ	Mädämdämiya	
መደረቢያ	Mädärräbiya	
መደርደሪያ	Mädärdäriya	
መደበኛ	Mädäbäñña	
መደብ	Mädäb	
መደብል	Mädäbbel	
መደብር	Mädäbber	
መደዳ	Mädäda	
መደጐሚያ	Mädäggomiya	
መዲና	Mädina	
መዳቢ	Mäddabi	
መዳብ	Mädab	
መዳፍ	Mädaf	
መድሃኒ ኣለም	Mädhani-Aläm	መድሃኒ አለም
መድሃኒት	Mädhanit	
መድሃኔ	Mädhané	
መድህኔ	Mädhné	
መድህን	Mädhen	
መድልወ	Mädlewä	
መድምም	Mädmem	
መድረክ	Mädräk	
መድበል	Mädbäl	
መድን	Mäden	
መድፈሪያሽ	Mädfäriyaš	
መድፈኛ	Mädfäñña	
መድፋኛ	Mädfäñña	
መድፍ	Mädf	
መዶሻ	Mädoša	
መጀመሪያ	Mäjämmäriya	
መጅ	Mäj	
መጅሊስ	Mäjlis	
መጅመሪያ	Mäjämmäriya	
መገለገያ	Mäggälgäya	
መገል	Mägel	
መገልገያ	Mäggälgäya	
መገርሳ	Mägärsa	
መገሮ	Mägäro	
መገናኛ	Mäggänañña	
መገንታ	Mägänta	
መገዘዝ	Mägäzäz	
መገድገጃ	Mägädgäja	
መጋላ	Mägala	
መጋል	Mägal	
መጋረጃ	Mäggaräja	
መጋቢ	Mäggabi	
መጋቢት	Mäggabit	
መጋኛ	Mäggañña	
መጋዞ	Mäggazo	
መግለጫ	Mägläč̣a	
መግል	Mägel	
መግቢያ	Mägbiya	
መግደላዊት	Mägdälawit	
መጐናጸፊያ	Mäggonaṣäfiya	
መጓጓዝ	Mäggʷgʷz̃a	
መጓጓዣ	Mäggʷgʷz̃a	
መጠሪያ	Mäṭṭäriya	
መጠቅለያ	Mäṭäqläya	
መጠን	Mäṭän	
መጠየቂያ	Mäṭäyyäqiya	
መጠየቅ	Mäṭäyyeq	
መጠይቅ	Mäṭäyyeq	
መጠጊያ	Mäṭṭägiya	
መጠጥ	Mäṭäṭṭ	
መጢቃ	Mäṭiqa	
መጣምር	Mäṭamer	
መጣጣ	Mäṭaṭa	
መጣፈጥ	Mäṭafäṭ	
መጤ	Mäṭṭé	
መጥረቢያ	Mäṭräbiya	
መጥረጊያ	Mäṭrägiya	
መጥሪያ	Mäṭriya	
መጥቅእ	Mäṭqe'e	
መጨኔ	Mäč̣äné	
መጨጊያ	Mäč̣č̣ägiya	
መጨጊያሽ	Mäč̣č̣ägiyaš	
መጫሚያ	Mäč̣č̣amiya	
መጫኛ	Mäč̣añña	
መጫጫት	Mäč̣ač̣at	
መጭ	Mäč̣	
መጸዳጃ	Mäṣṣädaja	
መጻህፍት	Mäṣaheft	
መጻጉእ	Mäṣagu'e	
መጽሀፈ	Mäṣehäfä-	
መጽሀፍ	Mäṣehäf	
መጽሄት	Mäṣehét	
መፈልፈያ	Mäffälfäya	
መፈንቀለ	Mäfänqelä-	
መፈንቅለ	Mäfänqelä-	
መፈክር	Mäfäkker	
መፋቂያ	Mäfaqiya	
መፍትሄ	Mäftehé	
መፍቻ	Mäfča	
ሙሄ	Muhé	
ሙህ የዲን	Muhyäddin	
ሙህየዲን	Muhyäddin	
ሙለታ	Muläta	
ሙሉ	Mulu	
ሙሉ ነህ	MuluNäh	
ሙሉ ነሽ	MuluNäš	
ሙላቱ	Mulatu	
ሙላት	Mulat	
ሙላቷ	Mulatʷ	
ሙላጭ	Mullač̣	
ሙልሙል	Mulmul	
ሙሜ	Mummé	
ሙሪ	Muri	
ሙሬ	Muré	
ሙሰንባይ	Musänbay	
ሙሰይድ	Musäyyed	
ሙሳ	Musa	
ሙሴ	Musé	
ሙሴላ	Musélla	
ሙስሊህ	Muslih	
ሙስላህ	Muslah	
ሙስባሀ	Musbahä	
ሙስና	Musenna	
ሙስጠፋ	Musṭäfa	
ሙሻዘር	Mušazär	
ሙሽራ	Mušerra	
ሙሾ	Mušo	
ሙቃ	Muqa	
ሙቅቢል	Muqbil	
ሙባረክ	Mubaräk	
ሙታን	Mutan	
ሙታንታ	Mutanta	
ሙኒራ	Munira	
ሙኒር	Munir	
ሙአዝ	Mu'äz	
ሙከራ	Mukkära	
ሙካሽ	Mukaš	
ሙካሽ	Mukaš	
ሙክታር	Muktar	
ሙክት	Mukket	
ሙዘይን	Muzäyyen	
ሙዚቀኛ	Muziqäñña	
ሙዚቃ	Muziqa	
ሙዝ	Muz	
ሙያ	Muya	
ሙያተኛ	Muyatäñña	
ሙያተኛች	Muyatäññočč	
ሙያተኞች	Muyatäññočč	
ሙደና	Mudäna	
ሙዳ	Mudda	
ሙዳይ	Muday	
ሙግት	Mugget	
ሙጥሃር	Muṭhar	
ሙጥልቅ	Muṭelleq	
ሙጫ	Muč̣a	
ሙጭጭላ	Muč̣eč̣ella	
ሙፍታህ	Muftah	
ሚልባህ	Milbah	
ሚልኪያስ	Milkiyas	
ሚልክያስ	Milkiyas	
ሚሚ	Mimmi	
ሚራህ	Mirah	
ሚና	Mina	
ሚናስ	Minas	
ሚኤሶ	Mi'ésso	
ሚኪያስ	Mikiyas	
ሚካኤል	Mika'él	
ሚዛን	Mizan	
ሚዜ	Mizé	
ሚያዚያ	Miyaziya	
ሚዳቆ	Mideqo	
ሚጣቅ	Miṭaq	
ሚጥሚጣ	Miṭmiṭṭa	
ማህሌት	Mahelét	
ማህሙድ	Mahemud	
ማህር	Maher	
ማህበረ	Mahebärä-	
ማህበራዊ	Mahebärawi	
ማህበር	Mahebär	
ማህብር	Mahebär	
ማህተመ	Mahetämä-	
ማህተም	Mahetäm	
ማህቶት	Mahetot	
ማህደረ	Mahedärä-	
ማህደሩ	Mahedäru	
ማህደር	Mahedär	
ማህዲ	Mahedi	
ማህጸን	Maheṣän	
ማህጸንተ	Maheṣäntä	
ማህፉድ	Mahefud	
ማለስለሻ	Maläsläša	
ማለደ	Mallädä	
ማለዱ	Mallädu	
ማለዳ	Maläda	
ማለፊያ	Maläfiya	
ማላሽ	Mellaš	
ማላጭ	Melač̣č̣	
ማልመላ	Melmäla	
ማመላለሻ	Mammälaläša	
ማመልከቻ	Mamälkäča	
ማመልካቻ	Mamälkäča	
ማመንጫ	Mamänč̣a	
ማመጫ	Mammäč̣a	
ማሙሸት	Mammušät	
ማሙዬ	Mammuyyé	
ማሚቱ	Mammitu	
ማሚቴ	Mammité	
ማሚቶ	Mammito	
ማማ	Mamma	
ማሜ	Mammé	
ማምረቻ	Mamräča	
ማሞ	Mammo	
ማሞካሸት	Mammokašät	
ማረሚያ	Marrämiya	
ማረሻ	Maräša	
ማረቆ	Maräqo	
ማረፊያ	Maräfiya	
ማሩ	Maru	
ማሪታ	Marita	
ማራገፊያ	Marragäfiya	
ማርልኝ	Marelleññ	
ማርቆስ	Mareqos	
ማርታ	Marta	
ማርከሻ	Markäša	
ማርኪያ	Markiya	
ማርያ	Mareya	
ማርያማዊት	Maryamawit	
ማርያም	Maryam	
ማርዳ	Marda	
ማርገጃ	Margäja	
ማሰልጠኛ	Masälṭäñña	
ማሰማሪያ	Massämariya	
ማሳመን	Masammän	
ማሳተሚያ	Masattämiya	
ማሳደሪያ	Masaddäriya	
ማስመሪያ	Masmäriya	
ማስረሻ	Masräšša	
ማስረጃ	Masräjja	
ማስተላለፊያ	Mastälaläfiya	
ማስተማሪያ	Mastämariya	
ማስተባበሪያ	Mastäbabäriya	
ማስተናገጃ	Mastänagäja	
ማስተዋወቅ	Mastäwawäq	
ማስተዳደሪያ	Mastädadäriya	
ማስተዳደር	Mastädadär	
ማስታወሻ	Mastawäša	
ማስታወቂያ	Mastawäqiya	
ማስጠንቀቂያ	Masṭänqäqiya	
ማስፈር	Masfär	
ማሻሻያ	Maššašaya	
ማሽላ	Mašella	
ማሽንክ	Mašenk	
ማቀዝቀዣ	Maqäzqäz̃a	
ማቅ	Maq	
ማቋቋሚያ	Maqqʷqʷmiya	
ማበጠሪያ	Mabäṭṭäriya	
ማባዘቻ	Mabazäča	
ማብረጃ	Mabräja	
ማብራሪያ	Mabrariya	
ማብሰያ	Mabsäya	
ማተሚያ	Mattämiya	
ማቲ	Mati	
ማትያስ	Mateyas	
ማቶት	Matot	
ማነቆ	Manäqo	
ማናቸውም	Mannaččäwemm	
ማን አህሎህ	MannAheloh	
ማን አህሎሽ	MannAheoš	
ማን አለብሽ	MannÄlläbbeš	
ማን ዘራሽ	MannZärraš	
ማን ያህሉሃል	MannYaheluhal	
ማን ያህሉሻል	MannYaheluhal	
ማን ያህልሃል	MannYahelehal	
ማን ያህልሻል	MannYahelešal	
ማን ያዘዋል	MannYazzäwal	
ማን ደፍሮ	MannDäfro	
ማን ጠግቦሽ	MannṬägboš	
ማንቆርቆሪያ	Manqorqoriya	
ማንኛውም	Manneññawemm	
ማንካ	Manka	
ማንገቻ	Mangäča	
ማንጠልጠያ	Manṭälṭäya	
ማኛ	Mañña	
ማእረገ	Ma'erägä	
ማእረጉ	Ma'eragu	
ማእረግ	Ma'eräg	
ማእርጉ	Ma'erägu	
ማእበል	Ma'ebäl	
ማእከላዊ	Ma'ekälawi	
ማእከላይ	Ma'ekälay	
ማእከል	Ma'ekäl	
ማእዘን	Ma'ezän	
ማእዘንት	Ma'ezänt	
ማእድ	Ma'edd	
ማእድን	Ma'edden	
ማእዶት	Ma'edot	
ማእጠንት	Ma'eṭänt	
ማከናወኛ	Makkänawäñña	
ማከፋፈል	Makkäfafäl	
ማከፋፈያ	Makkäfafäya	
ማኪቦ	Makébo	
ማካበት	Makabät	
ማኬቦ	Makébo	
ማክሰኞ	Maksäñño	
ማክተሚያ	Maktämiya	
ማክዳ	Makedda	
ማዋለድ	Mawwaläd	
ማዘንጊያ	Mazängiya	
ማዘጋጃ	Mazzägaja	
ማዝ	Maz	
ማዞሪያ	Mazoriya	
ማየ ህይወት	Mayä-Heywät	
ማያ ህይወት	Mayä-Heywät	
ማይ ሀባር	MayHäbar	
ማይ በላ	MayBäla	
ማይ ቤላ	MayBété	
ማይ ቤቴ	MayBété	
ማይ ጨሆት	MayČ̣ähot	
ማይ ጨው	MayČ̣äw	
ማይ ጸምሪ	MayṢ̌ämri	
ማይም	Mayyem	
ማደሪያ	Madäriya	
ማደራጃ	Maddäraja	
ማደያ	Maddäya	
ማደጐ	Madägo	ማደጎ
ማዳራጃ	Maddäraja	
ማዳበሪያ	Madabäriya	
ማዳወሪያ	Madawäriya	
ማዴቦ	Madébo	
ማድረቂያ	Madräqiya	
ማድያት	Madyat	
ማድጋ	Madegga	
ማዶ	Mado	
ማጀራት መች	MajeratMäč	
ማጀቴ	Majäté	
ማጀት	Majät	
ማጅራት መች	MajeratMäč	
ማገሩ	Magäru	
ማገገሚያ	Magäggämiya	
ማጋጣ	Magaṭa	
ማግስት	Magest	
ማጠራቀሚያ	Maṭṭäraqämiya	
ማጠቃለያ	Maṭṭäqaläya	
ማጠናቀሪያ	Maṭṭänaqäriya	
ማጠናቀቂያ	Maṭṭänaqäqiya	
ማጠናከሪያ	Maṭṭänakäriya	
ማጠንከሪያ	Maṭṭänakäriya	
ማጠንጠኛ	Maṭänṭäñña	
ማጣሪያ	Maṭṭariya	
ማጣፈጫ	Maṭafäč̣a	
ማጥ	Maṭ	
ማጫ	Méč̣č̣a	
ማጭድ	Mač̣ed	
ማፈሪያ	Mafäriya	
ማፈንገጥ	Mafängäṭ	
ማፈኛ	Maffäñña	
ሜሎ	Mélo	
ሜሮን	Méron	
ሜታ	Métta	
ሜንዳ	Ménda	
ሜንጦ	Ménṭo	
ሜኖ	Ménno	
ሜዞ	Mézzo	
ሜዳ	Méda	
ሜጫ	Méčča	
ምሁራን	Mehuran	
ምሁር	Mehur	
ምህላ	Mehella	
ምህረተ አብ	Mehrätä-Äb	
ምህረቱ	Mehrätu	
ምህረቴ	Mehräté	
ምህረት	Mehrät	
ምህዋር	Mehwar	
ምህጻረ ቃል	Meheṣarä-qal	
ምላሰኛ	Melasäñña	
ምላስ	Melas	
ምላሽ	Mellaš	
ምላጭ	Melač̣č̣	
ምልመላ	Melmäla	
ምልምል	Melmel	
ምልአተ	Mel'ätä-	ምልዓተ
ምልጣን	Melṭan	
ምረቃ	Merräqa	
ምሩጽ	Meruṣ	
ምራቅ	Meraq	
ምራት	Merat	
ምራጭ	Merrač̣	
ምርት	Mert	
ምርኮኛ	Merkoñña	
ምርጊት	Mergitt	
ምርጫ	Merč̣a	
ምርፋቅ	Merfaq	
ምሰሶ	Mesässo	
ምሳሌ	Messalé	
ምሳር	Messar	
ምስለኔ	Mesläné	
ምስል	Mesel	
ምስማር	Mesmar	
ምስማክ	Mesmak	
ምስራቃውያን	Mesraqaweyan	
ምስራቅ	Mesraq	
ምስራች	Messeračč	
ምስርች	Messerečč	
ምስቅልቅል	Mesqelqel	
ምስኪን	Meskin	
ምስክረ	Mesekkerä-	
ምስክር	Mesekker	
ምስጉን	Mesgun	
ምስጋኑት	Mesganut	
ምስጋናው	Mesganaw	
ምስግና	Mesgenna	
ምስጢራዊ	Mesṭirawi	
ምስጢር	Mesṭir	
ምስጥ	Mesṭ	
ምሽግ	Meššeg	
ምቧይ	Embʷy	
ምትሀት	Methät	
ምትኩ	Metekku	
ምትካቸው	Metekkaččäw	
ምትኬ	Metekké	
ምቹ	Mečču	
ምች	Mečč	
ምኒልክ	Menilek	
ምናምን	Menamen	
ምናሰር	Menasär	
ምናሴ	Menasé	
ምናብ	Menab	
ምን ተስኖት	MenTäsenot	
ምን ትዋብ	MenTewwab	
ምን አለ	MenÄlä	
ምን ውየለት	MenWeyyällät	
ምንሽር	Meneššer	
ምንቅርቅር	Menqerqer	
ምንባብ	Menbab	
ምንትራስ	Menteras	
ምንቸት	Menčät	
ምንችሌ	Menčellé	
ምንዛሬ	Menezzaré	
ምንዝር	Menzer	
ምንደኛ	Mendäñña	
ምንዳ	Menda	
ምንዳዬ	Mendayé	
ምንጃር	Menjar	
ምንጅላት	Menjellat	
ምንጠራ	Menṭära	
ምንጭ	Menč̣	
ምኞታዊ	Meññotawi	
ምኞት	Meññot	
ምእመናን	Me'emänan	
ምእራባውያን	Me'erabaweyan	
ምእራብ	Me'erab	
ምእራፍ	Me'eraf	
ምእት	Me'et	
ምእዳን	Me'edan	
ምኩራብ	Mekurab	
ምክረ	Mekrä	
ምክሩ	Mekru	
ምክር	Meker	
ምዝበራ	Mezbära	
ምዝብር	Mezber	
ምደባ	Meddäba	
ምድረ በዳ	Medrä-Bäda	
ምድር	Meder	
ምድጃ	Medejja	
ምጃ	Moja	
ምግብ	Megeb	
ምጣኔ	Meṭṭané	
ምጥማጥ	Meṭmaṭ	
ምጥበሻ	Mäṭbäša	
ምጥን	Meṭṭen	
ምጽላል	Meṣlal	
ምጽዋ	Meṣewwa	
ምጽዋት	Meṣwat	
ሞላ	Molla	
ሞላሌ	Molalé	
ሞላልኝ	Mollalleñ	
ሞረቴ	Moräté	
ሞረድ	Moräd	
ሞራ	Mora	
ሞሲሳ	Mosissa	
ሞተራ	Motära	
ሞት	Mot	
ሞት ባይኖር	MotBaynor	
ሞንዳላ	Mondalla	
ሞካ	Mokka	
ሞክሼ	Mokšé	
ሞጃ	Moja	
ሞጆ	Mojo	
ሞገሳ	Mogäsa	
ሞገስ	Mogäs	
ሞገደኛ	Mogädäñña	
ሞገድ	Mogäd	
ሞግሼ	Mogšé	
ሞግዚት	Mogzit	
ሞጣ	Moṭa	
ሞጣህት	Moṭaht	
ሞፈር	Mofär	
ሞፎ	Mofo	
ሟርተኛ	Mʷrtäñña	
ሟች	Mʷč	
ረሃብ	Rähab	
ረመጥ	Rämäṭ	
ረሺድ	Räšid	
ረቀታ	Räqäta	
ረቂቁ	Räqiqu	
ረቂቅ	Räqiq	
ረቡእ	Räbu'e	
ረቢ	Räbbi	
ረባዳ	Räbbadda	
ረታ	Rätta	
ረኮ	Räko	
ረኸጥ	Räk̃äṭ	
ረዘነ	Räzzänä	
ረዲ	Räddi	
ረዳ	Räda	
ረዳት	Räddat	
ረዳእ	Räda'e	
ረዴ	Räddé	
ረድ	Räd	
ረድማን	Rädman	
ረድኤቱ	Räde'étu	
ረድኤት	Räde'ét	
ረድፍ	Rädf	
ረጀቦ	Räjät	
ረጀት	Räjät	
ረጃ	Räja	
ረጅ	Räd	
ረጅም	Räjjem	
ረገዱ	Räggädu	
ረገድ	Räggäd	
ረጋሳ	Räggasa	
ረጋሽ	Aräggaš	
ረፋድ	Räffad	
ሩር	Rur	
ሩት	Rut	
ሩካቤ	Rukabé	
ሩጋ	Ruga	
ሩፋኤል	Rufa'él	
ሪህ	Rih	
ሪቅ	Riq	
ሪዝ	Riz	
ሪጋ	Riga	
ራሄል	Rahél	
ራህመቶ	Rahmäto	
ራሜት	Ramét	
ራም	Ram	
ራስ	Ras	
ራስ ቁር	RasQurr	
ራስጌ	Ras-Gé	
ራቢያ	Rabiya	
ራብእ	Rabe'e	
ራእይ	Ra'ey	
ራዘነ	Räzzänä	
ራጉ	Rago	
ራጉኤል	Ragu'él	
ራጐ	Rago	
ራፋኤል	Rafa'él	
ሬሳ	Résa	
ርሚጦ	Remmiṭo	
ርስ ቁር	Rasqurr	
ርስት	Rest	
ርቄ	Reqqé	
ርቢ	Rebbi	
ርብራብ	Rebrab	
ርብቃ	Rebqa	
ርብእ	Rabe'e	
ርቱእ	Retu'e	
ርችት	Reččet	
ርእስ	Re'es	
ርእሶም	Re'esom	
ርእዮተ ኣለም	Re'eyotä-Aläm	
ርእዮት	Re'eyot	
ርካሽ	Rekkaš	
ርዝመት	Rezmät	
ርዝራዥ	Rezerraz̃	
ሮሀ	Rohä	
ሮበሌ	Robälé	
ሮቢ	Robi	
ሮቢት	Robit	
ሮባ	Roba	
ሮቤ	Robé	
ሮብ	Rob	
ሰለሄ መለሄ	SälähéMälähé	
ሰለባ	Säläba	
ሰለክላካ	Säläklakka	
ሰለጠነ	Säläṭṭänä	
ሰሊሆም	Sälihom	
ሰላመ	Sälamä-	
ሰላሙ	Sälamu	
ሰላማ	Sälama	
ሰላማዊ	Sälamawi	
ሰላማዊት	Sälamawit	
ሰላም	Sälam	
ሰላሱት	Sälasut	
ሰላሳ	Sälasa	
ሰላቢ	Sälabi	
ሰላይ	Sällay	
ሰላጣ	Sälaṭa	
ሰላጤ	Sällaṭṭé	
ሰሌን	Sälén	
ሰሌዳ	Säléda	
ሰልማን	Sälman	
ሰልፈኛ	Sälfäñña	
ሰልፍ	Sälf	
ሰሎሜ	Sälomé	
ሰሎሞን	Sälomon	
ሰመመን	Sämämän	
ሰመረ	Sämärä	
ሰመተር	Sämätär	
ሰሙ	Sämmu	
ሰሚ	Sämi	
ሰማ	Sämma	
ሰማኒያ	Sämaniya	
ሰማን	Sämman	
ሰማእታት	Säma'etat	
ሰማእትነት	Säma'etennät	
ሰማያት	Sämayat	
ሰማያዊ	Sämayawi	
ሰማይ	Sämay	
ሰማይ ነሽ	SämayNäš	
ሰሜ ነህ	SeméNäh	
ሰሜናዊ	Säménawi	
ሰሜን	Sämén	
ሰም	Säm	
ሰምና ወርቅ	Sämenna-Wärq	
ሰሞነኛ	Sämonäñña	
ሰሞን	Sämon	
ሰረሰር	Säräsär	
ሰረቀ	Säräqä	
ሰረገላ	Särägälla	
ሰሪ	Säri	
ሰራተኛ	Särratäñña	
ሰራተኛች	Särratäññočč	
ሰራተኞት	Särratäññočč	
ሰራዊት	Särawit	
ሰርቦ	Särbo	
ሰርቶ በላ	Särto-Bälla	
ሰርኔሳ	Särnéssa	
ሰርክ	Särk	
ሰርዱ	Särdu	
ሰርዶ	Särdo	
ሰርገኛ	Särgäñña	
ሰርጸ	Särṣä-	
ሰርጹ	Särṣu	
ሰሳ	Säsa	
ሰቀላ	Säqäla	
ሰቃ	Säqa	
ሰቅ	Säqq	
ሰቆጣ	Säqoṭa	
ሰቋር	Säqqʷr	
ሰበ ነክ	SäbäNäk	
ሰበታ	Säbbäta	
ሰበከት	Säbäkät	
ሰበዝ	Säbäz	
ሰባ	Säba	
ሰባራ	Säbara	
ሰባተኛ	Säbattäñña	
ሰባት	Säbatt	
ሰባኪ	Säbaki	
ሰብለ	Säblä	
ሰብሉ	Säblu	
ሰብል	Säbel	
ሰብሳቢ	Säbsabi	
ሰብስቤ	Säbsebé	
ሰብአ ሰገል	Säb'äSägäl	
ሰብአ ስገል	Säb'äSägäl	
ሰብአዊ	Säb'äwi	
ሰብአዊነት	Säb'äwinnät	
ሰታቴ	Sätaté	
ሰነድ	Sänäd	
ሰናይ	Sännay	
ሰናይት	Sännayet	
ሰናድር	Sänader	
ሰናፊል	Sänafil	
ሰናፍጭ	Sänafeč̣č̣	
ሰኔ	Säné	
ሰንሰለት	Sänsälät	
ሰንሰል	Sänsäl	
ሰንበሌጥ	Sänbäléṭ	
ሰንበር	Sänbär	
ሰንበቱ	Sänbätu	
ሰንበታ	Sänbäta	
ሰንበቴ	Sänbäté	
ሰንበት	Sänbät	
ሰንበቶ	Sänbäto	
ሰንአፈ	Sän'äfä	
ሰንኮፍ	Sänkof	
ሰንደል	Sändäl	
ሰንደቅ	Sändäq	
ሰንዳፋ	Sändaffa	
ሰንጋ	Sänga	
ሰንጠረጅ	Sänṭäräj	
ሰንጢ	Sänṭi	
ሰኞ	Säñño	
ሰአት	Sä'at	
ሰኣታት	Sä'atat	
ሰኣት	Sä'at	
ሰኮሩ	Säkoru	
ሰኮና	Säkona	
ሰዋሰው	Säwasew	
ሰው	Säw	
ሰው በላ	SäwBälle	
ሰውነት	Säwennät	
ሰያፍ	Säyyaf	
ሰይድ	Säyed	
ሰይጣን	Säyṭan	
ሰይፈ	Säyfä-	
ሰይፈ አርእድ	Säyfä-Äre'ed	
ሰይፈ እርእድ	Säyfä-Äre'ed	
ሰይፉ	Säyfu	
ሰይፉዲን	Säyfudin	
ሰይፍ	Säyf	
ሰዮ	Säyyo	
ሰደሪያ	Sädäreyya	
ሰደርያ	Sädärayya	
ሰደቃ	Sädäqa	
ሰደቻ	Säddäčča	
ሰደድ	Sädäd	
ሰደፍ	Sädäf	
ሰዲ	Sädi	
ሰዶም	Sädom	
ሰገራ	Sägära	
ሰገባ	Sägäba	
ሰገነት	Sägännät	
ሰገነይቲ	Sägänäyti	
ሰገን	Sägän	
ሰገድ	Säggäd	
ሰጐን	Sägon	
ሰጠኝ	Säṭṭäññ	
ሰፈራ	Säfära	
ሰፈር	Säfär	
ሰፈፍ	Säfäf	
ሰፈፍ የለሽ	SäfäfYälläš	
ሰፊ	Säffi	
ሰፊው	Säffiw	
ሰፋሰፋ	Säfsaffa	
ሰፌድ	Säféd	
ሰፍሳፋ	Säfsaffa	
ሰፍነግ	Säfnäg	
ሱለሂማን	Sulähiman	
ሱልጣን	Sultan	
ሱረት	Surrät	
ሱሪ	Surri	
ሱራፌል	Surafél	
ሱስንዮስ	Suseneyos	
ሱቅ	Suq	
ሱቢህ	Subih	
ሱባኤ	Suba'é	
ሱቲ	Suti	
ሱፋጭ	Sufač̣	
ሱፍያን	Sufeyan	
ሲሚሎ	Similo	
ሲሚንቶ	Siminto	
ሲራክ	Sirak	
ሲራጅ	Siraj	
ሲርሃን	Sirhan	
ሲሳይ	Sisay	
ሲሶ	Siso	
ሲቃላ	Siqala	
ሲባጐ	Sibago	
ሲኖዶስ	Sinodos	
ሲኦል	Si'ol	
ሲዳ	Sida	
ሲዳማ	Sidama	
ሲዳሞ	Sidamo	
ሲጃራ	Sijara	
ሳህለ	Sahelä-	
ሳህሉ	Sahelu	
ሳህሊቱ	Sahelitu	
ሳህሌ	Sahelé	
ሳሆ	Saho	
ሳለ አይሰጥ	Sallä-Äysäṭ	
ሳለህ	Saläh	
ሳሊ	Sali	
ሳሊህ	Salih	
ሳሊም	Salim	
ሳላ	Sala	
ሳሌህ	Saleh	
ሳልህ	Saleh	
ሳልስ	Sales	
ሳሙና	Samuna	
ሳሙኤል	Samu'él	
ሳሚ	Sämi	
ሳማ	Samma	
ሳምራዊ	Samrawi	
ሳምሶን	Samson	
ሳምባ	Samba	
ሳምንታዊ	Sammentawi	
ሳምንት	Samment	
ሳሪስ	Saris	
ሳራ	Sara	
ሳሳሁልሽ	Sassahulleš	
ሳቡሬ	Saburé	
ሳቢ	Sabi	
ሳቢሳ	Sabisa	
ሳቢያ	Sabbiya	
ሳቢያን	Sabiyan	
ሳባ	Saba	
ሳብእ	Sabe'e	
ሳኒ	Sani	
ሳንቃ	Sanqa	
ሳንባ	Sanba	
ሳንቲም	Santim	
ሳንዱቅ	Sanduq	
ሳንጃ	Sanja	
ሳኣል	Sa'ol	
ሳይዳ	Sayda	
ሳዱላ	Sadulla	
ሳድስ	Sades	
ሳድያ	Sadeyya	
ሳጠራ	Saṭara	
ሳጥናኤል	Saṭna'él	
ሴም	Sém	
ሴረኛ	Séräñña	
ሴራ	Séra	
ሴሰኛ	Sésäñña	
ሴሰኛነት	Sésäññannät	
ሴቴ	Sété	
ሴት	Sét	
ሴት አውል	SétÄwel	
ሴትነት	Sétennät	
ሴትኛ አዳሪ	Séteñña Ädari	
ስሁል	Sehul	
ስሂን	Sehin	
ስህተት	Sehtät	
ስለሺ	Seläši	
ስለሽ	Seläši	
ስለት	Selät	
ስሉስ	Sellus	
ስላስ	Sellas	
ስልስ	Selles	
ስልቅ	Selleq	
ስልባቦት	Selbabot	
ስልብ	Selb	
ስልተ	Seltä-	
ስልቻ	Sellečča	
ስልክ	Selk	
ስልጣን	Selṭan	
ስመኝ	Semmäññ	
ስመኝሽ	Semmäññeš	
ስሙኒ	Semuni	
ስሚንቶ	Semminto	
ስማዳ	Semada	
ስሜ	Semé	
ስሜ ነህ	SeméNäh	
ስሜ ነሽ	SeméNäš	
ስሜት	Semmét	
ስም	Säm	
ስምምነት	Sememmennät	
ስምረት	Semrät	
ስምሪት	Semerrit	
ስምንተኛ	Semmentäñña	
ስምንት	Semment	
ስምኦን	Sem'on	
ስምዛ	Semezza	
ስሪት	Serrit	
ስራ	Sera	
ስራ አስኪያጅ	SeraÄskiyaj	
ስራ አጥ	Sera Äṭṭ	
ስር	Ser	
ስር ነቀል	SerNäqqäl	
ስርቅታ	Serreqta	
ስርቆሽ	Serqoš	
ስርቻ	Serečča	
ስርኣተ	Ser'atä-	
ስርኣተ አልባነት	Ser'atä-Älbannät	
ስርወ	Serwä-	
ስርየት	Seryät	
ስርገው	Sergew	
ስርጉት	Sergut	
ስርግው	Sergew	
ስቃይ	Seqay	
ስቅለት	Seqlät	
ስብሀቱ	Sebhätu	
ስብሀት	Sebhät	
ስብሀትለ አብ	SebhätLä-Äb	
ስብራት	Sebberat	
ስብሰባ	Sebsäba	
ስብስቴ	Sebesté	
ስብስቴያኖስ	Sebestéyanos	
ስነ	Senä-	
ስኒ	Seni	
ስና	Sena	
ስናር	Sennar	
ስናፍቅሽ	Senaffeqeš	
ስኔ	Seni	
ስንቄ	Senqé	
ስንቅ ነህ	SenqNäh	
ስንቅ ነሽ	SenqNäš	
ስንቡል	Senbul	
ስንብል	Senbul	
ስንት አየሁ	SentÄyyähu	
ስንኩል	Senkul	
ስንደዶ	Sendädo	
ስንዱ	Seneddu	
ስንድድ	Sended	
ስንጥር	Senṭer	
ስንጥቅ	Senṭeq	
ስእለ	Se'el	
ስእላዊ	Se'elawi	
ስእል	Se'el	
ስኳር	Sekʷr	
ስውር	Sewwer	
ስዩም	Seyyum	
ስደተኛ	Seddätäñña	
ስደተኞች	Seddätäññočč	
ስደት	Seddät	
ስድሳ	Sedsa	
ስድስተኛ	Seddestäñña	
ስድስት	Seddest	
ስድስቶ	Seddesto	
ስጋ	Sega	
ስጋ ሜዳ	Sega Méda	
ስጋ ወደሙ	Sega Wädämu	
ስጋዊ	Segawi	
ስጋጃ	Segajja	
ስግብግብ	Segebgeb	
ስጦታው	Seṭotaw	
ስፌት	Sefét	
ሶሎግ	Solog	
ሶምሶማ	Somsoma	
ሶራ	Sora	
ሶስተኛ	Sostäñña	
ሶስት	Sost	
ሶስና	Sosenna	
ሶታ	Sota	
ሶደሬ	Sodäré	
ሶዶ	Soddo	
ሶፊያ	Sofiya	
ሸህ	Šäh	
ሸሆና	Šähona	
ሸለመው	Šällämäw	
ሸለማይ	Šälämay	
ሸለሸል	Šäläšäl	
ሸለቆ	Šäläqo	
ሸመገለ	Šemagellä	
ሸሚዝ	Šämiz	
ሸማ	Šämma	
ሸማኔ	Šämmané	
ሸማገለ	Šemagellä	
ሸምሱ	Šämsu	
ሸምሲ	Šämsi	
ሸምቃቃ	Šemqaq	
ሸምበቆ	Šämbäqqo	
ሸረሪት	Šärärit	
ሸረኛ	Šärräñña	
ሸሩባ	Šurrubba	
ሸሪፍ	Šärif	
ሸራ	Šära	
ሸርሙጣ	Šärmuṭa	
ሸቀጣ ሸቀጥ	Šäqäṭa-Šäqäṭ	
ሸቀጥ	Šäqäṭ	
ሸቃጭ	Šäqqač̣	
ሸበሌ	Šäbälé	
ሸበል	Šäbäl	
ሸቤ	Šäbé	
ሸንቁጤ	Šänquṭé	
ሸንቁጥ	Šänquṭ	
ሸንቂጤ	Šänquṭé	
ሸንተረር	Šäntärär	
ሸንኮሩ	Šänkoru	
ሸንኮሬ	Šänkoré	
ሸንኮር	Šänkor	
ሸንጐ	Šängo	ሸንጎ
ሸንጐበት	Šängobät	ሸንጎበት
ሸንፈተኛ	Šänfätäñña	
ሸኖ	Šäno	
ሸክላ	Šäkla	
ሸዊት	Šäwwit	
ሸዋ	Šäwa	
ሸዋ ረገድ	ŠäwaRäggäd	
ሸዋ ርካብሽ	ŠäwaRkabeš	
ሸዋ ፈራ	ŠäwaFärra	
ሸዋን ግዛው	Šäwan-Gezaw	
ሸዋዬ	Šäwayyé	
ሸዌ	Šäwé	
ሸው ፈራ	ŠäwaFärra	
ሸውራራ	Šäwrarra	
ሸፋፋ	Šäfafa	
ሹሉዳ	Šuluda	
ሹልክታ	Šullekta	
ሹልዳ	Šuleda	
ሹማምንት	Šumament	
ሹሜ	Šumé	
ሹም	Šum	
ሹምዬ	Šumeyyé	
ሹሩባ	Šurrubba	
ሹራብ	Šurrab	
ሹርቤ	Šurrebbé	
ሹካ	Šukka	
ሺህ	Ših	
ሺመልስ	Ši-Mälles	
ሺምልጃሽ	Ši-Meljaš	
ሺሬ	Širé	
ሺበሺ	Šibäši	
ሺበት	Šibät	
ሺብሬ	Ši-Berré	
ሺታ	Šitta	
ሺታዬ	Šittayé	
ሺቶ	Šitto	
ሺፋው	Šifaw	
ሻህላ	Šähla	
ሻለቃ	Šaläqa	
ሻላ	Šala	
ሻሚል	Šamil	
ሻማ	Šama	
ሻሜ	Šammé	
ሻሜል	Šamil	
ሻምላ	Šamla	
ሻምበል	Šambäl	
ሻምቡ	Šambu	
ሻረው	Šaräw	
ሻሸ	Šaš	
ሻሸመኔ	Šašämänné	
ሻሼ	Šašé	
ሻሽ	Šaš	
ሻሾ	Šašo	
ሻንቅላ	Šanqella	
ሻንቆ	Šanqo	
ሻንጣ	Šanṭa	
ሻኛ	Šañña	
ሻውል	Šawel	
ሻይ	Šay	
ሻጉራ	Šagura	
ሻግያ	Šageyya	
ሻፊ	Šafi	
ሼባ	Šéba	
ሼቻ	Šéčča	
ሽለላ	Šelläla	
ሽል	Šel	
ሽልማት	Šellemat	
ሽልቀቃ	Šelqäqa	
ሽልጦ	Šelleṭo	
ሽመል	Šemäl	
ሽማግሌ	Šemagellé	
ሽምቃቅ	Šemqaq	
ሽምቅ	Šemmeq	
ሽምብራ	Šembera	
ሽምጥ	Šemeṭṭ	
ሽረት	Šerät	
ሽርሽር	Šerrešerr	
ሽርጥ	Šerreṭ	
ሽሮ	Šero	
ሽሽት	Šeššet	
ሽሽግ	Šeššeg	
ሽቅብ	Šeqqeb	
ሽባ	Šeba	
ሽባባው	Šebabbaw	
ሽቤ	Šäbé	
ሽብልቅ	Šebelleq	
ሽብሩ	Šebberu	
ሽብር	Šebber	
ሽቦ	Šebo	
ሽታ	Šetta	
ሽታ ሽቶ	ŠettaŠetto	
ሽታሽቶ	ŠettaŠetto	
ሽታው	Šettaw	
ሽታዬ	Šettayé	
ሽቶ	Šetto	
ሽንቅጡ	Šenqeṭu	
ሽንቅጥ	Šenqeṭ	
ሽንተ ማጥ	Šentä-Maṭ	
ሽንገላ	Šengäla	
ሽንጥ	Šenṭ	
ሽንፈተኛ	Šänfätäñña	
ሽንፈተኞች	Šänfätäññočč	
ሽንፈት	Šenfät	
ሽንፊላ	Šenfilla	
ሽኩር	Šekur	
ሽኩቻ	Šekkučča	
ሽኮኮ	Šekokko	
ሽውራራ	Šäwearra	
ሽውታ	Šewweta	
ሽያጭ	Šeyyač̣	
ሽጉጥ	Šegguṭ	
ሽግግር	Šegegger	
ሽፈራው	Šefärraw	
ሽፋሽፍት	Šefašeft	
ሽፋው	Šefaw	
ሽፋጭ	Šaffač̣	
ሽፍታ	Šefta	
ሽፍን	Šeffen	
ሽፍጠኛ	Šäfṭäñña	
ሾላ	Šola	
ሾርባ	Šorba	
ሾርኒ	Šorni	
ሾተል	Šotäl	
ሾኔ	Šoné	
ሾገሬ	Šogäré	
ቀለህ	Qäläh	
ቀለመ	Qälämä-	
ቀለሙ	Qälämu	
ቀለም	Qäläm	
ቀለምሲስ	Qälämsis	
ቀለሟ	Qälämʷ	
ቀለበት	Qäläbät	
ቀለብ	Qälläb	
ቀለታ	Qäläta	
ቀላቲ	Qälati	
ቀላዋጭ	Qälawač̣	
ቀላድ	Qälad	
ቀላጤ	Qälaṭé	
ቀላፎ	Qällaffo	
ቀልባሽ	Qälbaš	
ቀልደኛ	Qäldäñña	
ቀልድ	Qäld	
ቀልጣፋ	Qälṭaffa	
ቀመር	Qämär	
ቀሚስ	Qämis	
ቀማኛ	Qämmañña	
ቀምበጥ	Qämbäṭ	
ቀረርቶ	Qärärto	
ቀረጥ	Qäräṭ	
ቀረፋ	Qäräfa	
ቀራንዮ	Qäraneyo	
ቀርሳ	Qärsa	
ቀርሺ	Qärši	
ቀርቀሃ	Qärqäha	
ቀርበታ	Qärbäta	
ቀርጨሞ	Qärč̣ämo	
ቀሰም	Qäsäm	
ቀሰስተኛ	Qäsästäñña	
ቀሲስ	Qäsis	
ቀስቃሽ	Qäsqaš	
ቀስተኛ	Qästäñña	
ቀስት	Qäst	
ቀበሌ	Qäbälé	
ቀበርቾ	Qäbäreččo	
ቀበሮ	Qäbäro	
ቀበቶ	Qäbätto	
ቀበና	Qäbäñña	
ቀበኛ	Qäbäñña	
ቀብርቾ	Qäbäreččo	
ቀብድ	Qäbd	
ቀነአ	Qänä'ä	
ቀና	Qänna	
ቀናተኛ	Qännatäñña	
ቀናኢ	Qäna'i	
ቀናው	Qännaw	
ቀን	Qän	
ቀንበር	Qänbär	
ቀንበጥ	Qänbäṭ	
ቀንብር	Qänbär	
ቀንደኛ	Qändäñña	
ቀንዲል	Qändil	
ቀንድ	Qänd	
ቀንዶ	Qändo	
ቀንጠፋ	Qänṭäffa	
ቀኖ	Qänno	
ቀኖና	Qännona	
ቀኖናዊ	Qännonawi	
ቀኖናዊያን	Qännonaweyan	
ቀኖናውያን	Qännonaweyan	
ቀኛዝማች	Qäññazmač	
ቀኝ	Qäññ	
ቀውላላ	Qäwlalla	
ቀውስ	Qäws	
ቀውጢ	Qäwṭi	
ቀያሽ	Qäyyaš	
ቀያቴ	Qäyyaté	
ቀዬ	Qäyé	
ቀይ	Qäyy	
ቀይ ባህር	Qäyy Baher	
ቀይህ	Qäyyeh	
ቀደም	Qäddäm	
ቀደር	Qédär	
ቀዳማዊ	Qädamawi	
ቀዳማይ	Qädamay	
ቀዳዳ	Qädada	
ቀዶ ጥገና	Qäddo-Ṭeggäna	
ቀጄላ	Qäjéla	
ቀጋ	Qäga	
ቀጠሮ	Qäṭäro	
ቀጠና	Qäṭäna	
ቀጥቃጭ	Qäṭqač̣	
ቀጥታ	Qäṭṭeta	
ቀጨሞ	Qäč̣ämo	
ቀጨኔ	Qäč̣äné	
ቀጭ	Qäč̣	
ቀጭኔ	Qäč̣č̣ené	
ቀጭን	Qäč̣č̣en	
ቀጸላ	Qäṣäla	
ቀፈት	Qäfät	
ቀፎ	Qäfo	
ቁልል	Qullel	
ቁልቁለት	Qulqulät	
ቁልቁል	Qulqul	
ቁልቋል	Qulqʷl	
ቁልቢ	Qullebbi	
ቁልፍ	Qulf	
ቁማር	Qumar	
ቁማርተኛ	Qumartäñña	
ቁማጭ	Qummač̣	
ቁም ነገር	Qum-Nägär	
ቁምላቸው	Qumelaččäw	
ቁምጣ	Qumṭa	
ቁምጥና	Qumṭenna	
ቁረን	Qurän	
ቁረንጮ	Quränč̣o	
ቁረኛ	Qurañña	
ቁራ	Qura	
ቁራኛ	Qurañña	
ቁራጭ	Qurrač̣	
ቁር	Qurr	
ቁርሴ	Qursé	
ቁርስ	Qurs	
ቁርቁራ	Qurqura	
ቁርበት	Qurbät	
ቁርባ	Qurrebba	
ቁርባን	Qurban	
ቁርአን	Qur'än	
ቁርእን	Qur'än	
ቁርዝ	Qurz	
ቁርጠት	Qurṭät	
ቁርጠኛ	Qurṭäñña	
ቁርጥ	Qurṭ	
ቁርጥማት	Qurṭemat	
ቁርጥራጭ	Qureṭrač̣	
ቁርጭምጭምት	Qurč̣emč̣emt	
ቁስ አካላነት	QusÄkalennät	
ቁስ አካላዊ	QusÄkalawi	
ቁስ አካል	QusÄkal	
ቁስ አካልነት	QusÄkalennät	
ቁስለኛ	Qusläñña	
ቁስል	Qusel	
ቁስቋም	Qusqʷm	
ቁስጥንጥንያ	Qusṭenṭeneya	
ቁኒ	Qunni	
ቁና	Qunna	
ቁንቁን	Qunqun	
ቁንዲ	Qundi	
ቁንዶ በርበሬ	Qundo Bärbäré	
ቁንጣን	Qunṭan	
ቁንጥጫ	Qunṭeč̣č̣a	
ቁንጫ	Quneč̣č̣a	
ቁንጮ	Qunč̣o	
ቁንጽል	Qunṣel	
ቁጠባ	Quṭṭäba	
ቁጢት	Quṭit	
ቁጥር	Quṭer	
ቁጥቋጦ	Quṭqʷṭo	
ቁጥጥር	Quṭeṭṭer	
ቁፋሮ	Quffaro	
ቂል	Qil	
ቂም	Qim	
ቂርቆስ	Qirqos	
ቂንድ	Qind	
ቂጣ	Qiṭṭa	
ቂጥኝ	Qiṭṭeññ	
ቃለ አጋኖ	Qalä-Ägganno	
ቃለ ጉባኤ	Qalä-Guba'é	
ቃሉ	Qallu	
ቃሊብ	Qalib	
ቃሊቲ	Qallitti	
ቃላት	Qalat	
ቃሌም	Qalém	
ቃል	Qal	
ቃልቻ	Qallečča	
ቃሪያ	Qariya	
ቃሬዛ	Qaréza	
ቃርያ	Qarya	
ቃሲም	Qasim	
ቃተኛ	Qätäñña	
ቃታ	Qata	
ቃና	Qana	
ቃና ዘገሊላ	QanaZägälila	
ቃንቄ	Qanqé	
ቃኖ	Qänno	
ቃኘው	Qäññäw	
ቃየል	Qayäl	
ቃዲ	Qadi	
ቃጤ	Qaté	
ቃጫ	Qač̣č̣a	
ቃጭል	Qač̣el	
ቄራ	Qéra	
ቄርሎስ	Qérelos	
ቄሳር	Qésar	
ቄስ	Qés	
ቄብ	Qéb	
ቄንሳ	Qénsa	
ቄንሶ	Qénso	
ቄንጠኛ	Qénṭäñña	
ቄንጥ	Qénṭ	
ቄደር	Qédär	
ቄጠማ	Qéṭäma	
ቅሌት	Qellét	
ቅል	Qel	
ቅልሞሽ	Qelmoš	
ቅልበሳ	Qelbäsa	
ቅልብ	Qelleb	
ቅልጣን	Qelṭan	
ቅልጥም	Qelṭem	
ቅመማ	Qemmäma	
ቅመም	Qemäm	
ቅማል	Qemal	
ቅማት	Qemat	
ቅማንት	Qemant	
ቅምቡርስ	Qemburs	
ቅምብቻ	Qembečča	
ቅምጥ	Qemmeṭ	
ቅምጥል	Qemeṭṭel	
ቅምጦት	Qenṭot	
ቅምጫና	Qemč̣ana	
ቅምጭብ	Qenč̣ebt	
ቅሪላ	Qerilla	
ቅሪት	Qerrit	
ቅራቅንቦ	Qeraqenbo	
ቅራኔ	Qerrané	
ቅሬ	Qeré	
ቅሬታ	Qerréta	
ቅርሩ	Qererru	
ቅርሴ	Qersé	
ቅርስ	Qers	
ቅርሶች	Qersočč	
ቅርሻት	Qeršat	
ቅርቃብ	Qerqab	
ቅርንጫፍ	Qerenč̣af	
ቅርንጫፎች	Qerenč̣afoč̣č̣	
ቅርንጭፎች	Qerenč̣afočč	
ቅርንፉድ	Qerenfud	
ቅርጫ	Qerč̣a	
ቅርጫት	Qerč̣at	
ቅርጽ	Qerṣ	
ቅርፊት	Qerfitt	
ቅሲም	Qasim	
ቅስም	Qesm	
ቅስቀሳ	Qesqäsa	
ቅስት	Qesset	
ቅስና	Qessenna	
ቅቅል	Qeqqel	
ቅበላ	Qebbäla	
ቅባ ኑግ	QebaNug	
ቅባት	Qebat	
ቅቤ	Qebé	
ቅብአ ቅዱስ	Qeb'ä-Qedus	
ቅብኣት	Qeb'at	
ቅብዝብዝ	Qebezebez	
ቅብጥ	Qebṭ	
ቅናሽ	Qennaš	
ቅናት	Qenat	
ቅናጅ	Qennaj	
ቅኔ	Qené	
ቅንስናሽ	Qenesnaš	
ቅንቀና	Qenqäna	
ቅንአት	Qen'ät	
ቅንጅት	Qenejjet	
ቅንጣት	Qenṭat	
ቅንጦት	Qenṭot	
ቅንጭብት	Qenč̣ebt	
ቅንፍ	Qennef	
ቅኝ	Qeññ	
ቅዘን	Qezän	
ቅየሳ	Qeyyäsa	
ቅያስ	Qeyyas	
ቅዱሰ	Qeddusä-	
ቅዱሳት	Qeddusat	
ቅዱሳን	Qeddusan	
ቅዱስ	Qeddus	
ቅዳሜ	Qedamé	
ቅዳሜ ሱር	QedaméSur	
ቅድመ	Qedmä-	
ቅድሚያ	Qedmiya	
ቅድስተ	Qeddestä-	
ቅድስት	Qeddest	
ቅጠል	Qeṭäl	
ቅጣት	Qeṭat	
ቅጣው	Qeṭaw	
ቅጥራን	Qeṭran	
ቅጥር	Qeṭer	
ቅጥቅጣት	Qeṭqeṭat	
ቅጥያ	Qeṭṭeyya	
ቅጽ	Qeṣ	
ቅጽል	Qeṣṣel	
ቅጽበታዊ	Qeṣbätawi	
ቅጽበት	Qeṣbät	
ቅፍርናሆም	Qefrenahom	
ቆለኛ	Qolläñña	
ቆላ	Qolla	
ቆላ ድባ	Qolla Debba	
ቆላፋ	Qollaffa	
ቆሌ	Qollé	
ቆሎ	Qolo	
ቆመጥ	Qomäṭ	
ቆማጣ	Qomaṭa	
ቆምስ	Qomos	
ቆሞስ	Qomos	
ቆረቆር	Qoräqor	
ቆሪ	Qori	
ቆራጥ	Qorraṭ	
ቆራጭ	Qorač̣	
ቆርቆሮ	Qorqorro	
ቆርቾ	Qoreččo	
ቆርነሌዎስ	Qornäléwos	
ቆሮንጦስ	Qoronṭos	
ቆሳቁስ	Qosaqus	
ቆስጠንጢኖስ	Qosṭänṭinos	
ቆስጣ	Qosṭa	
ቆሽማዳ	Qošmadda	
ቆሽት	Qošt	
ቆቃ	Qoqa	
ቆበ	Qob	
ቆበር	Qobär	
ቆብ	Qob	
ቆቦ	Qobbo	
ቆቱ	Qottu	
ቆንስል	Qonsel	
ቆንዳላ	Qondala	
ቆንዶ በርበሬ	QundoBärbäré	
ቆንጅት	Qonjet	
ቆንጥር	Qonṭer	
ቆዳ	Qoda	
ቆጥ	Qoṭ	
ቆጭቶ	Qoč̣č̣eto	
ቆጮ	Qoč̣č̣o	
ቆፈን	Qofän	
ቋሊማ	Qʷlima	
ቋሚ	Qʷmi	
ቋር	Qʷr	
ቋቁቻ	Qʷqučča	
ቋት	Qʷt	
ቋንጃ	Qʷnja	
ቋንጣ	Qʷnṭa	
ቋያ	Qʷyya	
ቋግሚት	Qʷgmit	
ቋጥኝ	Qʷṭeññ	
በሀኪም	Bähäkim	
በለሳ	Bäläsa	
በለስ	Bäläs	
በለው	Bäläw	
በለጠ	Bälläṭä	
በለጠች	Bälläṭäčč	
በለጡ	Bälläṭu	
በለጤ	Bälläṭé	
በለጥሻቸው	Bälläṭšaččäw	
በላተኛ	Bällatäñña	
በላቸው	Bälaččäw	
በላይ	Bälay	
በላይ ሁን	BälayHun	
በላይ ነህ	BälayNäh	
በላይ ነሽ	BälayNäš	
በልሁ	Bällehu	
በልዩ	Bäleyyu	
በልግ	Bälg	
በረሀ	Bäräh	
በረሃ	Bäräha	
በረህ	Bäräh	
በረራ	Bärära	
በረት	Bärät	
በረንዳ	Bärända	
በረኛ	Bärräñña	
በረከት	Bäräk̃ät	
በረክ	Bäräk	
በረኸት	Bäräk̃ät	
በረደድ	Bäräddäd	
በረዶ	Bärädo	
በረጋ	Bärägga	
በረጋህልኝ	Bäräggahelleñ	
በሪ	Bäri	
በሪዳ	Bärida	
በራሪ	Bärari	
በራኪ	Bäraki	
በራኺ	Bärak̃i	
በራዡ	Bärraz̃	
በራዥ	Bärraz̃	
በራፍ	Bärraf	
በሬ	Bäré	
በሬሳ	Bärréssa	
በር	Bärr	
በር ይሁን	BärrYehun	
በርሄ	Bärehé	
በርሚል	Bärmil	
በርሜል	Bärmél	
በርሞሌ	Bärmolé	
በርሳ ሰዲ	Bärsä-Sädi	
በርበሬ	Bärbäré	
በርባን	Bärban	
በርቱማ	Bärtumma	
በርቱካ	Bärtuka	
በርታ	Bärta	
በርቶሎሜዎስ	Bärtoloméwos	
በርናባስ	Bärnabas	
በርኖስ	Bärnos	
በርጨቃ	Bärč̣äqa	
በርጩማ	Bärč̣umma	
በሰጊድ	Bäsägid	
በሱ ፈቃድ	BässuFäqad	
በስተርጅና	Bästärjenna	
በስፋ ነሽ	TäsfaNäš	
በሶ	Bässo	
በሶ ብላ	BässoBela	
በሹ	Bäšu	
በሺር	Bäšir	
በሻህ	Bäšah	
በሻዳ	Bäšada	
በሽሎ	Bäšlo	
በሽር	Bäšer	
በሽታ	Bäššeta	
በቀለ	Bäqqälä	
በቀለች	Bäqqäläčč	
በቀሉ	Bäqqälu	
በቀል	Bäqäl	
በቀልት	Bäqqält	
በቀት	Bäqät	
በቁሙ	Bäqumu	
በቃሉ	Bäqalu	
በቆልት	Bäqqolt	
በተሀ	Bätähä	
በትረ	Bäträ-	
በትሩ	Bätru	
በቸረር	Bäčärär	
በነበሩ	Bänäbbäru	
በኒአምር	Bäni'ämer	
በንቲ	Bänti	
በአሉ	Bä'alu	
በአካል	Bä'äkal	
በኣሉ	Bä'alu	
በኣላት	Bä'alat	
በኣል	Bä'al	
በእምነት	Bä'emnät	
በእውቀቱ	Bä'ewqätu	
በእውቀት	Bä'ewqät	
በእደ	Bä'edä-	
በኩረ	Bäkurä-	
በኩራይ	Bäkuray	
በኩር	Bäkur	
በክሩ	Bäkru	
በክሪ	Bäkri	
በዘፈቀደ	Bäzäfäqädä	
በዙ	Bäzzu	
በዛ	Bäzza	
በዛበህ	Bäzzabbeh	
በዛብህ	Bäzzabbeh	
በዜ	Bäzzé	
በዝባዥ	Bäzbaz̃	
በየነ	Bäyyänä	
በየነች	Bäyyänäčč	
በያን	Bäyyan	
በይነ ትግብርት	Bäynä-Tegbert	
በይን	Bäyyen	
በደሌ	Bäddällé	
በደል	Bädäl	
በደኖ	Bäddänno	
በደዊ	Bädäwi	
በደዌ	Bädäwé	
በዲሳ	Bäddéssa	
በዳኔ	Bädané	
በዳይ	Bädday	
በዳዳ	Bädada	
በድሉ	Bäddelu	
በድሩ	Bädru	
በድሪ	Bädri	
በድሪያ	Bädriya	
በድን	Bäden	
በድአሶ	Bäd'äso	
በድጋፍ	Bädegaf	
በጅሮንድ	Bäjerond	
በጊ	Bägi	
በጋ	Bäga	
በጋሻው	Bägaššaw	
በጌምድር	Bägémder	
በግ	Bäg	
በጐ	Bäggo	
በጣጢስ	Bäṭaṭis	
በጨር	Bäč̣är	
በጸሃ	Bäṣha	
በጽሃ	Bäṣha	
በፈቃዱ	Bäfäqadu	
በፍርዱ	Bäferdu	
በፍታ	Bäfta	
ቡሀቃ	Buhäqa	
ቡሄ	Buhé	
ቡሆ	Buho	
ቡሊ	Buli	
ቡላ	Bulla	
ቡሌ	Bulé	
ቡልቻ	Bulča	
ቡልጋ	Bulga	
ቡራቡሬ	Burrahurré	
ቡራኬ	Buraké	
ቡሬ	Buré	
ቡርቃ	Burqa	
ቡሰይሪ	Busäyri	
ቡሴይር	Buséyyer	
ቡሽራ	Bušera	
ቡቃያ	Buqayya	
ቡቅሬ	Buqré	
ቡባሞ	Bubamo	
ቡቱቶ	Butetto	
ቡታ	Butta	
ቡታ ጅራ	ButtaJera	
ቡችላ	Buččella	
ቡችሎች	Buččelločč	
ቡና	Bunna	
ቡናማ	Bunnamma	
ቡንኝ	Bunneññ	
ቡአ	Bu'ä	
ቡከን	Bukkän	
ቡይት	Buyyet	
ቡድን	Buden	
ቡጢ	Buṭṭi	
ቢሆነኝ	Bihonäññ	
ቢለዋ	Billäwa	
ቢልልኝ	Bilelleñ	
ቢልባህ	Bilbah	
ቢምረው	Bimeräw	
ቢራ	Bira	
ቢራቢሮ	Birrabirro	
ቢራቱ	Birrattu	
ቢርመጂ	Birmäji	
ቢሻሽ	Bišaš	
ቢሾፍቱ	Bišoftu	
ቢቂላ	Biqila	
ቢተው	Bitäw	
ቢተውልኝ	Bitäwelleñ	
ቢትወደድ	Bitwäddäd	
ቢነጋ	Binäga	
ቢዘን	Bizän	
ቢያድግልኝ	Biyadgelleñ	
ቢጫ	Bič̣a	
ቢፍቱ	Bahar	
ባሃር	Bahar	
ባሃዳድ	Bahadad	
ባህረ	Baherä-	
ባህረ ነጋሽ	BaherNägaš	
ባህረኛ	Baheräñña	
ባህር	Baher	
ባህር ማሽላ	BaherMašella	
ባህር ነጋሽ	BaherNägaš	
ባህር ዳር	BaherDar	
ባህርያት	Bahereyat	
ባህርይ	Baherey	
ባህታ	Baheta	
ባህታዊ	Bahetawi	
ባለ	Balä-	
ባለ ሟል	Balämʷl	
ባለ እኩል	Balä-Ekkul	
ባለ እጅ	Balä-Ejj	
ባለስልጣን	Balä-Selṭan	
ባለቤት	Baläbét	
ባለኩል	Baläkkul	
ባለጅ	Baläjj	
ባሊላ	Balilla	
ባላ	Balla	
ባላምበራስ	Balambäras	
ባላምባራስ	Balambaras	
ባላባታዊ	Balabbatawi	
ባላባታዊነት	Balabbatawinnät	
ባላባት	Balabbat	
ባላንጋራ	Balangara	
ባላንጣ	Balanṭa	
ባላገር	Balagär	
ባላጋራ	Balagara	
ባሌ	Balé	
ባል	Bal	
ባል ሟል	Balämʷl	
ባልቴት	Baltét	
ባልትና	Baltenna	
ባልቻ	Balča	
ባልቾ	Balleččo	
ባልንጀራ	Balenjära	
ባልንጅራ	Balenjära	
ባልከው	Balkäw	
ባልደረባ	Baldäräba	
ባልደራስ	Baldäras	
ባልዲ	Baldi	
ባልዳ	Balda	
ባልጭት	Balč̣ett	
ባሕሩ	Baheru	
ባምቡሌ	Bambulé	
ባረንቱ	Baräntu	
ባሩዳ	Baruda	
ባሩድ	Barud	
ባሪያ	Bariya	
ባሪያዎች	Bariyawočč	
ባራቱማ	Baratuma	
ባሬታ	Barrétta	
ባሬንቱ	Baréntu	
ባርነት	Barennät	
ባርኔጣ	Barnéṭa	
ባርካ	Barka	
ባርያ	Barya	
ባሮች	Baročč	
ባሳዝነው	Basazzenäw	
ባስልዮስ	Basleyos	
ባሻ	Bašša	
ባሻገር	Baššaggär	
ባቅላባ	Baqlaba	
ባቡ	Babbu	
ባቢሌ	Babbilé	
ባተሌ	Batälé	
ባቲ	Bati	
ባት	Bat	
ባት ወሰን	Bant-Yewwäsän	
ባት ይርጉ	Bant-Yergu	
ባት ይዋሉ	Bant-Yewalu	
ባኒ	Bani	
ባና	Bana	
ባንት አየሁ	Bant-Äyyähu	
ባንት ይርጉ	BantYergu	
ባንት ይወሰን	BantYewwäaän	
ባንት ይዋሉ	Bantyewalu	
ባንች ይርጉ	Bančč-Yergu	
ባንች ይርጋ	BanččYerga	
ባንዲራ	Bandira	
ባንዳ	Banda	
ባንጃው	Banjaw	
ባእዳን	Ba'edan	
ባእድ	Ba'ed	
ባካሉ	Bakalu	
ባኮ	Bakko	
ባኰ	Bakko	
ባዘቶ	Bazäto	
ባዙቃ	Bazuqa	
ባዚን	Bazin	
ባዝራ	Bazra	
ባዩ	Bayyu	
ባዩሽ	Bayyuš	
ባይለየኝ	Bayelläyyäñ	
ባይሩ	Bayeru	
ባይሳ	Bayyesa	
ባይተዋር	Baytäwar	
ባይነሳኝ	Baynäsañ	
ባይንሳኝ	Baynäsañ	
ባይከዳኝ	Baykädañ	
ባደንጋ	Badänga	
ባደግ	Baddäg	
ባዲያብ	Badiyab	
ባድማ	Bademma	
ባዶ	Bado	
ባጥ	Baṭ	
ባፈና	Bafäna	
ቤለማ	Bélläma	
ቤላማ	Bélama	
ቤላም	Bélema	
ቤሳ	Bésa	
ቤተ	Bétä-	
ቤተ ሰብ	Bétä-Säb	
ቤት	Bét	
ቤቶች	Bétočč	
ቤኛ	Béñnã	
ቤካ	Békka	
ቤዛ	Béza	
ቤዶ	Béddo	
ብሄረ ሰቦች	Behérä-Säbočč	
ብሄረ ሰብ	Behérä-Säb	ብሄረስብ
ብሄረ ሰቦች	Behérä-Säbočč	
ብሄረ ስብ	Behérä-Säb	
ብሄረተኛ	Behérätäñña	
ብሄረተኛነት	Behérätäññannät	
ብሄራዊ	Behérawi	
ብሄር	Behér	
ብሄርነት	Behérennät	
ብሄሮች	Behéročč	
ብለሽ	Belaš	
ብላሽ	Belaš	
ብላታ	Belatta	
ብላቴና	Belatténa	
ብላቴን	Belattén	
ብሌን	Belén	
ብል	Bel	
ብልሀተኛ	Belehätäñña	
ብልሀት	Belehät	
ብልሃተኛ	Belehatäñña	
ብልሃት	Belehat	
ብልህ	Beleh	
ብልማ	Bélläma	
ብልሽት	Beleššet	
ብልቃጥ	Belqaṭ	
ብልብላ	Belbella	
ብልት	Bellet	
ብልኮ	Bellekko	
ብልጭታ	Belleč̣ta	
ብሎን	Belon	
ብረታ ብረት	Beräta-Berät	
ብረት	Berät	
ብረት ለበስ	BerätLäbbäs	
ብሩ	Berru	
ብሩሽ	Beruš	
ብሩኬ	Beruké	
ብሩክ	Beruk	
ብሩክታዊት	Beruktawit	
ብሩክት	Berukt	
ብሪቱ	Berritu	
ብሪንጥ	Berinṭ	
ብራና	Beranna	
ብራኳ	Berakkʷ	
ብሬ	Berré	
ብር	Berr	
ብር ነሽ	BerrNäš	
ብርሃነ	Berhanä-	
ብርሃኑ	Berhanu	
ብርሃኔ	Berhané	
ብርሃን	Berhan	
ብርሌ	Berellé	
ብርቂቱ	Berqitu	
ብርቄ	Berqé	
ብርቅ	Berq	
ብርቅ ነሽ	BerqNäš	
ብርቅነሽ	BerqNäš	
ብርብራ	Berberra	
ብርብር	Berber	
ብርቱ	Bertu	
ብርቱካን	Bertukan	
ብርታት	Bertat	
ብርንዶ	Berendo	
ብርኩማ	Berkumma	
ብርክቲ	Berekti	
ብርክት	Berekt	
ብርዝ	Berz	
ብርዞ	Berzo	
ብርዬ	Berreyyé	
ብርዳም	Berdam	
ብርድ	Berd	
ብርጩፋ	Berč̣ufa	
ብርጭቆ	Berč̣eqqo	
ብሳና	Besanna	
ብስለት	Beslät	
ብስል	Besel	
ብስል ተቀሊል	BeselTäqälil	
ብስራተ	Besratä-	
ብስራት	Besrat	
ብስኩቴ	Beskuté	
ብስኩት	Beskut	
ብሶት	Besot	
ብሽሽት	Bešeššet	
ብቃት	Beqat	
ብቅል	Beqel	
ብብት	Bebbet	
ብታ ጅራ	ButtaJera	
ብትወጣ	Betwäṭa	
ብቸሬ	Bečäré	
ብቸና	Bečäna	
ብቸኛ	Beččäñña	
ብናኝ	Bennañ	
ብንያሚን	Beneyamin	
ብንያም	Beneyam	
ብእር	Be'er	
ብኩርና	Bekurenna	
ብኩን	Bekun	
ብዙ	Bezu	
ብዙ ነህ	BezuNäh	
ብዙ ነሽ	BezuNäš	
ብዙሃን	Bezuhan	
ብዝበዛ	Bezbäza	
ብዝባዛ	Bezbaza	
ብድር	Bedder	
ብጉር	Begur	
ብጉንጅ	Begunj	
ብጡል	Beṭul	
ብጤ	Beṭé	
ብጹዕ	Beṣu'e	
ብጽአት	Beṣ'ät	
ቦለቄ	Boläqé	
ቦለቅያ	Bolläqeyya	
ቦላሌ	Bolalé	
ቦሌ	Bolé	
ቦልቦሌ	Bolbollé	
ቦረና	Boräna	
ቦረን	Borän	
ቦረንትቻ	Boränttečča	
ቦረዳ	Borädda	
ቦሩ	Boru	
ቦራ	Bora	
ቦሬ	Boré	
ቦርሳ	Borsa	
ቦርዴ	Bordé	
ቦርጋ	Borga	
ቦርጭ	Borč̣	
ቦሰና	Bosäna	
ቦቃ	Boqa	
ቦቆጂ	Boqoji	
ቦታ	Bota	
ቦና	Bona	
ቦንሳ	Bonsa	
ቦንዳ	Bonda	
ቦንጋ	Bonga	
ቦኩ	Bokku	
ቦካ	Bokka	
ቦኮ	Bokko	
ቦዘና	Bozäna	
ቦዘኔ	Bozäné	
ቦዘኔነት	Bozänénnät	
ቦይና	Boyna	
ቦዲቲ	Bodditi	
ቦዲቴ	Boditti	
ቦዳ	Bodda	
ቦጄ	Bojé	
ቦጋለ	Boggalä	
ቦጋለች	Boggaläčč	
ቦጐስ	Bogos	ቦጎስ
ቧ ያለው	Bʷ-Yaläw	
ቧንቧ	Bʷnbʷ	
ቧያለው	Bʷ-Yaläw	
ቧጋች	Bʷgač	
ቨርሙጥ	Värmuṭ	
ተሀድሶ	Tähäddeso	
ተሁለደሬ	Tähulädäré	
ተለዋዋጭ	Täläwawač̣	
ተሊላ	Tälila	
ተላላኪ	Tälalaki	
ተላላፊ	Tälalafi	
ተልአል	Täle'äl	
ተልእል	Täle'äl	
ተልእኮ	Täle'eko	
ተመልሶ	Tämälso	
ተመልካች	Tämälkač	
ተመሳሳይ	Tämäsasay	
ተመስገን	Tämäsgän	
ተመናይ	Tämänay	
ተመን	Tämän	
ተመኙ	Tämäññu	
ተመኝ	Tämäññ	
ተሙን	Tämun	
ተማም	Tämam	
ተምር	Tämer	
ተምቤን	Tämbén	
ተምትሜ	Tämtemé	
ተምች	Tämč	
ተምኔታዊ	Tämenétawi	
ተምኔታዊነት	Tämenétawinnät	
ተምኔት	Tämenét	
ተሟጋች	Tämʷgač	
ተረበኛ	Täräbäñña	
ተረብ	Täräb	
ተረተር	Tärätär	
ተረኛ	Täräñña	
ተረፈ	Tärräfä	
ተረፈች	Tärräfäčč	
ተረፉ	Tärräfu	
ተራ	Tära	
ተራማጅ	Täramaj	
ተራራማ	Täraramma	
ተራቢ	Tädärrabi	
ተራዳ	Tärada	
ተራድኦ	Tärade'o	
ተርብ	Tärb	
ተርታ	Tärta	
ተርፉ	Tärfu	
ተርፋ	Tärfa	
ተርፋሳ	Tärfasa	
ተሰሎንቄ	Täsälonqé	
ተሰማ	Täsämma	
ተሰራ	Täsärra	
ተሰራች	Täsärračč	
ተሰነይ	Täsänäy	
ተሰፋ ሁን	TäsfaHun	
ተሳቢ	Täsabi	
ተሳትፎ	Täsatfo	
ተስማሚ	Täsmami	
ተስቦ	Täsebo	
ተስፉ	Täsfu	
ተስፋ	Täsfa-	
ተስፋ የሱስ	Täsfa-Yyäsus	
ተስፋ የስ	Täsfa-Yyäs	
ተስፋ-ሁን	Täsfa-Hun	
ተስፋ-ቢስ	TäsfaBis	
ተስፋ-ነሽ	Täsfa-Näš	
ተስፋው	Täsfaw	
ተስፋዝጊ	Täsfa-Zgi	
ተስፋየስ	Täsfa-YYäs	
ተስፋዬ	Täsfayé	
ተስፋይ	Täsfay	
ተሻለ	Täšalä	
ተሻገር	Täšagär	
ተሽከርካሪ	Täškärkari	
ተሽከርካሪዎች	Täškärkariwočč	
ተሾመ	Täšomä	
ተቀባ	Täqäbba	
ተቀባሽ	Täqäbbaš	
ተቀባይ	Täqäbbay	
ተቀታ	Räqäta	
ተቀናቃኝ	Täqänaqañ	
ተቀዳ	Täqädda	
ተቀዳሚ	Täqäddami	
ተቀጥላ	Täqäṭṭella	
ተቃዋሚ	Täqawami	
ተቃውሞ	Täqawmo	
ተቆጣጣሪ	Täqoṭaṭari	
ተቋመ	Täqʷmä	
ተቋም	Täqʷm	
ተበዝባዥ	Täbäzbaz̃	
ተበዳሪ	Täbäddari	
ተበዳይ	Täbädday	
ተባባሪ	Täbabari	
ተባእታይ	Täba'etay	
ተባእት	Täba'et	
ተባይ	Täbay	
ተቻለ	Täčalä	
ተነቃናቂ	Tänäqanaqi	
ተነፋነፍ	Tänäfanäf	
ተናሳሂ	Tänasahi	
ተናኘ	Tänaññä	
ተናካሽ	Tänakaš	
ተናጋሪ	Tänagari	
ተናጠል	Tänaṭäl	
ተንቀሳቃሽ	Tänqäsaqaš	
ተንኮለኛ	Tänkoläñña	
ተንኮል	Tänkol	
ተንዳሆ	Tändaho	
ተአምረ	Tä'ämmerä-	
ተአምር	Tä'ämmer	
ተአበኛ	Tä'äbäñña	
ተአብ	Tä'äb	
ተከላካይ	Täkälakay	
ተከራካሪ	Täkärakari	
ተከሳሽ	Täkässaš	
ተከስተ	Täkästä	
ተከተል	Täkättäl	
ተከታይ	Täkättay	
ተከዜ	Täkkäzé	
ተኪ	Täkké	
ተካ	Täkka	
ተካልኝ	Täkkalleñ	
ተካበ	Täkabä	
ተካበች	Täkabäčč	
ተካነች	Täkanäčč	
ተካፋይ	Täkafay	
ተኬ	Täkké	
ተክለ	Täklä-	
ተክሉ	Täklu	
ተክሊል	Täklil	
ተክላይ	Täklay	
ተክሌ	Täklé	
ተክል	Täkel	
ተክኤ	Täkke'é	
ተኮላ	Täkolla	
ተኸርቁት	Täk̃ärqut	
ተወልደ	Täwäldä-	
ተወካይ	Täwäkkay	
ተወዲዳ	Täwädida	
ተወዳዳሪ	Täwädadari	
ተወዳዳሪዎች	Täwädadariwočč	
ተዋህዶ	Täwahedo	
ተዋበች	Täwabäčč	
ተዋጊ	Täwagi	
ተውላጠ ስም	Täwlaṭä-Sem	
ተውሳከ ግስ	Täwsakä-Gess	
ተውሳካም	Täwsakam	
ተውሳክ	Täwsak	
ተውኔት	Täwenét	
ተውፊቅ	Täwfiq	
ተዘራ	Täzärra	
ተዘዋዋሪ	Täzäwawari	
ተዝካር	Täzkar	
ተደራቢ	Tädärrabi	
ተደነቀ	Tädännäqä	
ተደጋጋሚ	Tädägagami	
ተድላ	Tädla	
ተድባበ	Tädbaä-	
ተድባብ	Tädbab	
ተጂ	Täji	
ተጂባ	Täjiba	
ተገኔ	Tägäné	
ተገንጣይ	Tägänṭay	
ተገኙ	Tägäññu	
ተገኝ	Tägäññ	
ተገድራ	Tägädderra	
ተጋዳይ	Tägaday	
ተጌጠ	Tägéṭä	
ተግሳጽ	Tägsaṣ	
ተግባረ እድ	Tägbarä-Ed	
ተግባሩ	Tägbaru	
ተግባር	Tägbar	
ተጠሪ	Täṭäri	
ተጠራጣሪ	Täṭäraṭari	
ተጠቃሚ	Täṭäqqami	
ተጠባባቂ	Täṭäbabaqi	
ተጠያቂ	Täṭäyyaqi	
ተጨማሪ	Täč̣ämmari	
ተጨቋኝ	Täč̣äqqʷññ	
ተጨባጭ	Täč̣äbbač̣	
ተጫነ	Täč̣anä	
ተጻራሪ	Täṣarari	
ተጽእኖ	Täṣe'eno	
ተፈሪ	Täfäri	
ተፈራ	Täfärra	
ተፈጥሮ	Täfäṭro	
ተፍኪ	Täfki	
ቱሁኔ	Tehuné	
ቱለማ	Tuläma	
ቱሉ	Tullu	
ቱሉ ቦሎ	TulluBollo	
ቱሉማ	Tuluma	
ቱልቱላ	Tultulla	
ቱልት	Tult	
ቱማታ	Tumata	
ቱምሳ	Tumsa	
ቱሩፋት	Terufat	
ቱሬ	Turé	
ቱቢት	Tubit	
ቱባ	Tubba	
ቱቻ	Tučča	
ቱከምቢያ	Tukämbiya	
ቱፈር	Tufär	
ቱፋ	Tufa	
ቱፍታ	Tufta	
ቲማቲም	Timatim	
ቲባ	Tibba	
ቲዮብስታ	Tiyobesta	
ታህሳስ	Tahesas	
ታህታይ	Tahetay	
ታላላቅ	Talallaq	
ታመነ	Tammänä	
ታማኝ	Tammañ	
ታምሩ	Tammeru	
ታምሪያለሽ	Tamriyalläš	
ታምራት	Tammerat	
ታረቀ	Tarräqä	
ታረቀች	Tarräqäčč	
ታረቀኝ	Tarräqäññ	
ታሪኩ	Tariku	
ታሪካዊ	Tarikawi	
ታሪክ	Tarik	
ታሪኳ	Tarikʷ	
ታቦር	Tabor	
ታቦት	Tabot	
ታታሪ	Tatari	
ታች በሌ	TaččBälé	
ታኒካ	Tanika	
ታንኳ	Tankʷ	
ታንጉት	Tangut	
ታከለ	Takkälä	
ታከለልን	Takkälälleñ	
ታከለልኝ	Takkälälleñ	
ታዛቢ	Tazzabi	
ታዛዥ	Tazzaz̃	
ታየ	Tayyä	
ታየች	Tayyäčč	
ታደለ	Taddälä	
ታደለች	Taddäläčč	
ታደሰ	Taddäsä	
ታደሰች	Taddäsäčč	
ታደስች	Taddäsäčč	
ታዲሽ	Taddiš	
ታዳጊ	Taddagi	
ታዴዋስ	Tadéwos	
ታዴዎስ	Tadéwos	
ታጀበ	Tajjäbä	
ታገል	Tagäl	
ታጋሽ	Taggaš	
ታጋይ	Tagay	
ታጠረ	Taṭṭärä	
ታጠቅ	Taṭäq	
ታፈረ	Taffärä	
ታፈሰ	Taffäsä	
ታፈሰች	Taffäsäčč	
ታፈሱ	Taffäsu	
ታፋ	Tafa	
ታፍላ	Tafla	
ቴምብር	Témber	
ቴሶ	Tésso	
ቴዎድሮስ	Téwodros	
ቴዎዶስዮስ	Téwodoseyos	
ቴዎዶድዮስ	Téwodoseyos	
ቴዎፍሎስ	Téwoflos	
ትሁኔ	Tehuné	
ትልም	Telm	
ትምህርተ	Temehertä-	
ትምህርት	Temehert	
ትምባሆ	Tembaho	
ትምክህተኛነት	Temkehetäññannät	
ትምክህት	Temkehet	
ትሩፋት	Terufat	
ትራስ	Teras	
ትራፊ	Terrafi	
ትርሲት	Tersit	
ትርስእት	Terse'et	
ትርንጐ	Terengo	
ትርኪ ምርኪ	TerkiMerki	
ትርካሶ	Terkasso	
ትርጁማን	Terjuman	
ትርጉም	Tergum	
ትርጓሜ	Tergʷmé	
ትርፉ	Terfu	
ትርፌ	Terfé	
ትርፍ	Terf	
ትርፍራፊ	Terefrafi	
ትርፏ	Terfʷ	
ትሰሚያለሽ	Tessämmiyalläš	
ትሰሜ	Tessämé	
ትሳሴ	Tesasé	
ትስሚያለሽ	Tessämmiyalläš	
ትስሜ	Tessämmé	
ትስፍህቴ	Tesfeheté	
ትስፍህት	Tesfehet	
ትበርህ	Tebärreh	
ትበይን	Tebäyyen	
ትቢያ	Tebbiya	
ትብለጥ	Tebläṭ	
ትብብር	Tebebber	
ትችት	Teččet	
ትኋን	Tehʷn	
ትንሳኤ	Tensa'é	
ትንቅንቅ	Teneqneq	
ትንቢት	Tenbit	
ትንተና	Tentäna	
ትንታግ	Tentag	
ትንኝ	Teneññ	
ትንፋሽ	Tenfaš	
ትንፋገም	Tenfagän	
ትንፋገን	Tenfagän	
ትእዛዙ	Te'ezazu	
ትእዛዝ	Te'ezaz	
ትእይንት	Te'eyyent	
ትእግስት	Te'egest	
ትኩ	Tekku	
ትኩሳት	Tekkusat	
ትኩዬ	Tekkuyyé	
ትክትክ	Tekketekk	
ትክክለኛ	Tekekkeläñña	
ትውልድ	Tewledd	
ትውፊቅ	Täwfiq	
ትደነቂያለሽ	Teddännäqiyalläš	
ትደነቅ	Teddännäq	
ትደንቂያለሽ	Teddännäqiyalläš	
ትዳር	Tedar	
ትድባበ	Tädbabä-	
ትድባብ	Tädbaab	
ትገኛ	Ṭeggäñña	
ትጉህ	Teguh	
ትጉባ	Teguba	
ትግል	Tegel	
ትግበርት	Tegbert	
ትጥቅ	Teṭq	
ትፋት	Tefat	
ትፍስህተ	Tefsehetä	
ትፍስህት	Tefsehet	
ቶለሳ	Toläsa	
ቶላ	Tola	
ቶልቻ	Tolča	
ቶሎሳ	Tolosa	
ቶማስ	Tomas	
ቶበተኛ	Tobätäñña	
ቶፊቅ	Tofik	
ቶፊክ	Tofik	
ቶፋ	Tofa	
ቸሀ	Čähä	
ቸልተኛ	Čälletäñña	
ቸልታ	Čälleta	
ቸሩ	Čäru	
ቸርቻሪ	Čärčari	
ቸርነት	Čärennät	
ቸነፈር	Čänäfär	
ቸኮለ	Čekkola	
ቸኮል	Čäkkol	
ቻለው	Čaläw	
ችሎታ	Čelota	
ችሎት	Čelot	
ችርቻሮ	Čerčaro	
ችቦ	Čebbo	
ችካል	Čekal	
ችኮላ	Čekkola	
ችግረኛ	Čeggeräñña	
ችግሬ	Čeggeré	
ችግር	Čegger	
ችግኝ	Čeggeññ	
ችፌ	Čefé	
ችፍርግ	Čefregg	
ኋላ	Hʷla	
ነሀሴ	Nähäsé	
ነሀስ	Nähäs	
ነህምያ	Nähmeya	
ነመራ	Nämära	
ነሚር	Nämir	
ነሲቡ	Näsibu	
ነሲብ	Näsib	
ነስር	Näser	
ነቀምቴ	Näqämté	
ነቀርሳ	Näqärsa	
ነቀዝ	Näqäz	
ነቁጥ	Näwariwočč	
ነቂስ	Näqis	
ነቅንቅ	Näqneq	
ነቅአ ጥበብ	Näqä-Ṭebäb	
ነቅእ ጥበብ	Näq'ä-Ṭebäb	
ነበልባል	Näbälbal	
ነበበ	Näbbäbä	
ነበበች	Näbbäbäčč	
ነቢብ	Näbib	
ነቢየ	Näbiyyä	
ነቢዩ	Näbiyyu	
ነቢያት	Näbiyat	
ነቢይ	Näbiyy	
ነባራዊ	Näbarawi	
ነባር	Näbbar	
ነባቢት	Näbabit	
ነባይ	Näbay	
ነብራይ	Näbray	
ነብር	Näber	
ነብሮ	Näbro	
ነት	Nät	
ነነዌ	Nänäwé	
ነአሚ	Nä'ämi	
ነአኩቶ ለአብ	Nä'äkkutoLä'äb	
ነኢብ	Nä'ib	
ነካሽ	Näkaš	
ነክ	Näkk	
ነዋሪ	Näwari	
ነዋሪዎች	Näwariwočč	
ነውረኛ	Näwräñña	
ነዝናዛ	Näznazza	
ነዲድ	Nädid	
ነዳይ	Näday	
ነዳጅ	Nädaj	
ነዶ	Nädo	
ነጃ	Näjo	
ነጆ	Näjo	
ነገ	Nägä	
ነገሌ	Nägällé	
ነገረ ሰሪ	Nägärä-Säri	
ነገረ በላ	Nägärä-Bälla	
ነገረ ፈጅ	Nägärä-Fäjj	
ነገር	Nägär	
ነገር በላ	Nägärä-Bälla	
ነገሮች	Nägäročč	
ነገሰ	Näggäsä	
ነገስታት	Nägästat	
ነገስት	Nägäst	
ነገዎ	Nägäwo	
ነገደ	Nägädä	
ነጋ	Nägga	
ነጋሪት	Nägarit	
ነጋሲ	Nägasi	
ነጋሳ	Nägasa	
ነጋሽ	Nägaš	
ነጋዴ	Näggadé	
ነጋዴዎች	Näggadéwočč	
ነጋድራስ	Näggadras	
ነጐዴ	Nägodé	ነጎዴ
ነጐድጓድ	Nägodgʷd	ነጎድጓድ
ነጠረች	Näṭṭäräčč	
ነጠብጣብ	Näṭäbṭab	
ነጣቂ	Näṭaqi	
ነጥር	Näṭer	
ነጥብ	Näṭeb	
ነጥቦች	Näṭbočč	
ነጭ	Näč̣č̣	
ነጭናጫ	Näč̣nač̣č̣a	
ነጮ	Näč̣č̣o	
ነጸረ	Näṣṣärä	
ነጸብራቅ	Näṣäbraq	
ነጻ	Näṣa	
ነጻነት	Näṣannät	
ነፋሲት	Näfasit	
ነፋስ መውጫ	NäfasMäwč̣a	
ነፋሻ	Näffašša	
ነፍራቃ	Näfraqqa	
ነፍሰ ገዳይ	Näfsä-Gäday	
ነፍሳት	Näfsat	
ነፍስ	Näfs	
ነፍስ ወከው	NäfsWäkkäf	
ነፍስ ወከፍ	NäfsEäkkäf	
ነፍስ ገዳይ	Näfsä-Gäday	
ነፍሶ	Näfso	
ነፍጠኛ	Näṭäñña	
ነፍጥ	Näfṭ	
ነፍጥ	Näfṭ	
ኑማን	Numan	
ኑረዲን	Nuräddin	
ኑሩ	Nuru	
ኑሪ	Nuri	
ኑሪያ	Nuriya	
ኑር	Nur	
ኑሮ	Nuro	
ኑዛዜ	Nuzzazé	
ኑፋቄ	Nufaqé	
ኒማን	Niman	
ኒሻን	Nišan	
ኒቆዲሞስ	Niqodimos	
ኒነት	Kinät	
ኒያላ	Niyala	
ናሁ ሰናይ	NahuSännay	
ናሁሰናይ	NahuSännay	
ናሆም	Nahom	
ናላ	Nala	
ናሙና	Namuna	
ናርዶስ	Naredos	
ናርጅ	Narj	
ናስ	Nas	
ናስር	Naser	
ናቄ	Naqé	
ናቅፋ	Naqfa	
ናቡከደነጾር	Nabukädänäṣor	
ናትራ	Natra	
ናትናኤል	Natna'él	
ናኣድ	Na'od	
ናኦድ	Na'od	
ናዝራዊ	Nazrawi	
ናዝሬት	Nazrét	
ናይዝጊ	Nayzgi	
ናደው	Nadäw	
ናጂ	Naji	
ናጫ	Nač̣č̣a	
ንረዮ	Nere'äyyo	
ንርእዮ	Nere'äyyo	
ንሰብሆ	Nesébbeho	
ንሴብሆ	Nesébbeho	
ንስጥሮስ	Nesṭeros	
ንሽ	Nešš	
ንቁ	Nequ	
ንቃቃት	Neqaqat	
ንቃተ ህሊና	Neqatä-Hellina	
ንቃት	Neqat	
ንቅሳት	Neqqesat	
ንቅናቄ	Neqennaqé	
ንበርጋ	Nebärga	
ንቢይ	Näbiyy	
ንባቡ	Nebabu	
ንባብ	Nebab	
ንብ	Neb	
ንብረት	Nebrät	
ንኡስ	Ne'us	
ንክ	Nek	
ንዋየ	Newayä	
ንዋይ	Neway	
ንዳደ	Nedad	
ንዳድ	Nedad	
ንዴት	Neddét	
ንድፈ	Nedfä-	
ንድፍ	Nedef	
ንጉማ	Neguma	
ንጉሩ	Neguru	
ንጉሰ	Negusä-	
ንጉሱ	Negusu	
ንጉሳዊ	Negusawi	
ንጉሳይ	Negusay	
ንጉሴ	Negusé	
ንጉስ	Negus	
ንጋቱ	Negatu	
ንጋት	Negat	
ንጋቷ	Negatʷ	
ንግስተ	Negestä-	
ንግስቲ	Negesti	
ንግስት	Negest	
ንግድ	Negd	
ንግግር	Negegger	
ንጣፍ	Neṭaf	
ንጥረ	Neträ-	
ንጥር	Neṭer	
ንጥቂያ	Neṭqiya	
ንጹሄ	Neṣuhé	
ንጹህ	Neṣuh	
ንጽህና	Neṣehenna	
ንፉግ	Nefug	
ንፍሮ	Nefro	
ንፍቀ	Nefqä-	
ንፍቅ	Nefq	
ንፍታሌም	Neftalém	
ንፍጥ	Nefṭ	
ንፍፊት	Nefeffit	
ኖህ	Noh	
ኖላዊ	Nolawi	
ኖራ	Nora	
ኖባ	Noba	
አሀዝ	Ahäz	
አሀዱ	Ahädu	
አሁን	Ahun	
አህመዲን	Ahmädin	
አህመድ	Ahmäd	
አህሙ	Ahmu	
አህያ	Aheyya	
አህያ ፈጅ	AheyyaFäjj	
አህደሮም	Ahdärom	
አህጉራዊ	Ahegurawi	
አህጉር	Ahegur	
አህጽሮተ	Ahṣerotä-	
አለ	Alä	
አለላ	Aläla	
አለሌ	Alälé	
አለልኝ	Allälleññ	
አለሎ	Alällo	
አለማሁ	Alämmahu	
አለማሽ	Alämaš	
አለም	Aläm	
አለምንህ	Alamneh	
አለባቸው	Alläbaččäw	
አለብላቢት	Aläblabit	
አለንጋ	Alänga	
አለኝታ	Alläñta	
አለካክ	Alläkak	
አሉ ባልታ	Alu-Balta	
አሉላ	Alula	
አሉብልታ	Alu-Balta	
አሉታ	Aluta	
አሊ	Ali	
አሊ ሚራህ	Ali-Mirah	
አሊ አምረው	Ali-Amerräw	
አሊ ጋዝ	Ali-Gaz	
አሊያ ነሽ	AliyaNäš	
አሊፍ	Aléf	
አላማጣ	Allamaṭa	
አላምረው	Alamerräw	
አላምንህ	Alamneh	
አላሰቡ	Alassäbu	
አላባ	Alaba	
አላባ ቁሊቶ	AlabaQullito	
አላድ	Alad	
አሌፍ	Aléf	
አል አሚን	Al-Amin	
አል አሜን	Al-Amin	
አልማማው	Almamaw	
አልማው	Almaw	
አልማዝ	Almaz	
አልሞት ባይ	Almot-Bay	
አልሞት ባይ	Almot-Bay	
አልቃሽ	Alqaš	
አልቅት	Alqett	
አልቅትት	Alqett	
አልባ	Alba	
አልባሳት	Albasat	
አልባቤ	Albabé	
አልባብ	Albab	
አልባነት	Albannät	
አልብቤ	Albabé	
አልቦ	Albo	
አልቦ	Albo	
አልቲት	Altit	
አልታሽ	Altaššä	
አልታየ	Altayyä	
አልታዩ	Altayyé	
አልታዬ	Altayyé	
አልትዩ	Altayyé	
አልአዛር	Al'äzar	
አልዩ	Aleyyu	
አልጋ	Alga	
አልጋ ነሽ	AlgaNäš	
አልጣሽ	Aleṭaš	
አልጫ	Alleč̣č̣a	
አመሀ የስ	Ammehä-Yyäs	
አመሄ	Amähé	
አመለ	Amälä-	
አመለኛ	Amäläñña	
አመለጥ	Amälläṭ	
አመልሳ	Amälsa	
አመልካች	Amälkač	
አመራር	Ammärar	
አመራሮ	Amäraro	
አመርጋ	Amärga	
አመነ	Ammänä	
አመኑ	Ammänu	
አመንሲሳ	Amänsissa	
አመንሲስ	Amänsissa	
አመንዝራ	Amänzera	
አመክሮ	Amäkkero	
አመዘነች	Amäzzänäčč	
አመዳም	Amädam	
አመዳይ	Amäday	
አመዴ	Amädé	
አመድ	Amäd	
አመጣጥ	Ammäṭaṭ	
አመጸኛ	Amäṣäñña	
አመጽ	Amäṣ	
አሙካ	Amukka	
አሚር	Amir	
አሚነ	Aminä-	
አሚኑ	Aminu	
አሚና	Amina	
አሚን	Amin	
አማላጅ	Ammalaj	
አማረ	Amarä	
አማረች	Amaräčč	
አማራ	Amara	
አማራጭ	Ammarač̣	
አማሬሳ	Ammarréssa	
አማርኛ	Amareñña	
አማት	Amat	
አማች	Amač	
አማኑኤል	Amanu'él	
አማን	Aman	
አማአክለ	Ama'ekälä	
አማእከለ	Ama'ekälä	
አማከለች	Amakkäläčč	
አማካሪ	Ammakari	
አማካይ	Ammakay	
አሜን	Amén	
አሜከላ	Amékäla	
አምሀ	Ammehä	
አምሀ የስ	AmmehäYyäs	
አምሄ	Amähé	
አምለሰት	Amläsät	
አምላኪ	Amlaki	
አምላክ	Amlak	
አምላክነት	Amlakennät	
አምልኮ	Amleko	
አምልኮት	Amlekot	
አምራች	Amrač	
አምሳለ	Amsalä	
አምሳለች	Amsaläčč	
አምሳሉ	Amsalu	
አምሳያ	Amsayya	
አምስተኛ	Ammestäñña	
አምስት	Ammest	
አምሾ	Amšo	
አምበሉ	Ambälu	
አምበል	Ambäl	
አምበርበር	Ambärber	
አምበርብር	Ambärber	
አምበዛ	Ambazza	
አምቡላ	Ambulla	
አምባ ላይ	Amba Lay	
አምባ ላጌ	Ambalagé	
አምባ ቄጦ	Amba Qéṭo	
አምባ ገነን	Amba Gännän	
አምባ ገነንነት	Amba Gännänennät	
አምባ ጓሮ	Amba Gʷro	
አምባር	Ambar	
አምባሻ	Ambašša	
አምባቸው	Ambaččäw	
አምባው	Ambaw	
አምባዛ	Ambazza	
አምባዬ	Ambayé	
አምቦ	Ambo	
አምና	Amna	
አምደ	Amdä-	
አምደ የሱስ	Amdä-Yyäsus	
አምዴ	Amdé	
አምድ	Amd	
አምዶም	Amdom	
አሞሌ	Amolé	
አሞራ	Amora	
አሞተ ቢስ	Amotä-Bis	
አሞተ ኩሩ	Amotä-Kuru	
አሞት	Amot	
አሞጭ	Amoč̣	
አሞጽ	Amoṣ	
አረሆ	Aräho	
አረመኔ	Arämäné	
አረማሞ	Arämamo	
አረማዊ	Arämawi	
አረም	Aräm	
አረሩ	Aräru	
አረስእት	Are'est	
አረቄ	Aräqi	
አረቦ	Aräbo	
አረቦን	Aräbon	
አረንዛ	Aränza	
አረንጓዴ	Arängʷdé	
አረዳ	Arädda	
አረጋ	Arägga	
አረጋሽ	Aräggš	
አረጋኸኝ	Aräggak̃äññ	
አረጋዊ	Arägawi	
አረጋይ	Arägay	
አረግ	Aräg	
አረጓ	Arägʷ	
አረጣ	Araṭa	
አረፈ	Arräfä	
አረፈ ኣይኔ	ArräfäAyné	
አረፋ	Aräfa	
አሩሲ	Arusi	
አሩት	Arut	
አራሙቻ	Arramučča	
አራሚ	Arrami	
አራራይ	Araray	
አራስ	Aras	
አራሽ	Araš	
አራቢ	Arrabi	
አራባ	Arraba	
አራተኛ	Arattäñña	
አራት	Aratt	
አራዊት	Arawitt	
አራዳ	Arada	
አራጅ	Araj	
አራጋው	Arragaw	
አራጣ	Araṭa	
አሬራ	Aréra	
አሬው	Feréw	
አርማ	Arma	
አርምሞ	Armemo	
አርምዴ	Armedé	
አርሲ	Arsi	
አርስጣጣሊስ	Aresṭaṭalis	
አርሶ አደር	Arso-Addär	
አርሽም	Aršem	
አርበኛ	Arbäñña	
አርበኞች	Arbäññočč	
አርቢ	Arbi	
አርባ	Arba	
አርባ ምንጭ	Arba Menč̣	
አርባጫ	Arbač̣č̣a	
አርብ	Arb	
አርነት	Arennät	
አርአያ	Ar'äya	
አርእስት	Are'est	
አርዌ	Arwé	
አርያም	Areyam	
አርዮስ	Areyos	
አርድእት	Arde'et	
አርጃኖ	Arjano	
አርጆ	Arjo	
አርጋኖን	Arganon	
አርጋው	Argaw	
አርጐባ	Argobba	
አርጩሜ	Arč̣ummé	
አርፍጮ	Arfeč̣č̣o	
አሮንቃ	Aronqa	
አሮጊት	Arogit	
አሮጌ	Arogé	
አሰለጥ	Asälläṭ	
አሰለፈች	Assälläfäčč	
አሰለፍ	Assälläf	
አሰላ	Assälla	
አሰልፍ	Assällef	
አሰማ	Asama	
አሰማኸኝ	Assämmak̃äññ	
አሰሜ	Assämé	
አሰሪ	Assärri	
አሰሳ	Asäsa	
አሰስ ገሰስ	Asäs Gäsäs	
አሰበ	Asbä	
አሰበ ተፈሪ	Asäbä-Täfäri	
አሰብ	Assäb	
አሰቦ	Asäbo	
አሰቦት	Asäbot	
አሰን	Asän	
አሰንዳቦ	Asändabo	
አሰገሰች	Assäggädäčč	
አሰገደች	Assäggädäčč	
አሰጋሽ	Asäggaš	
አሰግደው	Assäggedäw	
አሰግድ	Assägged	
አሰፉ	Asäffu	
አሰፋ	Asäffa	
አሰፋሽ	Asäffaš	
አሰፋች	Asäffačč	
አሲምባ	Asimba	
አሲዳም	Asidam	
አሳ	Asa	
አሳልፍ	Asallef	
አሳመረ	Asammärä	
አሳመነች	Asammänäčč	
አሳማ	Asama	
አሳምነው	Asammenäw	
አሳረኛ	Asaräñña	
አሳሽ	Assaš	
አሳብ	Assab	
አሳታሚ	Asattami	
አሳቻ	Assačča	
አሳየኸኝ	Asayyäk̃äññ	
አሳየኽኝ	Asayyäk̃äññ	
አሳይታ	Asayta	
አሳዳሪ	Asaddari	
አሳዳጅ	Assadaj	
አሳዳጊ	Asaddagi	
አሳፋሪ	Asaffari	
አስለቃሽ	Asläqqaš	
አስላ	Assälla	
አስልቃሽ	Asläqqaš	
አስልፍ	Assällef	
አስመላሽ	Asmällaš	
አስመረት	Asmärät	
አስመሪና	Asmärina	
አስመራ	Asmära	
አስመሮም	Asmärom	
አስመነች	Asammänäčč	
አስመጭና	Asmäččenna-	
አስማማው	Asmamaw	
አስማረ	Asmarä	
አስማተኛ	Asmatäñña	
አስማት	Asmat	
አስማይት	Asmayet	
አስሜ	Assämé	
አስምራቸው	Asmeraččäw	
አስረሳኸን	Asrässak̃äññ	
አስረሳኸኝ	Asrässak̃äññ	
አስረስ	Asräss	
አስረኛ	Asseräñña	
አስረጅ	Asräjj	
አስረግደው	Asräggedäw	
አስራተ	Asrat	
አስራቴ	Asraté	
አስራት	Asrat	
አስራጋ	Asraga	
አስር	Asser	
አስቦት	Asäbot	
አስተላላፊ	Astälalafi	
አስተርእዮ	Astär'eyo	
አስተርጓሚ	Astärgʷmi	
አስተሳሰብ	Astäsasäb	
አስተባባሪ	Astäbabari	
አስተናባሪ	Astänabari	
አስተናጋጅ	Astänagaj	
አስተናግር	Astänager	
አስተካካይ	Astäkakay	
አስተዋይ	Astäway	
አስተዋጽኣ	Astäwaṣe'o	
አስተዋጽኦ	Astäwaṣe'o	
አስተያየት	Astäyayät	
አስተዳር	Estädar	
አስተዳደር	Astädadär	
አስተዳደግ	Astädadäg	
አስተዳዳሪ	Astädadari	
አስተድዳሪ	Astädadari	
አስታ	Asta	
አስታማሚ	Astamami	
አስታጥቄ	Astaṭqé	
አስቴር	Astér	
አስትላላፊ	Astälalafi	
አስትረእዮ	Astär'eyo	
አስትናባሪ	Astänabari	
አስትናጋጅ	Astänagaj	
አስቸጋረ	Asčäggari	
አስቸጋሪ	Asčäggari	
አስቻለው	Asčaläw	
አስናቀ	Asnaqä	
አስናቀች	Asnaqäčč	
አስንቀ	Asnaqä	
አስከልካይ	Askälkay	
አስከሬን	Askärén	
አስኪያጅ	Askiyaj	
አስካለ	Askalä	
አስካል	Askal	
አስክልካይ	Askälkay	
አስኳል	Askʷl	
አስገባረ	Asgäbbari	
አስገባሪ	Asgäbbari	
አስገዶም	Asgädom	
አስጨናቂ	Asč̣ännaqi	
አስጨንቀው	Asč̣änneqäw	
አስፈሪ	Asfärri	
አስፈራቸው	Asfärraččäw	
አስፋ ወሰን	Asfa-Wäsän	
አስፋው	Asfaw	
አስፍሀ	Asfehä	
አሸባሪ	Aššäbbari	
አሸብር	Aššäbber	
አሸቦ	Ašabo	
አሸነ	Aššänä	
አሸናፊ	Aššännafi	
አሸንክታብ	Ašänketab	
አሸንዳ	Ašända	
አሸንጌ	Ašängé	
አሸዋ	Ašäwa	
አሹቅ	Ašuq	
አሻሚ	Aššami	
አሻራ	Ašara	
አሻሮ	Ašaro	
አሻሻ	Ašaša	
አሻሻጭ	Aššašač̣	
አሻንጉሊት	Ašangullit	
አሻገረች	Aššaggäräčč	
አሻግሬ	Aššagré	
አሻጥረኛ	Ašaṭeräñña	
አሻጥር	Ašaṭer	
አሽሙር	Ašmur	
አሽሟጣጭ	Ašmʷṭač̣	
አሽብራቂ	Ašäbraqi	
አሽብር	Aššäbber	
አሽኔ	Aššené	
አሽከር	Aškär	
አሽከርካረ	Aškärkari	
አሽከርካሪ	Aškärkari	
አሽከርካሪዎች	Aškärkariwočč	
አሽካኪታ	Aškakitta	
አሽክላ	Aškella	
አሽክት	Aškett	
አቀበት	Aqäbät	
አቀባባይ	Aqqäbabay	
አቀባይ	Aqäbbay	
አቀንቃኝ	Aqänqaññ	
አቀፍ	Aqqäf	
አቁባ	Aquba	
አቃቂ	Aqaqi	
አቃቂር	Aqaqir	
አቃቅማ	Aqaqma	
አቃቢ	Aqqabi	
አቃቢት	Aqqabit	
አቃቤ	Aqqabé	
አቃጣሪ	Aqqaṭari	
አቅመ ቢስ	Aqmä-Bis	
አቅማዳ	Aqmada	
አቅም	Aqm	
አቅራቢያ	Aqrabbiya	
አቅቢ	Aqqabi	
አቅኚ	Aqñi	
አቅድ	Eqqed	
አቅጣጫ	Aqṭač̣č̣a	
አቆልቋይ	Aqolqʷy	
አቆማዳ	Aqomada	
አቆርዳት	Aqqordat	
አቆአጣጠር	Aqqoṭaṭär	
አቆጣጠር	Aqqoṭaṭär	
አቋም	Aqʷm	
አበ	Abä-	
አበል	Abäll	
አበሩ	Abbäru	
አበራ	Abärra	
አበራሽ	Abärraš	
አበርገል	Abärgäl	
አበሱዳ	Abäsuda	
አበሳ	Abäsa	
አበሻ	Abäša	
አበቅቴ	abäqté	
አበበ	Abbäbä	
አበበች	Abbäbäčč	
አበባ	Abäba	
አበባው	Abäbaw	
አበው	Abäw	
አበዙ	Abäzzu	
አበዛች	Abäzzačč	
አበያ	Abäya	
አበይት	Abbäyt	
አበዳሪ	Abäddari	
አበጀ	Abäjjä	
አበጋር	Abbägar	
አበጋዝ	Abägaz	
አቡ	Abbu	
አቡሻከር	Abušaker	
አቡሻክር	Abušaker	
አቡቀዳዲ	Abuqädadi	
አቡበከር	Abubäkär	
አቡነ	Abunä-	
አቡን	Abun	
አቡዬ	Abbuyyé	
አቡድ	Abud	
አቡጀዲ	Abujädi	
አቢ	Abbi	
አቢራር	Abirar	
አቢይ	Abiyy	
አቢጋር	Abégar	
አባ	Abba	
አባ ወራ	Abba-Wärra	
አባ ዲና	AbbaDina	
አባ ድሽቃ	Abbadéšqa	
አባ ጨጓሬ	AbbaČ̣äggʷrré	
አባል	Abal	
አባል ዘርእ	Abalä-Zär'e	
አባስ	Abbas	
አባቡ	Abbabbu	
አባተ	Abatä	
አባት	Abbat	
አባት ሁን	AbbatHun	
አባያ	Abaya	
አባይ	Abbay	
አባይ	Abbay	
አባይ ነህ	AbbayNäh	
አባይ ነሽ	AbbayNäš	
አባዲ	Abbadi	
አባዲሽቃ	Abbaadéšqa	
አባዲና	AbbaDina	
አባድር	Abader	
አባጣ	Abaṭa	
አቤል	Abél	
አቤሴሎም	Abésélom	
አቤቱታ	Abétuta	
አቤቶ	Abéto	
አቤቶ ሁን	AbétoHun	
አብ	Ab	
አብለ ዘርእ	Abalä-Zär'e	
አብላሊት	Ablalit	
አብራር	Abrar	
አብራክ	Abrak	
አብርሂት	Abrehit	
አብርሃ	Abreha	
አብርሃም	Abreham	
አብሱዳ	Abäsdua	
አብሲት	Absit	
አብሽ	Abeš	
አብሽሎ	Abšello	
አብሾ	Abešo	
አብሿም	Abešʷm	
አብቅቴ	Abäqté	
አብተው	Abetäw	
አብቹ	Abbečču	
አብነት	Abennät	
አብየ	Abbeyyä	
አብያተ	Abeyatä-	
አብዮተኛ	Abeyotäñña	
አብዮተኞች	Abeyotäññočč	
አብዮታዊ	Abeyotawi	
አብዮታዊት	Abeyotawit	
አብዮታውያን	Abeyotaweyan	
አብዮት	Abeyot	
አብደላ	Abdälla	
አብደረብ	Abdäräb	
አብደታ	Abdäta	
አብዱ	Abdu	
አብዱ ራህማን	Abdurahman	
አብዱላሂ	Abdullahi	
አብዱል	Abdul	
አብዱል ራሂም	AbdulRahim	
አብዱል ቃኒ	AbdulQani	
አብዱል ቃድር	AbdulQader	
አብዱል ከሪም	AbdulKärim	
አብዱራሂም	Abdurahim	
አብዱራህማን	Abdurahman	
አብዱር ቃድር	AbdurQader	
አብዲ	Abdi	
አብድል ጋውሪ	AbdälGawri	
አብድረቦ	Abderäbo	
አብዶ	Abdo	
አብዶሽ	Abdoš	
አብጠው	Abbeṭäw	
አብጤ	Abbeṭé	
አቦ ነሽ	AbboNäš	
አቦል	Abol	
አቦማ	Aboma	
አቦሬ	Aboré	
አቧራ	Abʷra	
አቧሬ	Abʷré	
አተላ	Atäla	
አተቴ	Atäté	
አቲከም	Atikäm	
አቲካም	Atikäm	
አታለል	Attalläl	
አታላ	Attalla	
አታላይ	Attalay	
አታሞ	Atamo	
አታክልቴ	Atakelté	
አታክልት	Atakelt	
አቴና	Aténa	
አትለይ	Attelläy	
አትርሳው	Attersaw	
አትሮንስ	Atrones	
አትባራ	Atbara	
አትናቴዎስ	Atnatéwos	
አትናጐ	Atnago	
አትክልተኛ	Atkeltäñña	
አትክልት	Atkelt	
አትገኝ	Atteggäññ	
አትጠገብ	Atteṭṭäggäb	
አቸነፈች	Aččännäfäčč	
አቸናፊ	Aččännafi	
አቸዘ	Ačäzän	
አቸዘን	Ačäzän	
አቸፈር	Ačäfär	
አቻ	Ačča	
አቻም የለሽ	Aččamm-Yälläš	
አቻምና	Aččamna	
አችፈር	Ačäfär	
አነር	Anär	
አነሳሽ	Annäsaš	
አነስተኛ	Anästäñña	
አነባበሮ	Annäbabäro	
አናጉንስጢስ	Anagunesṭis	
አናጋው	Annagaw	
አናጢ	Anaṭi	
አንለይ	Annelläy	
አንልይ	Annelläy	
አንሴቦ	Ansébo	
አንስታይ	Anestay	
አንሶላ	Ansola	
አንሻ	Anša	
አንቀልባ	Anqälba	
አንቀጸ	Anqäṣä-	
አንቀጽ	Anqäṣ	
አንቃ	Anqa	
አንቃር	Anqar	
አንበሳ	Anbässa	
አንበሴ	Anbässé	
አንበጣ	Anbäṭa	
አንቦልክ	Anbolek	
አንተ	Antä	
አንተ ነህ	Antä Näh	
አንችን አሉ	Ančen-Alu	
አንከሊስ	Ankälis	
አንከርት	Ankärett	
አንከሮ	Ankero	
አንካሳ	Ankassa	
አንካሴ	Ankassé	
አንክርትት	Ankärett	
አንክሮ	Ankero	
አንኮ	Anko	
አንኮ በር	Ankobärr	
አንኮበር	Ankobärr	
አንኳር	Ankʷr	
አንደርብ	Andärebb	
አንደበት	Andäbät	
አንደታ	Andäta	
አንደኛ	Anddäñña	
አንዱ	Anddu-	
አንዳርጋቸው	Andargaččäw	
አንዳርጌ	Anddargé	
አንዳች	Anddačč	
አንዳፍታ	Anddafta	
አንዴ	Anddé	
አንድ	Andd	
አንድምታ	Anddemta	
አንድሬ	Anderré	
አንድነት	Anddennät	
አንዶም	Andom	
አንጀት	Anjät	
አንጀኛ	Anjäñña	
አንጃ	Anja	
አንጆ	Anjo	
አንገረብ	Angärebb	
አንገርብ	Angärebb	
አንጉላላ	Angoläla	
አንጋሬ	Angarré	
አንጋው	Angaw	
አንጋጋው	Angagaw	
አንጋፋ	Angaffa	
አንጐለላ	Angoläla	
አንጐል	Angol	
አንጐት	Angot	
አንጓ	Angʷ	
አንጓቼ	Angʷčé	
አንጓዴ	Angʷčé	
አንጥረኛ	Anṭeräñña	
አንጥጮ	Anṭeč̣č̣o	
አንጸባራቂ	Anṣäbaraqi	
አንጻራዊ	Anṣarawi	
አንጻር	Anṣar	
አንፊላ	Anfilla	
አንፊሎ	Anfillo	
አንፋር	Anfar	
አንፋሮ	Anfarro	
አእላፍ	A'elaf	
አእምሮ	A'emro	
አእዋፍ	A'ewaf	
አከለ	Akkälä	
አከርካሪ	Akrari	
አከፋፋይ	Akkäfafay	
አካሉ	Akalu	
አካላት	Akalat	
አካላዊ	Akalawi	
አካል	Akal	
አካሏ	Akalʷ	
አካባቢ	Akkababi	
አካባች	Akabač	
አካፋ	Akafa	
አክሊለ	Aklilä-	
አክሊሉ	Aklilu	
አክሊል	Aklil	
አክሎግ	Aklog	
አክምባሎ	Akembalo	
አክራሪ	Akrari	
አክርማ	Akerma	
አክሱም	Aksum	
አክስት	Akest	
አክበረት	Akbärät	
አክበር	Akbär	
አክበሮም	Akbärom	
አክብሮም	Akbärom	
አክብሮት	Akberot	
አክታ	Akketa	
አኮርባጅ	Akorbaj	
አኮፋዳ	Akofada	
አኳኋን	Akkʷhʷn	
አኳያ	Akkʷyya	
አወል	Awäl	
አወቀ	Awwäqä	
አወናባጅ	Awwänabaj	
አወዛጋቢ	Awwäzagabi	
አወዳሽ	Awäddaš	
አወዳደቅ	Awwädadäq	
አወጣሽ	Awäṭṭaš	
አወጣኸኝ	Awäṭṭak̃äññ	
አዋላጅ	Awwalaj	
አዋሳ	Awasa	
አዋሳኝ	Awwasañ	
አዋሽ	Awaš	
አዋቆ	Awaqo	
አዋዜ	Awazé	
አዋድ	Awad	
አዋጁ	Awaju	
አዋጅ	Awaj	
አውላላ	Awlalla	
አውላቸው	Awelaččäw	
አውላችው	Awelaččäw	
አውሎ ነፋስ	Awelo Näfas	
አውራ	Awra	
አውራሪስ	Awraris	
አውራጃ	Awrajja	
አውራጅ	Awraj	
አውሬ	Awré	
አውባቸው	Awebaččäw	
አውታር	Awtar	
አውታታ	Awtatta	
አውእሎም	Aw'älom	
አውደ	Awdä-	
አውደልዳይ	Awdälday	
አውድ	Awd	
አውድማ	Awdemma	
አውግስጦስ	Awgesṭos	
አውግቸው	Awgeččäw	
አውጣ እኬ	Awṭa'eké	
አውጣአኬ	Awṭa'eké	
አውጥ	Aweṭ	
አውጫጭኝ	Awč̣ač̣eññ	
አዘራር	Azrar	
አዘቅት	Azäqt	
አዘቦ	Azäbo	
አዘቦት	Azäbot	
አዘነ	Azzänä	
አዘነጋሽ	Azänäggaš	
አዘዜ	Azäzé	
አዘዞ	Azäzo	
አዙሪት	Azurit	
አዚዛ	Aziza	
አዚዝ	Aziz	
አዚፋ	Azifa	
አዛለች	Azaläčč	
አዛማጅ	Azzamaj	
አዛርያ	Azareya	
አዛርያስ	Azareyas	
አዛባ	Azaba	
አዛናው	Azzanaw	
አዛውንት	Azawent	
አዛዥ	Azzaz̃	
አዜብ	Azéb	
አዝመራ	Azmära	
አዝሙድ	Azmud	
አዝማሚያ	Azmammiya	
አዝማረ	Azmari	
አዝማሪ	Azmari	
አዝማች	Azmač	
አዝማጅ	Azzamaj	
አዝራር	Azrar	
አዝርእት	Azre'et	
አዝጋሚ	Azgami	
አዞ	Azzo	
አየሁ	Ayyähu	
አየለ	Ayyälä	
አየለች	Ayyäläčč	
አየሉ	Ayyälu	
አየር	Ayyär	
አየነው	Ayyänäw	
አያሌ	Ayyalé	
አያሌው	Ayyaléw	
አያል ነህ	AyyalNäh	
አያል ነሽ	AyyalNäš	
አያት	Ayat	
አያና	Ayyana	
አያኔ	Ayyané	
አያንቱ	Ayyantu	
አያኖ	Ayyano	
አይሁድ	Ayhud	
አይመለል	Aymäläl	
አይሸሽም	Ayšäšemm	
አይሻ	Ayša	
አይብ	Ayb	
አይታገድ	Ayettagäd	
አይትክቱ	Aytaktu	
አይትገድ	Ayettagäd	
አይናዲስ	Aynadis	
አይከል	Aykäl	
አይደርቄ	Aydärqé	
አይዳ	Ayda	
አይዳኝ	Ayeddaññ	
አይድ	Ayyed	
አይድሩስ	Aydrus	
አይጠ መጐጥ	Ayṭä-Mägoṭ	
አይጠየፍ	Ayeṭṭäyyäf	
አይጠገብ	Ayeṭṭäggäb	
አይጥ	Ayṭ	
አዮ	Ayyo	
አደመ	Addämä	
አደም	Adäm	
አደራ	Adära	
አደራዬ	Adärayé	
አደሬ	Adäré	
አደስ	Adäs	
አደባባይ	Addäbabay	
አደንጓሬ	Adängʷrré	
አደይ	Adäy	
አደገ	Addägä	
አደገኛ	Adägäñña	
አደጋ	Adäga	
አደፍርስ	Adäfres	
አዱሊስ	Adulis	
አዱኛ	Adduñña	
አዲ ሸሁ	Addi-Šähu	
አዲ ቀይህ	Addi-Qäyyeh	
አዲ ተከለዛን	Addi-Täkkäzzan	
አዲ አርቃይ	Addi-Arqay	
አዲ ኡግሪ	Addi-Ugri	
አዲ ኳላ	Addi-Kʷla	
አዲ ግራት	Addi-Getat	
አዲሱ	Addisu	
አዲሲቷ	Addisitʷ	
አዲሴ	Addisé	
አዲስ	Addis	
አዲስ አለም	AddisAläm	
አዲስ አበባ	AddisAbäba	
አዲስ ኣለም	AddisAläm	
አዲቦ	Adébo	
አዳል	Adal	
አዳሙ	Addamu	
አዳም	Addam	
አዳራሽ	Addaraš	
አዳስ	Addas	
አዳሽ	Addaš	
አዳባ	Adaba	
አዳነ	Adanä	
አዳነች	Adanäčč	
አዳጋ	Adaga	
አዳፍሬ	Addafré	
አድሀሪ	Adhäri	
አድሀርያን	Adhäreyan	
አድሃና	Adhana	
አድሃኖም	Adhanom	
አድላዊ	Adlawi	
አድላዎ	Adlewo	
አድልዎ	Adlewo	
አድመኛ	Admäñña	
አድማ	Adma	
አድማሱ	Admasu	
አድማሴ	Admasé	
አድማስ	Admas	
አድማሷ	Admasʷ	
አድምቄ	Admeqé	
አድምጤ	Admeṭé	
አድሩስ	Adrus	
አድራጐት	Adragot	
አድር ባይ	Ader-Bay	
አድባራት	Adbarat	
አድባር	Adbar	
አድነው	Adenäw	
አድአ	Adwa	
አድዋ	Ad'ä	
አድጉይ	Adgoy	
አድጐይ	Adgoy	
አጀብ	Ajäb	
አጀንዳ	Ajända	
አጃቢ	Ajjebi	
አጅሬ	Ajjeré	
አጅበው	Ajjebäw	
አጅቢ	Ajjabi	
አገልግል	Agälgel	
አገረ	Agärä-	
አገር	Agär	
አገናዛቢ	Aggänazabi	
አገኘሁ	Agäññähu	
አገው	Agäw	
አገያ	Agäyya	
አገዳ	Agäda	
አገጭ	Agäč̣	
አጉላ	Agula	
አጉል	Agul	
አጊቦ	Agébo	
አጋ	Aga	
አጋሙዳ	Agamudda	
አጋሚዶ	Agamiddo	
አጋማሽ	Aggamaš	
አጋሜ	Agamé	
አጋም	Agam	
አጋር	Aggar	
አጋሮ	Aggaro	
አጋሰስ	Agassäs	
አጋቦስ	Agabos	
አጋንንት	Aganent	
አጋዘን	Agazän	
አጋጣሚ	Aggaṭami	
አጋጭ	Agäč̣	
አጋፋሪ	Aggafari	
አጌቦ	Agébo	
አግ አዚ	Ag'äzi	
አግማሴ	Agmasé	
አግቦ	Agbo	
አግአዚ	Ag'äzi	
አግአዚት	Ag'äzit	
አግአዚያን	Ag'äzeyan	
አግአዝያን	Ag'äzeyan	
አግዛቸው	Aggezaččäw	
አግደው	Aggedäw	
አግዳሚ	Agdami	
አግዴ	Aggedé	
አግድም	Agdem	
አጐበር	Agobär	
አጐብጓቢ	Agobgʷbi	
አጐት	Aggot	
አጐናፍር	Aggonefar	
አጐዛ	Agoza	
አጓት	Aggʷt	
አጓዳኝ	Aggʷdaññ	
አጠቃላይ	Aṭṭäqalay	
አጠባበቅ	Aṭṭäbabäq	
አጣሪ	Aṭari	
አጣና	Aṭana	
አጣዳፊ	Aṭṭadafi	
አጣጥ	Aṭaṭ	
አጥላባቸው	Aṭlabbaččäw	
አጥላው	Aṭlaw	
አጥሌ	Aṭlé	
አጥሚት	Aṭmit	
አጥማጅ	Aṭmaj	
አጥቂ	Aṭqi	
አጥቂነት	Aṭqinnät	
አጥቢያ	Aṭbiya	
አጥናፈ	Aṭnafä-	
አጥናፉ	Aṭnafu	
አጥናፌ	Aṭnafé	
አጥናፍ	Aṭnaf	
አጥንት	Aṭent	
አጥፊ	Aṭfi	
አጨሌ	Ač̣älé	
አጨዳ	Ač̣äda	
አጭር	Ač̣č̣er	
አጵሎስ	Ap̣p̣elos	
አጸቀ	Aṣqä	
አጸደ	Aṣädä	
አጸድ	Aṣäd	
አጸፋ	Aṣäfa	
አጼ	Aṣé	
አጽመ ርስት	Asmä-Rest	
አጽሜ	Aṣmé	
አጽም	Aṣm	
አጽም ርስት	Aṣmä-Rest	
አጽቀ	Aṣqä-	
አጽቅ የለሽ	Asq-Yälläš	
አጽቅ ያለሽ	Aṣq-Yälläš	
አጽብሀ	Aṣbehä	
አጽዋማት	Aṣwamat	
አጽደ	Aṣädä	
አፈ	Afä-	
አፈ ላማ	Afä-Lama	
አፈ ወርቂ	Afä-Wärqi	
አፈ ወርቅ	Afä-wärq	
አፈሩ	Afärru	
አፈራሁ	Afärrahu	
አፈር	Afär	
አፈርሳታ	Afärsata	
አፈሳ	Afäsa	
አፈና	Afäna	
አፈንጋጭ	Afänggač̣	
አፈንጋጭ	Afänggač̣	
አፈኛ	Afäñña	
አፋፍ	Afaf	
አፍለኛ	Afläñña	
አፍሊ	Aflé	
አፍላ	Afla	
አፍላል	Aflal	
አፍላኛ	Afläñña	
አፍሌ	Aflé	
አፍረተ ስጋ	Afrätä-Sega	
አፍራሽ	Afraš	
አፍርሳታ	Afersata	
አፍርንጅ	Afrenj	
አፍቻለ	Afčal	
አፍቻል	Afčal	
አፍአዊ	Af'äwi	
አፍደም	Afdäm	
አፍጼ	Afṣé	
አፎቄ	Afoqé	
አፎት	Afot	
ኡመር	Umär	
ኡራኤል	Ura'él	
ኡርጌ	Urgé	
ኡርጌሳ	Urgéssa	
ኡስማን	Usman	
ኡኡታ	U'uta	
ኡውሱን	I-Wessun	
ኡደት	Udät	
ኢላላ	Ilala	
ኢላማ	Ilama	
ኢላበርእድ	Ilabär'ed	
ኢምንት	Iment	
ኢርቱእ	I-Retu'e	
ኢሰብአዊ	I-Säb'äwi	
ኢሳ	Issa	
ኢሳይያስ	Isayeyyas	
ኢብራሂም	Ibrahim	
ኢብሳ	Ibsa	
ኢቦ	Ibbo	
ኢተያ	Itteyya	
ኢቱ	Ittu	
ኢታና	Ittana	
ኢትየጵያ	Ityop̣eya	
ኢትያ	Itteyya	
ኢትዮጲስ	Ityop̣is	
ኢትዮጵያ	Ityop̣eya	
ኢትዮጵያዊ	Ityop̣eyawi	
ኢትዮጵያውያን	Ityop̣eyaweyan	
ኢውሱን	I-Wessun	
ኢዘዝ	Izäz	
ኢዛዝ	Izäz	
ኢየሩሳሌም	Iyyärusalém	
ኢየሱስ	Iyyäsus	
ኢየሱስ ሞላ	IyyäsusMo'a	
ኢየሱስ ሞኣ	IyyäsusMo'a	
ኢያሪኮ	Iyyariko	
ኢያሱ	Iyyasu	
ኢያቄም	Iyyaqém	
ኢዮብ	Iyyob	
ኢዮአስ	Iyyo'äs	
ኢዮአብ	Iyyo'äb	
ኢዮኤል	Iyyu'él	
ኣለመ	Alämä	
ኣለሙ	Alämu	
ኣለሚቱ	Alämitu	
ኣለማ ማያ	AlämMaya	
ኣለማየሁ	Alämayyähu	
ኣለሜ	Alämé	
ኣለም	Aläm	
ኣለም ማያ	Aläm Maya	
ኣለም ነህ	AlämNäh	
ኣለም ነሽ	AlämNäš	
ኣላማ	Alama	
ኣመተ	Amätä-	
ኣመተ የስ	Amätä-Yyäs	
ኣመቱ	Amätu	
ኣመቴ	Amäté	
ኣመት	Amät	
ኣምሀጀር	Omehäjär	
ኣሞናዳ	Omonada	
ኣርጋው	Argaw	
ኣስማ	Osman	
ኣይነ በጐ	Aynä-Bäggo	
ኣይነ ኩሉ	Aynä-Kullu	
ኣይነተኛ	Aynätäñña	
ኣይነት	Aynät	
ኣይን	Ayn	
ኣይን አውጣ	AynÄwṭa	
ኣዲ ቀይህ	Addi-Qäyyeh	
ኣዲ ተከለዛን	Addi-Täkkäläzzan	
ኣዲ አርቃይ	Addi-Ärqay	
ኣዲ ኡግሪ	Addi-Ugri	
ኣዲ ኳላ	Addi-Kʷla	
ኣዲ ግራት	Addi-Gerat	
ኤልሲ	Élsi	
ኤልሳ	Élsa	
ኤልሳቤጥ	Élsabéṭ	
ኤልያስ	Éleyas	
ኤልዳር	Élidar	
ኤረር	Érär	
ኤርምያስ	Érmeyas	
ኤርትራ	Értera	
ኤርትራዊ	Érterawi	
ኤርትራውያን	Érteraweyan	
ኤሳው	Ésaw	
ኤባ	Ébba	
ኤቶ	Étto	
ኤደን	Édän	
ኤዲቶ	Éditto	
ኤዳ	Éda	
ኤገኖ	Égäno	
ኤፌሶን	Éféson	
ኤፍሬም	Éfrém	
እሁድ	Ehud	
እህል	Ehel	
እህተ	Ehetä	
እህቴ	Eheté	
እህት	Ehet	
እህደጋ	Ehdägga	
እህዳጋ	Ehdägga	
እለት	Elät	
እሌኒ	Elléni	
እልልታ	Elelta	
እልመለክ	Elmäläk	
እልም ነህ	ElmNäh	
እልቂት	Elqitt	
እልቆ መሳፍርት	ElqoMäsafert	
እልበት	Elbät	
እልባት	Ellebat	
እልኸኛ	Ellek̃äñña	
እልኽ	Ellek̃	
እልፍ	Elf	
እልፍ ነሽ	ElfNäš	
እልፍነሽ	ElfNäš	
እልፍኝ	Elfeññ	
እመ	Emmä-	
እመ ምኔት	Emmä-Menét	
እመርታ	Emmärta	
እሙና	Emmuna	
እማማ	Emmamma	
እማኙ	Emmaññu	
እማኝ	Emmaññ	
እሜቴ	Emmété	
እምላእሉ	Em-La'elu	
እምሩ	Emmeru	
እምር	Emmer	
እምሻው	Emmešaw	
እምቡሽቡሽ	Embušbuš	
እምቡጥ	Embuṭ	
እምቢልታ	Embilta	
እምቢተኛ	Embitäññä	
እምቢተኛነት	Embitäññannät	
እምቢታ	Embita	
እምባሶይራ	Embasoyra	
እምባትካላ	Embatekalla	
እምባትክላ	Embatekalla	
እምባጮ	Embač̣č̣o	
እምቦሳ	Embossa	
እምቦቃቅላ	Emboqaqella	
እምቧይ	Embʷy	
እምቧጮ	Embʷč̣č̣o	
እምአእላፍ	Em-Ä'elaf	
እምወድሽ	Emmewäddeš	
እምድብር	Emdeberr	
እረኛ	Erräñña	
እረኛው	Erräññaw	
እረፍት	Eräft	
እራሪ	Errari	
እራቁት	Eraqut	
እራት	Erat	
እሬት	Erét	
እርማት	Erremat	
እርምጃ	Ermejja	
እርሳስ	Ersam	
እርስ በርስ	Ers-Bärs	
እርስቴ	Eresté	
እርስዎ	Ersewo	
እርሻ	Erša	
እርሾ	Eršo	
እርቁ	Erqu	
እርቃን	Erqan	
እርቅ	Erq	
እርቢ	Erebbi	
እርባር	Erban	
እርባታ	Erbata	
እርባን	Erban	
እርብራብ	Erebrab	
እርቦ	Erbo	
እርከን	Erkän	
እርኩም	Erkum	
እርካብ	Erkab	
እርኰት	Erkot	
እርዝቅ	Erzeq	
እርያ	Ereya	
እርዳታ	Erdata	
እርዳው	Erdaw	
እርድ	Erd	
እርጅና	Erjenna	
እርገቱ	Ergätu	
እርገት	Ergät	
እርገጤ	Ergäṭé	
እርጉዝ	Erguz	
እርጋጭ	Ereggač̣	
እርግማን	Ergeman	
እርግብ	Ergeb	
እርግብግቢት	Ergebgebit	
እርግጫ	Ergeč̣č̣a	
እርጥባን	Erṭeban	
እርጥብ	Erṭeb	
እሰዬ	Essäyé	
እሱ ባለው	EssuBaläw	
እሱ ነህ	EssuNäh	
እሳተ ገሞራ	Esatä-Gämora	
እሳቱ	Esatu	
እሳት	Esat	
እሴተ	Essétä	
እስላም	Eslam	
እስማኤል	Esma'él	
እስራት	Esserat	
እስር	Eser	
እስስት	Esest	
እስተዳር	Estädar	
እስትንፋስ	Estenfas	
እስትንፍስ	Estenfas	
እስክስታ	Eskesta	
እስክንድር	Eskender	
እስጢፋኖስ	Esṭifanos	
እሸቱ	Ešätu	
እሸቴ	Ešäté	
እሸት	Ešät	
እሽታ	Eššeta	
እቁበ	Equbä-	
እቁባ	Equba	
እቁባት	Equbat	
እቁባይ	Equbay	
እቁብ	Equb	
እቃ	Eqa	
እቃዎች	Eqawočč	
እቅድ	Eqqed	
እቅፍ	Eqqef	
እበት	Ebbät	
እቡያን	Ebbuyan	
እቡይ	Ebbuy	
እቡይት	Ebbuyt	
እባብ	Ebab	
እባጭ	Ebbač̣	
እብሪተኛ	Ebritäñña	
እብሪት	Ebrit	
እብራይስጥ	Ebrayesṭ	
እብቅ	Ebbeq	
እብነ በረድ	Ebnä-Bäräd	
እብነመለክ	Ebnä-Mäläk	
እብነበ በረድ	Ebnä-Bäräd	
እብድ	Ebd	
እቱቤ	Etubé	
እታለማሁ	Etalämmahu	
እታገኘሁ	Etagäññähu	
እታገኝ	Etagäññ	
እታፈራሁ	Etafärrahu	
እታፍራሁ	Etafärrahu	
እቴ ነሽ	EtéNäš	
እቴቱ	Etétu	
እቴጌ	Etéggé	
እትማማች	Etemmamač	
እትም	Ettem	
እትብት	Etebt	
እነሞር	Ennämor	
እነርሱ	Ennärsu	
እነቆር	Ennäqor	
እነዋሪ	Ennäwari	
እነዚህ	Ennäzih	
እነዚያ	Ennäziya	
እነፍሴ	Ennäfsé	
እናርያ	Ennarya	
እናቲቱ	Ennatitu	
እናት	Ennat	
እናኑ	Ennannu	
እናኒ	Ennanni	
እናንተ	Ennantä	
እናንጐ	Ennango	
እናውጋው	Ennawgaw	
እኔ	Ené	
እንሰት	Ensät	
እንሳሮ	Ensaro	
እንስላል	Enselal	
እንስሳ	Ensesa	
እንስሳት	Ensesat	
እንስት	Ensät	
እንሶስላ	Ensosella	
እንሽላሊት	Enšelalit	
እንቀት	Enqät	
እንቁ	Enqu	
እንቁላል	Enqulal	
እንቁጣጣሽ	Enquṭaṭaš	
እንቃቅላ	Enqaqella	
እንቅልፋም	Enqelfam	
እንቅልፍ	Enqelf	
እንቅርት	Enqert	
እንቅስቃሴ	Enqeseqqasé	
እንቅብ	Enqeb	
እንቅፋት	Enqefat	
እንቆቅልሽ	Enqoqelleš	
እንቆቆ	Enqoqqo	
እንባ	Enba	
እንብርት	Enbert	
እንቧይ	Enbʷy	
እንተኔ	Entäné	
እንተን	Entän	
እንትና	Entena	
እንትን	Enten	
እንትክትክ	Entektek	
እንከን	Enkän	
እንከን የለሽ	EnkänYälläš	
እንኩሮ	Enkuro	
እንክርዳድ	Enkerdad	
እንክብል	Enkebell	
እንክብካቤ	Enkebekkabé	
እንክብክብ	Enkebkeb	
እንኮይ	Enkoy	
እንዘዝ	Enzez	
እንዝህላል	Enzehlal	
እንዝርት	Enzert	
እንየ	Enneyyä	
እንየው	Enneyäw	
እንደራሴ	Endärasé	
እንደርታ	Endärta	
እንደሻው	Endäšaw	
እንደኋሁላ	Endähʷhulla	
እንዳ ስላሴ	EndaSellasé	
እንዳ ይላሉ	Endaylallu	
እንዳሁላ	Endahulla	
እንዳለ	Endalä	
እንዳልሽ	Endalš	
እንዳልካቸው	Endalkaččäw	
እንዳየን	Endayyän	
እንድሪስ	Enderis	
እንድሬ	Enderré	
እንድርያስ	Endereyas	
እንድይላሉ	Endaylallu	
እንዶድ	Endod	
እንጀራ	Enjära	
እንጅልሽ	Enjelleš	
እንጅራ	Enjära	
እንጆሪ	Enjorri	
እንጉርጉሮ	Engurguro	
እንጉዳይ	Enguday	
እንግርግብ	Engergeb	
እንግዳ	Engeda	
እንግዳ አየሁ	Engeda Ayyähu	
እንግዳ እሸት	Engeda Ešät	
እንግዳሸት	EngedaŠät	
እንግዳየሁ	Engeda-Yyähu	
እንግዴልጅ	Engedé-Lej	
እንግጫ	Engeč̣č̣a	
እንጐቻ	Engočča	
እንጥል	Enṭel	
እንጦንስ	Enṭons	
እንጦጦ	Enṭoṭṭo	
እንጨት	Enč̣ät	
እንጭጭ	Enč̣eč̣	
እንፋሎት	Enfalot	
እንፍሴ	Ennäfsé	
እኛ	Eñña	
እኝኝ ብላ	Eññeññ Bela	
እእዛዝ	Te'ezaz	
እከደከ	Ekkädäkkä	
እኩሌታ	Ekkuléta	
እኩል	Ekkul	
እኩልነት	Ekkulennät	
እኩያ	Ekkuyya	
እኩይ	Ekkuy	
እክል	Ekkel	
እውቀቱ	Ewqätu	
እውቀት	Ewqät	
እውነቱ	Ewnätu	
እውነታ	Ewnäta	
እውነት	Ewnät	
እዘዜ	Azäzé	
እዝል	Ezl	
እዝራ	Ezra	
እዝጊእ	Ezgi'e	
እደ	Edä-	
እዳ	Eda	
እዳሪ	Eddari	
እዳይት	Eddayet	
እዳጋ	Edaga	
እድል	Eddel	
እድሜ	Edmé	
እድምተኛ	Eddemtäñña	
እድሞ	Edmo	
እድሪስ	Ederis	
እድር	Edder	
እድገት	Edgät	
እጀ እዙር	EjjÄzur	
እጀ ጠባብ	Ejjä-Ṭäbbab	
እጃጂ	Ejaji	
እጅ	Ejj	
እጅ መንሻ	EjjMänša	
እጅ አዙር	EjjÄzur	
እጅ ይንሱ	Ejj Yensu	
እጅ ጠባብ	Ejjä-Ṭäbbab	
እጅጉ	Ejjegu	
እጅግ አየሁ	EjjegÄyyähu	
እግረ ተማሪ	Egrä-Tämari	
እግረኛ	Egräñña	
እግር	Eger	
እግዚአብሄር	Egzi'äbhér	
እግዚእ	Egzi'e	
እጓለ	Egʷlä	
እጓለ ማውታ	EgʷläMawta	
እጢ	Eṭi	
እጣ	Eṭa	
እጣቢ	Eṭṭabi	
እጣን	Eṭan	
እጥረት	Eṭrät	
እጥፍ	Eṭef	
እጨጌ	Eč̣äggé	
እጭ	Eč̣	
እጮኛ	Eč̣oñña	
እጸ	Eṣä-	
እጹብ	Eṣub	
እጽ	Eṣ	
እፉኝት	Effuññet	
እፍታ	Effeta	
እፍኝ	Effeññ	
እፍያ	Effeya	
ኦሉማ	Oluma	
ኦላማ	Oluma	
ኦላና	Olana	
ኦመር	Omär	
ኦሜድላ	Omédla	
ኦምሀጀር	Omehäjär	
ኦሞናዳ	Omonada	
ኦሪታዊ	Oritawi	
ኦሪት	Orit	
ኦርማ	Orma	
ኦስማን	Osman	
ኦዳ	Oda	
ከሀሊ	Kähäli	
ከሃሊ	Kähali	
ከሃዲ	Kähadi	
ከለለው	Källäläw	
ከለሜዳ	Käläméda	
ከለቻ	Källäčča	
ከለው	Käläw	
ከሊል	Kälil	
ከሊፋ	Kälifa	
ከላሽ	Källaš	
ከል	Käll	
ከልሌ	Källelé	
ከልታማ	Kältamma	
ከልካይ	Kälkay	
ከልክለው	Kälkeläw	
ከልክሌ	Kälkelé	
ከሙን	Kämun	
ከማል	Kämal	
ከምሱር	Kämsur	
ከምሲ	Kämsi	
ከምሴ	Kämesé	
ከረን	Kärän	
ከረዩ	Kärräyyu	
ከረጢት	Käräṭit	
ከርሲማ	Kärsima	
ከርሴ	Kärsé	
ከርስ	Kärs	
ከርቢ	Kärbé	
ከርቤ	Kärbé	
ከርታታ	Kärtatta	
ከርቸሌ	Kärčällé	
ከርከሮ	Kärkärro	
ከርዳዳ	Kärdadda	
ከሰል	Käsäl	
ከሰም	Käsäm	
ከሰተ	Käsätä	
ከሳሽ	Käsaš	
ከሳቴ	Käsaté	
ከሳቴ ከርስ	KäsatéKärs	
ከሺሸያ	Käšišeya	
ከበረ	Käbbärä	
ከበርቴ	Käbbärté	
ከበበ	Käbbäbä	
ከበበው	Käbbäbäw	
ከበቡሽ	Käbbäbuš	
ከበባ	Käbäba	
ከበደ	Käbbädä	
ከበደች	Käbbädäčč	
ከበዱ	Käbbädu	
ከባድ	Käbbad	
ከብት	Käbt	
ከተማ	Kätäma	
ከተራ	Kätära	
ከነአን	Känä'än	
ከንቲባ	Käntiba	
ከውካዋ	Käwkawwa	
ከዘራ	Käzära	
ከዚራ	Käzira	
ከይሲ	Käysi	
ከዳተኛ	Käddatäñña	
ከድር	Käder	
ከድጃ	Kädejja	
ከፈለኝ	Käffäläññ	
ከፈለው	Käffäläw	
ከፈን	Käfän	
ከፈይ	Käfay	
ከፊል	Käfil	
ከፋ	Käfa	
ከፋት	Kefat	
ከፋይ	Käfay	
ከፍ አለ	Käff-Älä	
ከፍ ያለው	Käff-Yaläw	
ከፍተኛ	Käffetäñña	
ከፍታ	Käffeta	
ኩሀ	Kwihä	
ኩለኔ	Kuläné	
ኩሉኮንታ	KuloKonta	
ኩሊ	Kuli	
ኩላሊት	Kulalit	
ኩልኩልት	Kulkult	
ኩልፎ	Kulfo	
ኩሎ ኮንታ	KulloKonta	
ኩመልቻ	Kumälča	
ኩሜላ	Kuméla	
ኩምሳ	Kumsa	
ኩምቢ	Kumbi	
ኩረት	Kurät	
ኩሪ	Kuri	
ኩሪባቸው	Kuribbaččäw	
ኩራባቸው	Kurabbaččäw	
ኩራተኛ	Kuratäñña	
ኩራት	Kurat	
ኩራዝ	Kurraz	
ኩሬ	Kuré	
ኩርማን	Kurman	
ኩርሲ	Kursi	
ኩርቢት	Kurbit	
ኩርባ	Kurba	
ኩርባን	Kurban	
ኩርቱ	Kurtu	
ኩርንችት	Kurenčet	
ኩርኩም	Kurkum	
ኩርፊያ	Kurfiya	
ኩርፋድ	Kurfad	
ኩርፍተኛ	Kurreftäñña	
ኩርፍታ	Kurrefta	
ኩስ	Kus	
ኩስማል	Kusmal	
ኩስታሪ	Kusettari	
ኩስኩስት	Kuskust	
ኩበት	Kubät	
ኩባንያ	Kubbaneyya	
ኩባያ	Kubbayya	
ኩብኩባ	Kubkubba	
ኩታ	Kuta	
ኩታራ	Kutara	
ኩናማ	Kunama	
ኩክ	Kuk	
ኩዊህ	Kwiha	
ኩዩ	Kuyyu	
ኩይሳ	Kuyyesa	
ኩፋሌ	Kufalé	
ኩፍታ	Kuffeta	
ኩፍኝ	Kuffeññ	
ኪሄሾን	Kihéšon	
ኪሩቤል	Kirubél	
ኪሮስ	Kiros	
ኪሳራ	Kisara	
ኪቦር	Kibor	
ኪታ	Kitta	
ኪነ	Kinä-	
ኪነት	Kinät	
ኪያ	Kiyya	
ኪዳነ	Kidanä-	
ኪዳኑ	Kidanu	
ኪዳኔ	Kidané	
ኪዳን	Kidan	
ካህሱ	Kahesu	
ካህሳይ	Kahesay	
ካህናት	Kahenat	
ካህን	Kahen	
ካሊድ	Kalid	
ካሌብ	Kaléb	
ካሚል	Kamil	
ካራ	Karra	
ካራ ሚሌ	Karamillé	
ካራ ማራ	KarraMarra	
ካራ ቆሪ	KarraQori	
ካራሚሌ	Karamillé	
ካር ቆሬ	KarraQori	
ካሰች	Kasäčč	
ካሰኝ	Kasäññ	
ካሱ	Kasu	
ካሳ	Kasa	
ካሳ ሁን	KasaHun	
ካሳዬ	Kasayé	
ካሴ	Kasé	
ካስማ	Kasma	
ካሺሽያ	Kašišeya	
ካባ	Kabba	
ካብትህ	Kabteh	
ካቦ	Kabbo	
ካቲካላ	Katikala	
ካቴና	Katéna	
ካቻ	Kačča	
ካናቴራ	Kanatéra	
ካእብ	Ka'eb	
ካኪሳ	Kakkisa	
ካካ	Kakka	
ካውያ	Kaweyya	
ካዝና	Kazna	
ካፊያ	Kaffiya	
ካፖርት	Kapport	
ኬላ	Kélla	
ኬርሻዋ	Kéršawa	
ኬርጋ	Kirga	
ኬሻ	Kéša	
ኬትሮንስ	Kétrons	
ኬኔ	Kénné	
ኬንዳ	Kénda	
ኬኛ	Kéñña	
ኬክሮስ	Kékros	
ክህነት	Kehnät	
ክህደት	Kehdät	
ክልል	Kellel	
ክልስ	Kelles	
ክምር	Kemmer	
ክምችት	Kemeččet	
ክረምት	Kerämt	
ክራር	Kerar	
ክር	Kerr	
ክርስቲያን	Kerestiyan	
ክርስትና	Kerestenna	
ክርስትያናዊ	Kerestiyanawi	
ክርስቶስ	Kerestos	
ክርታስ	Kertas	
ክርክር	Kerekker	
ክርፋት	Kerfat	
ክስረት	Kesrät	
ክስተት	Kestät	
ክስዲያም	Kesseddiyam	
ክበር	Kebr	
ክበበ	Kebäbä	
ክበበው	Kebäbäw	
ክበብ	Kebäb	
ክበድ	Kebäd	
ክባባው	Kebäbäw	
ክቤ	Kebbé	
ክብረ	Kebrä	
ክብረታዬ	Kebrätayé	
ክብረት	Kebrät	
ክብሩ	Kebru	
ክብሪት	Kebrit	
ክብራ	Kebra	
ክብራን	Kebran	
ክብርና	Kebrenna	
ክብርዬ	Kebreyyé	
ክብሮም	Kebrom	
ክብሯ	Kebrʷ	
ክተት	Ketät	
ክትባት	Kettebat	
ክትክታ	Ketketta	
ክትፎ	Ketfo	
ክነፈርግብ	Kenäfä-Regb	
ክንታሮት	Kentarot	
ክንድ	Kend	
ክንፈ	Kenfä	
ክንፉ	Kenfu	
ክንፌ	Kenfé	
ክንፍ	Kenf	
ክክ	Kekk	
ክፈለኝ	Käffäläññ	
ክፈለው	Käffäläw	
ክፈተው	Kefätäw	
ክፈፍ	Kefäf	
ክፍለ	Keflä	
ክፍሉ	Keflu	
ክፍላተ	Keflatä-	
ክፍላይ	Keflay	
ክፍሌ	Keflé	
ክፍል	Kefel	
ክፍልፋይ	Kefelfay	
ክፍሎም	Keflom	
ክፍት	Keft	
ክፍያ	Kefeyya	
ኮሌታ	Kollétta	
ኮልፌ	Kolfé	
ኮመኮም	Komäkom	
ኮመዲኖ	Komädino	
ኮምቦልቻ	Kombolča	
ኮረም	Koräm	
ኮረሪማ	Korärima	
ኮረብታ	Koräbta	
ኮረብታማ	Koräbtamma	
ኮረብቴት	Koräbtit	
ኮረንቲ	Korränti	
ኮረኮንች	Koräkonč	
ኮረዳ	Korädda	
ኮራ	Korra	
ኮራን	Korran	
ኮራይ	Koray	
ኮሬ	Koré	
ኮሬብ	Koréb	
ኮርማ	Korma	
ኮርሜ	Kormé	
ኮርቻ	Korečča	
ኮስታራ	Kostarra	
ኮስትር	Koster	
ኮሶ	Koso	
ኮሸሽላ	Košäšella	
ኮሽም	Košem	
ኮባ	Koba	
ኮቲ	Kotti	
ኮቴ	Kotté	
ኮትቻ	Kotečča	
ኮንሶ	Konso	
ኮከበ ጽባህ	Kokkäbä-Ṣebah	
ኮከቤ	Kokkäbé	
ኮከብ	Kokkäb	
ኮክ	Kok	
ኮዳ	Kodda	
ኮፈሌ	Kofälé	
ኮፈጆ	Koräjo	
ኮፍያ	Kofeyya	
ኳኳቴ	Kʷkʷté	
ወህኒ	Wähni	
ወለለት	Wälälät	
ወለላ	Wäläla	
ወለል	Wäläl	
ወለምታ	Wälämta	
ወለባ	Wäläba	
ወለተ	Wälättä-	
ወለቱ	Wälättu	
ወለንጪቲ	Wälänč̣itti	
ወለንጭቲ	Wälänč̣itti	
ወለወልዳ	Wäläwälda	
ወለድ አገድ	WällädÄggäd	
ወለጋ	Wällägga	
ወለጌ	Wällägé	
ወላሞ	Wälamo	
ወላስማ	Wälasma	
ወላንሳ	Wälansa	
ወላዋይ	Wälaway	
ወላዲት	Wäladit	
ወላጅ	Wälaj	
ወላፈን	Wälafän	
ወሌ	Wälé	
ወልሻሻ	Wälšašša	
ወልቂጤ	Wälqiṭṭé	
ወልቃይት	Wälqayet	
ወልቆ	Wälqo	
ወልወል	Wälwäl	
ወልደ	Wäldä-	
ወልደ የሱስ	Wäldä-Yyäsus	
ወልደ የስ	Wäldä-Yyäs	
ወልደየስ	Wäldä-Yyäs	
ወልደያ	Wäldeya	
ወልዱ	Wäldu	
ወልዳይ	Wälday	
ወልዴ	Wäldé	
ወልድ	Wäld	
ወልድያ	Wäldeya	
ወሎ	Wällo	
ወሎዬ	Wälloyyé	
ወመዘክር	Wä-Mäzäkker	
ወምበር	Wämbär	
ወረ ሂመኖ	Wärä-Himäno	
ወረ ባቦ	Wärrä-Babbo	
ወረ ነሻ	Wärrä-Näš	
ወረ ንጥሻ	Wärrä-Nṭešša	
ወረ ኢሉ	Wärrä-Ilu	
ወረ ገኑ	Wärrä-Gänu	
ወረሀ	Wärähä	
ወረርሺኝ	Wärräršeñ	
ወረርሽኝ	Wärräršeñ	
ወረቀት	Wäräqät	
ወረተኛ	Wärätäñña	
ወረታ	Wärräta	
ወረት	Wärät	
ወረንጦ	Wäränṭo	
ወረዳ	Wäräda	
ወረጋ	Wäräga	
ወረፋ	Wäräfa	
ወራሪ	Wärari	
ወራሽ	Wäraš	
ወራቂ	Wärraqi	
ወራት	Wärat	
ወራጅ	Wäraj	
ወሬሳ	Wärrésa	
ወሬኛ	Wäréñña	
ወሬዛ	Wäréza	
ወር	Wär	
ወር ነሽ	Wärrä-Näša	
ወርሃዊ	Wärhawi	
ወርቀ ዘቦ	Wärqä-Zäbo	
ወርቁ	Wärqu	
ወርቂቱ	Wärqitu	
ወርቂት	Wärqit	
ወርቃማ	Wärqamma	
ወርቄ	Wärqé	
ወርቅ	Wärq	
ወርቅ ነህ	WärqNäh	
ወርቅ ነሽ	WärqNäš	
ወርቅቾ	Wärqeččo	
ወርች	Wärč	
ወርድ	Wärd	
ወርዶፋ	Wärdofa	
ወርጅ	Wärj	
ወርጅብኝ	Werjebbeññ	
ወሮ በላ	Wärro-Bälla	
ወሮታ	Wärrota	
ወሰኑ	Wäsänu	
ወሰኔ	Wäsäné	
ወሰን	Wäsän	
ወሰካ	Wäsäka	
ወሳኝ	Wässaññ	
ወሳፍቻ	Wässafečča	
ወስላታ	Wäslatta	
ወስከምባይ	Wäskämbay	
ወስፈንጠር	Wasfäntär	
ወስፈንጥር	Wäsfänṭär	
ወስፋት	Wäsfat	
ወስፌ	Wäsfé	
ወሸላ	Wäšäla	
ወሽመጥ	Wäšmäṭ	
ወቀሳ	Wäqäsa	
ወቄት	Wäqét	
ወቅታዊ	Wäqtawi	
ወቅት	Wäqt	
ወባ	Wäba	
ወቦ	Wäbbo	
ወተት	Wätät	
ወታደራዊ	Wättaddärawi	
ወታደር	Wättaddär	
ወትሮ	Wätro	
ወና	Wäna	
ወናሄ	Wänahé	
ወናጉ	Wänago	
ወናግ	Wänag	
ወናጐ	Wänago	ወናጎ
ወናፍ	Wänaf	
ወንበር	Wänbär	
ወንበዴ	Wänbädé	
ወንዝ	Wänz	
ወንደ ላጤ	Wändä-Latté	
ወንዳ ወንድ	Wända-Wänd	
ወንዳ ገረድ	Wända-Gäräd	
ወንዴ	Wändé	
ወንድ	Wänd	
ወንድ አፍራሽ	WändÄfraš	
ወንድ ይራድ	WändYerad	
ወንድ ይፍራው	WändYefraw	
ወንድሙ	Wändemmu	
ወንድማማች	Wändemmamač	
ወንድማማቾች	Wändemmamačočč	
ወንድም	Wändemm	
ወንድም ነህ	WändemmNäh	
ወንድም አገኘሁ	Wändemm-Ägännähu	
ወንድም አገኝ	Wändemm-Ägäññ	
ወንድምዬ	Wändemmeyyé	
ወንዶ	Wändo	
ወንጀለኛ	Wänjäläñña	
ወንጀል	Wänjäl	
ወንጂ	Wänji	
ወንጅለኛ	Wänjäläñña	
ወንጋያ	Wängaya	
ወንጌላዊ	Wngélawi	
ወንጌላዊት	Wängélawit	
ወንጌል	Wängél	
ወንጠፍት	Wänṭäft	
ወንጭፍ	Wänč̣ef	
ወንፈል	Wänfäl	
ወንፊት	Wänfit	
ወኪል	Wäkkil	
ወዘተርፈ	Wäzätärfä	
ወዘና	Wäzäna	
ወዝ	Wäz	
ወዝ አደር	WäzÄddär	
ወዝ አደሮች	WäzÄddäročč	
ወያ	Wäyya	
ወያኔ	Wäyyané	
ወይነ ጠጅ	Wäynä-Ṭäjj	
ወይኒቱ	Wäynitu	
ወይና ደጋ	Wäyna-Däga	
ወይኔ	Wäyné	
ወይን	Wäyn	
ወይዘሪት	Wäyzärit	
ወይዘሮ	Wäyzäro	
ወይጦ	Wäyṭo	
ወይፈን	Wäyfän	
ወደ ኋላ	Wädä-Hʷla	
ወደ ፊት	Wädä-Fit	
ወደላ	Wädälla	
ወደል	Wädäl	
ወደሬ	Wädäré	
ወደር የለሽ	WädärYälläš	
ወደብ	Wädäb	
ወዳድ	Wäddad	
ወዳጄ	Wädajé	
ወዳጅ	Wädaj	
ወዳጆ	Wädajo	
ወድ ይፍራው	WändYefraw	
ወድም አገኛሁ	Wändemm-Ägännähu	
ወድቅት	Weddeqt	
ወገል	Wägäl	
ወገራ	Wägära	
ወገርት	Wäggärt	
ወገብ	Wägäb	
ወገብጌ	Wägäb-gé	
ወገኔ	Wägäné	
ወገን	Wägän	
ወገኛ	Wägäñña	
ወገዲ	Wägeddi	
ወጋገራ	Wägagra	
ወጋግራ	Wägagra	
ወጌላዊ	Wängélawi	
ወጌሻ	Wägéšša	
ወግ	Wäg	
ወግ አራቂ	WägÄrraqi	
ወግ አየሁ	WägÄyyähu	
ወግ አጥባቂ	WägÄṭbaqi	
ወግ ደረሰኝ	WägDärräsäññ	
ወግ ደረስ	WägDärräs	
ወግ ዳር	WägDar	
ወግሊያ	Wägliya	
ወግደረስ	WägDärräs	
ወግዴ	Wägeddi	
ወጠጤ	Wäṭäṭé	
ወጣት	Wäṭṭat	
ወጣቶች	Wäṭṭatočč	
ወጥ	Wäṭ	
ወጥመድ	Wäṭmäd	
ወጨፎ	Wäč̣äfo	
ወጭት	Wäč̣et	
ወፈፌ	Wäfäffé	
ወፈፍተኛ	Wäfäftäñña	
ወፍ	Wäf	
ወፍ አንቁር	WäfÄnqur	
ወፍላ	Wäfla	
ወፍራም	Wäfram	
ወፍጮ	Wäfč̣o	
ዋህድ	Wahed	
ዋለልኝ	Walälleññ	
ዋሉ	Walu	
ዋልታ	Walta	
ዋልያ	Waleya	
ዋልድባ	Waldebba	
ዋልጋ	Walga	
ዋልጌ	Walgé	
ዋሚ	Wami	
ዋምራ	Wamra	
ዋርሳ	Warsa	
ዋርካ	Warka	
ዋርዳ	Warda	
ዋርዴ	Wardé	
ዋሱ	Wasu	
ዋሴ	Wasé	
ዋስ	Was	
ዋስ ይሁን	WasYehun	
ዋስትና	Wastenna	
ዋሻ	Wašša	
ዋሽንት	Wašent	
ዋቃ	Waqa	
ዋቄ	Waqé	
ዋቅ ጂራ	WaqJera	
ዋቅ ጅራ	WaqJera	
ዋቅቶላ	Waqtola	
ዋቆ	Waqo	
ዋቢ ሸበሌ	WabiŠäbälé	
ዋቢላ	Wabélla	
ዋቤላ	Wabélla	
ዋቶ አደር	Watto-Äddär	
ዋና	Wana	
ዋኔ	Wané	
ዋንዛ	Wanza	
ዋንጫ	Wanč̣a	
ዋኬኔ	Wakéané	
ዋዜማ	Wazéma	
ዋዠራ	Waz̃ära	
ዋይታ	Wayeta	
ዋድላ	Wadla	
ዋድያት	Wadyat	
ዋጃ	Wajja	
ዋጅራት	Wajerat	
ዋገምት	Wagämt	
ዋጋው	Wagaw	
ዋጋዬ	Wagayé	
ዋግ	Wag	
ዋግ ሹም	WagŠum	
ውሂብ	Wehib	
ውሃ	Weha	
ውሃ ገብ	WehaGäbb	
ውህደት	Wehdät	
ውለታ	Weläta	
ውላጅ	Wellaj	
ውል	Wel	
ውልብልቢት	Weleblebit	
ውራጅ	Werraj	
ውርማ	Werma	
ውርርድ	Wererred	
ውርስ	Wers	
ውርንጫ	Werenč̣a	
ውርንጭላ	Werenč̣ella	
ውርዴ	Werdé	
ውርጅብኝ	Werjebbeññ	
ውርጋጥ	Wergaṭ	
ውርጌሳ	Weergéssa	
ውሳኔ	Wessané	
ውሳጣዊ	Wesṭawi	
ውስብስብ	Wesebsab	
ውስጣዊ	Wesṭawi	
ውስጥ	Wesṭ	
ውሻ	Wešša	
ውሻል	Wešal	
ውሽማ	Wešemma	
ውሽንፍር	Wešenfer	
ውቂያ	Weqqiya	
ውቃቢ	Weqabi	
ውቃው	Weqaw	
ውቅራት	Weqqerat	
ውቅሮ	Weqro	
ውቅያኖስ	Weqeyanos	
ውበቴ	Webäté	
ውበት	Webät	
ውቢቱ	Webitu	
ውቢት	Webit	
ውቤ	Webé	
ውብ	Web	
ውብ ሻው	WebŠaw	
ውብ ታዬ	WebTayyé	
ውብ ነህ	WebNäh	
ውብ ነሽ	WebNäš	
ውብ አለ	WebÄlä	
ውብ አለ ሰው	WebÄläSäw	
ውብ እሽት	Web Ešät	
ውብታዬ	WebTayyé	
ውትድርና	Wettedderenna	
ውንደ ላጤ	Wändä-Laṭṭé	
ውዝፍ	Wezzef	
ውዠንብር	Wez̃enber	
ውይይት	Weyeyyet	
ውዲቱ	Wedditu	
ውዳሴ	Weddasé	
ውዳቂ	Weddaqi	
ውዴ	Weddé	
ውዴታ	Weddéta	
ውድ	Wedd	
ውድ ነህ	WeddNäh	
ውድ ነሽ	WeddNäš	
ውድማ	Wedemma	
ውድቀት	Wedqät	
ውድቅት	Weddeqt	
ውድድር	Wededder	
ውገያ	Weggiya	
ውጉዘ	Weguz	
ውጉዝ	Weguz	
ውጊያ	Weggiya	
ውጋት	Wegat	
ውጋጋን	Wegagan	
ውጣ ውረድ	Weṭa-Weräd	
ውጤት	Weṭṭét	
ውጥረት	Weṭrät	
ውጥንቅጥ	Weṭenqeṭ	
ውጫሌ	Weč̣alé	
ውጭ	Weč̣č̣	
ዎለንኮሚ	Wolänkomi	
ዎሮታ	Worrota	
ዎታንጐ	Wotango	
ዘሃራ	Zähara	
ዘለለ	Zällälä	
ዘለለው	Zälläläw	
ዘለላ	Zäläla	
ዘለሰኛ	Zäläsäñña	
ዘለስ	Zäläs	
ዘለስኛ	Zäläsäñña	
ዘለቀ	Zälläqä	
ዘለቃ	Zäläqa	
ዘለቃሽ	Zäläqaš	
ዘለቄታ	Zäläqéta	
ዘለበት	Zäläbät	
ዘለኣለማዊ	Zälä'alämawi	
ዘለኣለም	Zälä'aläm	
ዘለፋ	Zäläfa	
ዘላቂ	Zälaqi	
ዘላን	Zällan	
ዘሌዋውያን	Zä-Léwawayan	
ዘመሚት	Zämämit	
ዘመነ	Zämmänä	
ዘመናዊ	Zämänawi	
ዘመን	Zämän	
ዘመንፈስ	Zä-Mänfäs	
ዘመዱ	Zämädu	
ዘመድ	Zämäd	
ዘመድ ሁን	ZämädHun	
ዘመድ ኩን	ZämädKun	
ዘሙ	Zämu	
ዘሙይ	Zämuyy	
ዘሚካኤል	Zä-Mika'él	
ዘማ	Zämma	
ዘማኑኤል	Zä-Ämanu'él	
ዘማዊ	Zämmawi	
ዘሜ	Zämmé	
ዘምባባ	Zämbaba	
ዘምዘም	Zämzäm	
ዘረኛ	Zäräñña	
ዘረኛነት	Zäräññannät	
ዘረፉ	Zärräfu	
ዘሩ	Zäru	
ዘሩባቤል	Zärubabél	
ዘሩፋኤል	Zä-Rufa'él	
ዘሪሁን	Zärihun	
ዘራፌ	Zärrafé	
ዘር	Zär	
ዘር ትሁን	ZärTehun	
ዘር አብሩክ	Zär'ä-Beruk	
ዘር ይሁን	ZärYehun	
ዘርአ ብርክ	Zär'ä-Beruk	
ዘርአ የእቆብ	Zär'ä-Ya'eqob	
ዘርአ ያእቆብ	Zär'ä-Ya'eqob	
ዘርአይ	Zär'äy	
ዘርኡ	Zär'u	
ዘርኣም	Zär'om	
ዘርእ ሰናይ	Zär'ä-Sännay	
ዘርኦም	Zär'om	
ዘርጊ	Zärgi	
ዘርጋው	Zärgaw	
ዘርፈሸዋል	Zärfäšäwal	
ዘርፉ	Zärfu	
ዘርፌ	Zärfé	
ዘርፍ	Zärf	
ዘርፍ ነሽ	ZärfNäš	
ዘቃቅቤ	Zäqaqebé	
ዘበርጋ	Zäbärga	
ዘበት	Zäbät	
ዘበናይ	Zäbänay	
ዘበኛ	Zäbäñña	
ዘቢባ	Zäbib	
ዘቢብ	Zäbib	
ዘብ	Zäb	
ዘብ ይደሩ	ZäbYedäru	
ዘብዴዎስ	Zäbdéwos	
ዘብጥ	Zäbṭ	
ዘብጥያ	Zäbṭeyya	
ዘነበ	Zännäbä	
ዘነበች	Zännäbäčč	
ዘነብ	Zännäb	
ዘንቢል	Zänbil	
ዘንባባ	Zänbaba	
ዘንካታ	Zänkatta	
ዘንዘራ	Zänzära	
ዘንድሮ	Zändero	
ዘንጋዳ	Zängada	
ዘንግ	Zäng	
ዘአማኒኤል	Zä-Ämanu'él	
ዘኪሮስ	Zä-Kiros	
ዘካርያስ	Zäkkareyas	
ዘኬ	Zäkké	
ዘኬዎስ	Zäkkéwos	
ዘወልዴ	Zä-Wäldé	
ዘወርዋራ	Zäwärwarra	
ዘወንጌል	Zä-Wängél	
ዘዋሪ	Zäwari	
ዘውደኛ	Zäwdäñña	
ዘውዱ	Zäwdu	
ዘውዲ	Zäwdi	
ዘውዲቱ	Zäwditu	
ዘውዳዊ	Zäwdawi	
ዘውዴ	Zäwdé	
ዘውድ	Zäwd	
ዘውድ ነህ	ZäwdNäh	
ዘውድ ነሽ	ZäwdNäš	
ዘውገ	Zäwgä	
ዘየደች	Zäyyädäčč	
ዘዬ	Zäyé	
ዘይላ	Zäyla	
ዘይቤ	Zäybé	
ዘይቱን	Zäyetun	
ዘይት	Zäyet	
ዘይኑ	Zäynu	
ዘይን	Zäyn	
ዘይዳን	Zäydan	
ዘዴኛ	Zädéñña	
ዘድንግል	Zä-Dengel	
ዘገብርኤል	Zä-Gäbre'él	
ዘገየሁ	Zägäyyéhu	
ዘገዩ	Zägäyyu	
ዘገዬ	Zägäyyé	
ዘገዬሁ	Zägäyyéhu	
ዘጊዮርጊስ	Zä-Giyorgis	
ዘጠና	Zäṭäna	
ዘጠኘኛ	Zäṭäññäñña	
ዘጠኝ	Zäṭäññ	
ዘጠኝኛ	Zäṭäññäñña	
ዘፈን	Zäfän	
ዘፋኝ	Zäfañ	
ዙረት	Zurät	
ዙሪያሽ	Zuriyaš	
ዙፋን	Zufan	
ዚቅ	Ziq	
ዛህራ	Zaher	
ዛላ	Zala	
ዛሬ	Zaré	
ዛር	Zar	
ዛቢር	Zabir	
ዛቢያ	Zabiya	
ዛብሎን	Zabelon	
ዛብሽ	Zabeš	
ዛቻ	Začča	
ዛኒጋባ	Zanigabba	
ዛንጀሮ	Zanjäro	
ዛኪር	Zakir	
ዛይኑ	Zaynu	
ዛይድ	Zayed	
ዛዲግ	Zadig	
ዛጐል	Zagol	
ዜና	Zéna	
ዜናዊት	Zénawit	
ዜጋ	Zéga	
ዜግነት	Zégennät	
ዝሆኔ	Zehoné	
ዝሆን	Zehon	
ዝልል	Zellel	
ዝልግልግ	Zelegleg	
ዝሙተኛ	Zemmetäñña	
ዝሙት	Zemmut	
ዝሚሩ	Zemiru	
ዝማሜ	Zemamé	
ዝማም	Zemam	
ዝማሬ	Zemmaré	
ዝምብ	Zemb	
ዝምተኛ	Zemmetäñña	
ዝምታ	Zemmeta	
ዝምድና	Zemdenna	
ዝርያ	Zerreyya	
ዝርግ	Zerg	
ዝርግፍ	Zergef	
ዝርፊያ	Zerfiya	
ዝርፍጥ	Zerfeṭ	
ዝቃጭ	Zeqqač̣	
ዝቅ አርጋቸው	Zeqq-Ärgaččäw	
ዝቅ አርጋችው	Zeqq-Ärgaččäw	
ዝቅተኛ	Zeqqetäñña	
ዝቅዝቅ	Zaf	
ዝባዝንኬ	Zebazenké	
ዝባድ	Zebad	
ዝብርቅርቅ	Zebreqreq	
ዝብድይ	Zebdeyy	
ዝተት	Zettät	
ዝና	Zenna	
ዝናህ	Zennah	
ዝናር	Zennar	
ዝናሽ	Zennaš	
ዝናቡ	Zenabu	
ዝናብ	Zenab	
ዝንባሌ	Zenebbalé	
ዝንብ	Zenb	
ዝንብሌ	Zenebbalé	
ዝንጀሮ	Zenjäro	
ዝንጅሮ	Zenjäro	
ዝንጉ	Zengu	
ዝንጉርጉር	Zengurgur	
ዝክሩፋ	Zekrufa	
ዝክር	Zeker	
ዝዋይ	Zeway	
ዝውውር	Zewewwer	
ዝይ	Zeyy	
ዝይን	Zeyyen	
ዝገት	Zegät	
ዝግባ	Zegba	
ዝግታ	Zeggeta	
ዝግን	Zegen	
ዝግጅት	Zegejjet	
ዞማ	Zoma	
ዞብል	Zobel	
ዞጲ	Zop̣p̣i	
ዣን	Z̃an	
ዥግራ	Z̃an	
የሃንሱ	Yähansu	
የህዝብ	Yä-Hezb	
የሎስ	Yälos	
የመስቀል ወፍ	Yä-Mäsqäl-Wäf	
የማር እሸት	Yä-Mar-Ešät	
የማታ	Yä-Mata	
የማታ	Yä-Mata	
የማነ	Yämanä	
የሜዳ አህያ	Yä-Méda-Äheyya	
የምሩ	Yämerru	
የምስራች	Yä-Messeračč	
የምሻው	Yämmešaw	
የምወድሽ	Yämmewäddeš	
የረር	Yärär	
የሮም	Yä-Rom	
የሮም ነሽ	Yä-Rom Näš	
የሮም ንሽ	Yä-RomNäš	
የሱ	Yässu	
የሱሳዊት	Yäsusawit	
የሱስ	Yäsus	
የስጋት	Yä-Segat	
የሸዋ ልኡል	Yä-Šäwa-le'ul	
የሸዋ መብራት	Yä-Šäwa-Mäbrat	
የሹሜ	Yäšumé	
የሹም ነሽ	Yä-ŠumNäš	
የሺ	Yä-Ši	
የሻረግ	Yäšaräg	
የሻሸ ወርቅ	Yäšaš-Wärq	
የሻው	Yä-Šaw	
የሽዋ ልኡል	Yä-Šäwa-Le'ul	
የሽዋ መብራት	Yä-Šwa-Märat	
የበላይ	Yä-Bälay	
የበላይነት	Yä-Bälayennät	
የበታች	Yä-Bätačč	
የበታችነት	Yäbätaččennät	
የቡ	Yäbbu	
የብስ	Yäbs	
የተሻ	Yätäša	
የተሻ	Yätäša-Wärq	
የተሻው	Yätäšaw	
የተባበሩት	Yätäbabbärut	
የትም	Yätemm	
የኋላ	Yä-Hʷ	
የኔ ሰው	YänéSäw	
የኔ ነህ	YänéNäh	
የኔ ፋንታ	YänéFänta	
የኣለም	Yä-Aläm	
የካ	Yäkka	
የካቲት	Yäkkatit	
የወርቅ ውሃ	Yä-Wärq-Weha	
የወንድ ወሰን	Yä-Wänd-Wäsän	
የወይን እሸት	Yä-Wäyn-Ešät	
የወዲያ ነሽ	Yä-WädiyaNäš	
የወግ ነሽ	Yä-WägNäš	
የዋህ	Yäwwah	
የውሃ ሽታ	Yä-Weha-Šetta	
የውል ሰው	Yä-Wel-Säw	
የውብ ዳር	Yä-Web-Dar	
የውነቱ	Yäwnätu	
የዛሬይቱ	Yä-Zaréytu	
የደም ገንቦ	Yä-DämGänbo	
የደቴ	Yadäté	
የዱር አራዊት	Yä-Dur Ärawit	
የገዝ መደብ	Yä-Gäz-Mädäb	
የገዥ መዳብ	Yä-Gäz̃Mädäb	
የገደል ማሚቶ	Yä-GädälMammito	
የገድል ማሚቶ	Yä-GädälMammito	
የጋራ	Yä-Gara	
የጋርዮሽ	Yä-Gareyyoš	
የግል	Yä-Gell	
የጡት ልጅ	Yä-Ṭut-Lej	
የጭን ገረድ	Yä-Č̣anGäräd	
የፊጥኝ	Yä-Fiṭṭeññ	
ዩሱፍ	Yusuf	
ያህያ	Yaheya	
ያለው	Yaläw	
ያልጋ ነሽ	YalgaNäš	
ያመ ነሽ	Yammänäš	
ያመነሽ	Yammänäš	
ያምሮት	Yamrot	
ያረጋል	Yarägal	
ያሬድ	Yaréd	
ያሲን	Yasin	
ያስችለዋል	Yasčeläwal	
ያኑስ	Yanus	
ያንጥፉ	Yanṭefu	
ያእቆብ	Ya'eqob	
ያዘው	Yazäw	
ያየህ ይራድ	Yayyäh-Yerad	
ያየሽ	Yayyäs	
ያዩ	Yayyu	
ያይኔ አበባ	Yayné-Äbäba	
ያይን ኣለም	Yayn-Aläm	
ያደታ	Yadäta	
ያደግድጉ	Yadägdegu	
ያጅቡሻል	Yajjebušal	
ያግብአ	Yagbe'ä	
ያፌት	Yafét	
ይሁኔ	Yehuné	
ይሁዲ	Yehudi	
ይሁዳ	Yehuda	
ይሄይስ	Yehéyyes	
ይህ	Yeh	
ይህች	Yehečč	
ይህደጋ	Yehdägga	
ይህደጐ	Yehdäggo	
ይለፍ	Yeläf	
ይሉኝታ	Yeluñta	
ይላላ	Yelala	
ይላቅ	Yelaq	
ይላኩ	Yelaku	
ይልማ	Yelma	
ይመር	Yemär	
ይመስገን	Yemmäsgän	
ይመችሻል	Yemmäččešall	
ይመኑ	Yemänu	
ይመኔ	Yemäné	
ይመኙሻል	Yemmäññušall	
ይማሙ	Yemamu	
ይማም	Yemam	
ይምርሃነ	Yemrehannä	
ይምታቱ	Yemtatu	
ይምአታ	Yem'ätta	
ይራድ	Yerad	
ይርሳው	Yersaw	
ይርዳው	Yerdaw	
ይርገዱ	Yergädu	
ይርጉ	Yergu	
ይርጋ	Yerga	
ይርጋ አለም	YergaAläm	
ይርጋ ኣለም	YergaAläm	
ይርጋ ጨፌ	YergaČ̣äffé	
ይስሀቅ	Yeshäq	
ይስሙ	Yesmu	
ይስሙላ	Yesmulla	
ይስማ	Yesma	
ይስማው	Yesmaw	
ይስገዱ	Yesgädu	
ይስፋ ወሰን	YesfaWäsän	
ይሻሙ	Yeššamu	
ይሻሙሽ	Yeššamuš	
ይበርታ	Yebärta	
ይበሳ	Yebsa	
ይቤቶ	Yebéto	
ይብርሁ	Yebrehu	
ይብሳ	Yebsa	
ይብዛ	Yebza	
ይታክቱ	Yetaktu	
ይታየው	Yettayäw	
ይታይሽ	Yettayeš	
ይታጠቁ	Yettaṭäqu	
ይትረፍ	Yeträf	
ይነሱ	Yennäsu	
ይንሱ	Yennäsu	
ይኩኖ	Yekunno	
ይዘሽዋል	Yezäšewal	
ይዘት	Yezät	
ይዞታ	Yezota	
ይዞት	Yezät	
ይደነቁ	Yeddänäqu	
ይደነቅ	Yeddänäq	
ይድነቃቸው	Yednäqaččäw	
ይገምቱ	Yegämmetu	
ይገባሀል	Yeggäbbahal	
ይገባሃል	Yeggäbbahal	
ይገብሩ	Yegäbberu	
ይገዙ	Yeggäzu	
ይጋርዱ	Yegardu	
ይግለጡ	Yegläṭu	
ይግባኝ	Yegbaññ	
ይግዛው	Yegzaw	
ይጥና	Yeṭna	
ይፋ	Yefa	
ይፋቴ	Yefaté	
ይፋት	Yefat	
ይፍሩ	Yefru	
ይፍራው	Yefraw	
ይፍቱ	Yeftu-	
ይፍጠር	Yefṭär	
ዮሀንስ	Yohännes	
ዮርዳኖስ	Yordanos	
ዮሲያስ	Yosiyas	
ዮሴፍ	Yoséf	
ዮና	Yona	
ዮናስ	Yonas	
ዮናታን	Yonattan	
ዮናኒ	Yonani	
ዮዲት	Yodit	
ዮፍታሄ	Yoftahé	
ደሀራይ	Dähäray	
ደሀብ	Dähäb	
ደህራይ	Dähäray	
ደህኔ	Dähné	
ደህንነት	Dähnennät	
ደለለች	Dälläläčč	
ደለለኝ	Dälläläññ	
ደለሉ	Dällälu	
ደለሎ	Dällälu	
ደላላ	Dällala	
ደላንታ	Dälanta	
ደላጐ	Dälago	ደላጎ
ደልዳላ	Däldalla	
ደመረ	Dämmärä	
ደመረው	Dämmäräw	
ደመሩ	Dämmäru	
ደመራ	Dämära	
ደመራው	Dämäraw	
ደመቀ	Dämmäqä	
ደመቀች	Dämmäqäčč	
ደመቁ	Dämmäqu	
ደመቄ	Dämmäqé	
ደመቅሳ	Dämmäqsa	
ደመና	Dämmäna	
ደመኛ	Dämäñña	
ደመወዜ	Dämäwäzé	
ደመወዝ	Dämäwäz	
ደማሚት	Dämamit	
ደማኛ	Dämäñña	
ደሜ	Dämé	
ደም	Däm	
ደም መላሽ	DämMällaš	
ደም ግባት	DämGebat	
ደምለው	Dämelläw	
ደምላው	Dämelläw	
ደምል	Dämell	
ደምሰው	Dämessäw	
ደምሳሽ	Dämsaš	
ደምሳቸው	Dämessaččäw	
ደምስ	Dämess	
ደምበል	Dämbäl	
ደምቢ ዶሎ	DämbiDollo	
ደምቦባ	Dämboba	
ደሞዜ	Dämäwäzé	
ደረሰ	Därräsä	
ደረሳ	Däräsa	
ደረስ	Därräs	
ደረስጊ	Däräsgi	
ደረሶ	Däräso	
ደረባ	Däräba	
ደረት	Därät	
ደረጀ	Däräjjä	
ደረጃ	Däräja	
ደረጃዎች	Däräjawočč	
ደራ	Därra	
ደራሞ ደራም	Däramo-Däram	
ደራሞ-ድራም	Däramo-Däram	
ደራሲ	Därasi	
ደራሲያን	Därasiyan	
ደርሂም	Därhim	
ደርሞ	Dermo	
ደርሰህ	Därsäh	
ደርሶማ	Därsoma	
ደርባባው	Därbabbaw	
ደርባቸው	Därrebaččäw	
ደርቤ	Därrebé	
ደርጉ	Därgu	
ደርግ	Därg	
ደሮማይ	Darimu	
ደሳለኝ	Dässaläññ	
ደሳሳ	Däsasa	
ደሴ	Dosé	
ደሴት	Dässét	
ደሴቶች	Dässétočč	
ደስሜ	Dässemé	
ደስታ	Dässeta	
ደቀ መሀረ	Däqqä-Mähärä	
ደቀ መዝሙር	Däqqä-Mäzmur	
ደቂቃ	Däqiqa	
ደቂቅ	Däqiq	
ደቃቅ	Däqqaq	
ደበላ	Däbäla	
ደበሌ	Däbälé	
ደበሎ	Däbälo	
ደበሳይ	Däbäsay	
ደበሽ	Däbäš	
ደበበ	Däbbäbä	
ደበኔ	Däbäné	
ደበን አንሳ	DäbänÄnsa	
ደቡባዊ	Däbubawi	
ደቡብ	Däbub	
ደባ	Däba	
ደባል	Däbbal	
ደባልቄ	Däbalqé	
ደባርቅ	Däbarq	
ደባርዋ	Däbarwa	
ደባሱ	Däbbasu	
ደባስ	Däbbas	
ደባይ	Däbay	
ደብረ	Däbrä-	
ደብረ ሲና	Däbrä-Sina	
ደብረ ዳሞ	Däbrä-Damo	
ደብሩ	Däbru	
ደብሪቱ	Däbritu	
ደብሬ	Däbré	
ደብር	Däber	
ደብተራ	Däbtära	
ደብተር	Däbtär	
ደብዛ	Däbza	
ደብዳቤ	Däbdabbé	
ደብዳቤዎች	Däbdabbéwočč	
ደቦ	Däbo	
ደቦጭ	Däboč̣	
ደነቀ	Dännäqä	
ደነቀው	Dännäqäw	
ደነባ	Dännäba	
ደነዝ	Dänäz	
ደናግል	Dänagel	
ደን	Dänn	
ደንቀራ	Dänqära	
ደንቀዝ	Dänqäz	
ደንበሌ	Dänbälé	
ደንበኛ	Dänbäñña	
ደንበኞቻችን	Dänbäññoččaččen	
ደንበኞች	Dänbäññočč	
ደንባሪ	Dänbari	
ደንብ	Dänb	
ደንቦባ	Dänboba	
ደንቦች	Dänbočč	
ደንከል	Dänkäl	
ደንከልያ	Dänkäleya	
ደንከሎች	Dänkäločč	
ደንካልያ	Dänkäleya	
ደንደሮ	Dändärro	
ደንደስ	Dändäss	
ደንገላሳ	Dängälasa	
ደንገጡር	Dängäṭur	
ደንጐሎ	Dängollo	
ደከሮ	Däkäro	
ደካማ	Däkkama	
ደወል	Däwäl	
ደዌ	Däwé	
ደዎ	Däwo	
ደያሱ	Däyyasu	
ደያስ	Däyyas	
ደያሶ	Däyyaso	
ደይን	Däyn	
ደደሆ	Dädäho	
ደደር	Dädär	
ደደብ	Däddäb	
ደጀ ሰላም	Däjjä-Sälam	
ደጀኑ	Däjänu	
ደጀኔ	Däjäné	
ደጀን	Däjän	
ደጃዝማች	Däjjazmač	
ደጃፍ	Däjjaf	
ደጅ	Däjj	
ደጅ ይትኑ	DäjjYeṭnu	
ደጅ ይጥኑ	DäjjYeṭnu	
ደገፉ	Dägäfu	
ደገፋ	Dägäfa	
ደጉ	Däggu	
ደጊቱ	Däggitu	
ደጋ	Däga	
ደጋን	Dägan	
ደጋጋ	Dägaga	
ደጌ	Däggé	
ደግ ነህ	DäggNäh	
ደግለሃን	Däglähan	
ደግነት	Däggennät	
ደግዳጋ	Dägdagga	
ደግፌ	Däggefé	
ደፈጣ	Däfäṭa	
ደፈጫ	Däfäč̣a	
ደፋር	Däffar	
ዱለት	Dulät	
ዱለቻ	Dulläčča	
ዱለኛ	Dulläñña	
ዱላ	Dulla	
ዱልዱም	Duldum	
ዱሎ	Dulo	
ዱሜሳ	Duméssa	
ዱረቲ	Durätti	
ዱሪ	Duri	
ዱራሜ	Duramé	
ዱር	Dur	
ዱርዬ	Dureyyé	
ዱሮ	Duro	
ዱሽ	Duš	
ዱቄት	Duqét	
ዱበርቲ	Dubärti	
ዱባ	Dubba	
ዱቤ	Dubé	
ዱብ አለ	Dubb-Älä	
ዱብ እዳ	Dubb-Eda	
ዱኪ	Duki	
ዱካ	Dukka	
ዱኬ	Duki	
ዱዳ	Duda	
ዱፍቲ	Dufti	
ዲላ	Dilla	
ዲማ	Dima	
ዲሞፍተር	Dimoftär	
ዲሮ	Diro	
ዲሳሳ	Disasa	
ዲቃላ	Diqala	
ዲብ	Dib	
ዲታ	Ditta	
ዲንሳ	Dinsa	
ዲንሾ	Dinšo	
ዲያቆን	Diyaqon	
ዲያብሎስ	Diyabelos	
ዲዮስቆሮስ	Diyosqoros	
ዲዮቅልጥያኖስ	Diyoqleṭeyanos	
ዲዲሞ	Didimo	
ዲድስቅልያ	Didesqeleya	
ዳሌ	Dallé	
ዳልቻ	Dalečča	
ዳልጋ	Dalga	
ዳመነ	Dammänä	
ዳማ	Dama	
ዳምጠው	Damṭäw	
ዳምጤ	Damṭé	
ዳሞት	Damot	
ዳሞትራ	Damotra	
ዳረጐት	Darägot	ዳረጎት
ዳሪሙ	Darimu	
ዳሪቱ	Daritu	
ዳርም የለሽ	Daremm-Yälläš	
ዳርቻ	Darečča	
ዳርጌ	Dargé	
ዳስ	Das	
ዳሸን	Dašän	
ዳቢት	Dabit	
ዳባ	Daba	
ዳባሽ	Dabaš	
ዳባት	Dabat	
ዳቤ	Dabbé	
ዳቦ	Dabbo	
ዳተኛ	Datäñña	
ዳንኤል	Dane'él	
ዳንኪራ	Dankira	
ዳንዴ	Dandé	
ዳንግላ	Dangela	
ዳንግሌ	Dangelé	
ዳኘው	Daññäw	
ዳኛ	Dañña	
ዳኛቸው	Daññaččäw	
ዳኛችው	Daññaččä	
ዳኜ	Daññé	
ዳካ	Dakka	
ዳክዬ	Dakkeyyé	
ዳዊት	Dawit	
ዳዋ	Dawwa	
ዳውላ	Dawella	
ዳውንት	Dawent	
ዳውድ	Dawed	
ዳውዶ	Dawdo	
ዳውጃ	Dawejja	
ዳዲ	Dadi	
ዳገት	Dagät	
ዳጉሳ	Dagussa	
ዳግመኛ	Dagmäñña	
ዳግማዊ	Dagmawi	
ዳግማዊት	Dagmawit	
ዳግም	Dagem	
ዳግምዊ	Dagmawi	
ዳጨው	Dač̣äw	
ዳፍንታም	Dafentam	
ዳፍንት	Dafent	
ዴልቻ	Délča	
ዴሬሳ	Déréssa	
ዴጋሳ	Dégasa	
ድሀነት	Dehennät	
ድሁር	Dehur	
ድሃ	Deha	
ድህረ ምረቃ	Dehrä-Merräqa	
ድህረ ቃል	Dehrä-qal	
ድህራ ምረቃ	Dehrä-merräqa	
ድህነት	Dehennät	
ድል	Del	
ድል ነሳሁ	DelNässahu	
ድል ነሳው	DelNässahu	
ድልህ	Delleh	
ድልባን	Delban	
ድልብ	Delb	
ድልዝ	Dellez	
ድልድል	Delbel	
ድልድይ	Deldeyy	
ድሎት	Delot	
ድመት	Demmät	
ድሜጥሮስ	Deméṭros	
ድም ግባት	DämGebat	
ድምበል	Dämbäl	
ድምቡሼ	Dembuššé	
ድምቢጥ	Dembiṭṭ	
ድምብላል	Dembelal	
ድምኳን	Denkʷn	
ድምጸ	Demṣä-	
ድምጻዊ	Demṣawi	
ድምጻውያን	Demṣaweyan	
ድምጼ	Demṣé	
ድምጽ	Demṣ	
ድረሴ	Deräsé	
ድረስ	Deräs	
ድሪ	Deri	
ድራር	Derar	
ድሬ ዳዋ	DerréDawa	
ድርሞ	Dermo	
ድርሻ	Derša	
ድርሻዬ	Deršayé	
ድርቆሽ	Derqoš	
ድርብ	Derreb	
ድርብርብ	Derebreb	
ድርቧ	Derrebʷ	
ድርጃ	Däräja	
ድርጅት	Derejjet	
ድርጐ	Dergo	ድርጎ
ድርጭት	Dereč̣ett	
ድስት	Dest	
ድቀት	Deqqät	
ድቁስ	Deqqus	
ድቁና	Dequnna	
ድበላ	Debbäla	
ድቡልቡል	Debulbul	
ድቢ	Debbi	
ድባብ	Debab	
ድቤ	Debbi	
ድብ	Debb	
ድብ እዳ	Dubb-Eda	
ድብልቅ	Debelleq	
ድብልቅልቅ	Debleqleq	
ድብሪቱ	Däbritu	
ድብሬ	Däbré	
ድብቁ	Denqu	
ድብኝት	Debeññet	
ድብደባ	Debdäba	
ድብዳብ	Debdab	
ድንቀራ	Dänqära	
ድንቁ	Denqu	
ድንቁት	Denqut	
ድንቄ	Denqé	
ድንቅ	Denq	
ድንቅ ነሽ	DenqNäš	
ድንቅነሽ	DenqNäš	
ድንቋ	Denqʷ	
ድንበሩ	Denbäru	
ድንበር	Denbär	
ድንቡሎ	Denbullo	
ድንች	Dennečč	
ድንክ	Denk	
ድንክዬ	Denkeyyé	
ድንኳን	Denkʷn	
ድንገተኛ	Dengätäñña	
ድንጉላ	Dengula	
ድንጉዜ	Denguzé	
ድንጉጥ	Denguṭ	
ድንጋያማ	Dengayamma	
ድንጋይ	Dengay	
ድንግል	Dengel	
ድንፋታ	Denfata	
ድኝ	Deññ	
ድኩላ	Dekkula	
ድኩማን	Dekuman	
ድኩም	Dekum	
ድውያን	Dewweyan	
ድውይ	Dewwey	
ድድ	Dedd	
ድጅኖ	Dejno	
ድጉማ	Deguma	
ድጉስ	Degus	
ድጋፌ	Degafé	
ድጋፍ	Degaf	
ድግ	Deg	
ድግምት	Degemt	
ድግስ	Degges	
ድግጣ	Degeṭṭa	
ድጐማ	Deggoma	
ድጓ	Deggʷ	
ድፋባቸው	Defabbaččäw	
ድፋት	Defat	
ድፎ	Defo	
ዶለዝ	Dolläz	
ዶማ	Doma	
ዶርዜ	Dorzé	
ዶርዜ ሀይዞ	DorzéHäyzo	
ዶሮ	Doro	
ዶሴ	Dosé	
ዶሴኛ	Doséñña	
ዶቃ	Doqa	
ዶባ	Dobba	
ዶቲ	Doti	
ዶቴ	Doti	
ዶኬ	Dokké	
ዶዮ	Doyyo	
ዶዶላ	Dodola	
ዶግ	Dog	
ዶጮ	Doč̣č̣o	
ዶፈር	Dofär	
ዶፍ	Dof	
ጀሀር	Jähär	
ጀሊል	Jälil	
ጀላል	Jälal	
ጀሌ	Jälé	
ጀልባ	Jälba	
ጀልዱ	Jäldu	
ጀማ ነህ	JämaNäh	
ጀማ ነሽ	JämaNäš	
ጀማል	Jämal	
ጀምበሩ	Jämbäru	
ጀምበሬ	Jämbäré	
ጀምበር	Jämbär	
ጀርባ	Järba	
ጀበና	Jäbäna	
ጀቢሳ	Jäbésa	
ጀባር	Jäbar	
ጀቤሳ	Jäbésa	
ጀብደኝነት	Jäbdäññennät	
ጀብዱ	Jäbdu	
ጀንብ	Jänb	
ጀግና	Jägna	
ጀግንነት	Jägnennät	
ጀግኖች	Jägnočč	
ጁሁር	Jehour	
ጂል	Jil	
ጂማ	Jimma	
ጂራሞ	Jiramo	
ጂሬ	Jiré	
ጂብሪል	Jibril	
ጂን	Jinn	
ጂግሳ	Jigsa	
ጃለታ	Jaläta	
ጃምቦ	Jambo	
ጃምዮ	Jammeyyo	
ጃርት	Jart	
ጃቢር	Jabir	
ጃን	Jan	
ጃን ሜዳ	Jan-Méda	
ጃን ጥራር	Jan-Ṭerar	
ጃንደረባ	Jandäräba	
ጃኖ	Jano	
ጃፈር	Jafär	
ጃፈሮ	Jafäro	
ጄሶ	Jésso	
ጅሁር	Jehur	
ጅማ	Jemma	
ጅማታም	Jemmatam	
ጅማት	Jemmat	
ጅምላ	Jemla	
ጅረት	Jerät	
ጅሩ	Jerru	
ጅራት	Jerat	
ጅራፍ	Jeraf	
ጅባት	Jebbat	
ጅብ	Jeb	
ጅብሩክ	Jebruk	
ጅንፎ	Jenfo	
ጅው ጅው	JewwJeww	
ጅውጅው	JewwJeww	
ጅጅጋ	Jejjega	
ጅጌ	Jegé	
ጅግራ	Jegra	
ጅፋር	Jefar	
ጆቢራ	Jobira	
ጆቴ	Joté	
ጆንያ	Joneyya	
ጆፌ	Joffé	
ጆፍጆፌ	Jofjoffé	
ገሀ	Gähä	
ገሃነም	Gähannäm	
ገሃድ	Gähad	
ገለልተኛ	Gälältäñña	
ገለምሶ	Gälämso	
ገለባ	Gäläba	
ገለብ	Gäläb	
ገለቱ	Gälätu	
ገለታ	Gäläta	
ገለፈት	Gäläfät	
ገሊላ	Gälila	
ገሊላዊ	Gälilawi	
ገላ	Gäla	
ገላ ሁን	Gäla Hun	
ገላ ነህ	Gäla Näh	
ገላ ነሽ	Gäla Näš	
ገላሁን	Gälahun	
ገላሲ	Gälasi	
ገላትያ	Gälateya	
ገላና	Gälana	
ገላን	Gälan	
ገላው	Gälaw	
ገላውዴዎስ	Gälaedéwos	
ገላዬ	Gälayé	
ገላጋይ	Gälagay	
ገላግሌ	Gälaglé	
ገል	Gell	
ገልቱ	Gältu	
ገልጃጃ	Gäljajja	
ገመምተኛ	Gämämtäñña	
ገመሬ	Gemärré	
ገመቹ	Gämmäčču	
ገመች	Gämmäčč	
ገመና	Gämäna	
ገመዳ	Gämmädda	
ገመድ	Gämäd	
ገመገም	Gämägäm	
ገማልኤል	Gämale'él	
ገሜሳ	Gämméssa	
ገምቢ	Gämbi	
ገምባሌ	Gämballé	
ገምታ	Gämta	
ገምጋሚ	Gämgami	
ገምጦ ወጥ	Gämṭo-Wäṭṭ	
ገሞራ	Gämora	
ገሞራው	Gämoraw	
ገረመው	Gärrämäw	
ገረሱ	Gäräsu	
ገረድ	Gäräd	
ገራም	Gärram	
ገራገር	Gäragär	
ገራፊ	Gärafi	
ገርማሜ	Gärmammé	
ገርቢ	Gärbi	
ገሰሰ	Gässäsä	
ገሰሰች	Gässäsäčč	
ገሰሰው	Gässäsäw	
ገሳ	Gäsa	
ገበሎ	Gäbälo	
ገበሬ	Gäbäré	
ገበታ	Gäbäta	
ገበቴ	Gäbäté	
ገበዝ	Gäbäz	
ገበየሁ	Gäbäyyähu	
ገበያ ነሽ	GäbäyaNäš	
ገበያው	Gäbäyaw	
ገበጣ	Gäbäṭa	
ገቢር	Gäbir	
ገቢሳ	Gäbbisa	
ገባር	Gäbbar	
ገቤሳ	Gäbbéssa	
ገብ	Gäbb	
ገብረ	Gäbrä-	
ገብረ ጉራቻ	Gäbrä-Gurračča	
ገብረ ጉንዳን	Gebrä-Gundan	
ገብሩ	Gäbru	
ገብራት	Gäbrat	
ገብራይ	Gäbray	
ገብሬ	Gäbré	
ገብር ኤሏ	Gäbre'élʷ	
ገብርኤል	Gäbr'él	
ገብርኤሏ	Gäbre'élʷ	
ገብርዬ	Gäbreyyé	
ገብነት	Gäbbennät	
ገብጋባ	Gäbgabba	
ገትየ	Gäteyyä	
ገቺ	Gäčči	
ገቻ	Gečča	
ገች	Gečč	
ገነሞ	Gänämo	
ገነቲ	Gännäti	
ገነቴ	Gännäti	
ገነት	Gännät	
ገነነ	Gännänä	
ገና	Gänna	
ገናሌ	Gännalé	
ገንዘብ	Gänzäb	
ገንዲ	Gändi	
ገንዳ	Gända	
ገንፎ	Gänfo	
ገዙ	Gäzzu	
ገዛኸኝ	Gäzzak̃äññ	
ገዛኽኝ	Gäzzak̃äññ	
ገዝሙ	Gäzmu	
ገዥ	Gäz̃	
ገዥነት	Gäz̃ennät	
ገደል	Gädäl	
ገደቡ	Gädäbu	
ገደብ	Gädäb	
ገዳ	Gäda	
ገዳሙ	Gädamu	
ገዳሜ	Gädamé	
ገዳም	Gädam	
ገዳሪፍ	Gädarif	
ገዳዳ	Gädada	
ገዴ	Gäddé	
ገድ	Gädd	
ገድሉ	Gädlu	
ገድሌ	Gädlé	
ገጀሞ	Gäjämo	
ገጀረት	Gäjärät	
ገጅሞ	Gäjämo	
ገጅረት	Gäjärät	
ገጠሬ	Gäṭäré	
ገጠር	Gäṭär	
ገጣሚ	Gäṭami	
ገጦ ለጣይ	Gäṭṭo-Läṭay	
ገጽ	Gäṣṣ	
ገፈታ	Gäfäta	
ገፈፋ	Gäfäfa	
ገፋፊ	Gäfafi	
ጉሀር	Guhär	
ጉለሌ	Gullällé	
ጉለንታ	Guläntta	
ጉሉይ	Guluy	
ጉሌልሞ	Gulélmo	
ጉልህ	Guleh	
ጉልላት	Gullelat	
ጉልማ	Gulemma	
ጉልበት	Gulbät	
ጉልባን	Gulban	
ጉልተኛ	Gultäñña	
ጉልታዊ	Gultawi	
ጉልታዊነት	Gultawinnät	
ጉልቴ	Gulté	
ጉልት	Gullet	
ጉልቻ	Gullečča	
ጉሎ	Gulo	
ጉማ	Guma	
ጉማሬ	Gumarré	
ጉሜ	Gumé	
ጉም	Gum	
ጉምሩክ	Gumruk	
ጉረኖ	Guränno	
ጉረኛ	Gurräñña	
ጉራ	Gura	
ጉራ ምድር	GuraMeder	
ጉራማይሌ	Guramaylé	
ጉራራ	Gurara	
ጉራቻ	Gurračča	
ጉራንጉር	Gurangur	
ጉራጌ	Guragé	
ጉሬዛ	Guréza	
ጉርሙ	Gurmu	
ጉርሜሳ	Gurméssa	
ጉርሱም	Gursum	
ጉርስ	Gurs	
ጉርሸጥ	Guršeṭṭ	
ጉርሻ	Gurša	
ጉርሽጥ	Guršeṭṭ	
ጉርቢያ	Gurbiya	
ጉርብትና	Gurbetenna	
ጉርአ	Gur'ä	
ጉርአጌ	Gur'ä-gé	
ጉርኣ	Gur'a	
ጉርጥ	Gurṭ	
ጉሮሮ	Gurorro	
ጉስምት	Gusemt	
ጉስቁልና	Gusqulenna	
ጉስጉሻ	Gusgušša	
ጉሽ	Guš	
ጉሽም	Guššem	
ጉሽርጥ	Gušreṭṭ	
ጉበት	Gubbät	
ጉበን	Gubän	
ጉበኝነት	Gubeññet	
ጉባ	Gubba	
ጉባኤ	Guba'é	
ጉባይ	Gubay	
ጉብላው	Gubelaw	
ጉብል	Gubel	
ጉብልዬ	Gubeleyyé	
ጉብኝት	Gubeññet	
ጉቦ	Gubbo	
ጉተማ	Gutäma	
ጉቱ	Guttu	
ጉታ	Guta	
ጉትቻ	Gutečča	
ጉትያ	Gutteyya	
ጉቶ	Gutto	
ጉናጉና	Gunagune	
ጉንዳን	Gundan	
ጉንድሽ	Gundeš	
ጉንዶ	Gundo	
ጉንጉን	Gungun	
ጉንፋን	Gunfan	
ጉዝጉዝ	Guzegguz	
ጉዝጓዝ	Guzgʷz	
ጉዞ	Guzo	
ጉያ	Guyya	
ጉደር	Gudär	
ጉደታ	Guddäta	
ጉዱ	Gudu	
ጉዲት	Gudit	
ጉዲና	Guddina	
ጉዲፈቻ	Guddifäčča	
ጉዳ	Gudda	
ጉዳዩ	Guddayu	
ጉዳዬ	Guddayé	
ጉዳይ	Gudday	
ጉዳዮች	Guddayočč	
ጉዴላ	Gudélla	
ጉድሩ	Gudru	
ጉድሮ	Guderro	
ጉድባ	Gudba	
ጉድኝ	Gudeññ	
ጉድዩ	Guddayu	
ጉድፍ	Gudef	
ጉዶ	Gudo	
ጉጉት	Guggut	
ጉግሳ	Gugsa	
ጉግስ	Gugs	
ጉጠት	Guṭät	
ጉጭማ	Guč̣ma	
ጉፋያ	Gufayya	
ጉፍታ	Gufta	
ጊላ	Gila	
ጊላይ	Gilay	
ጊምቢ	Gimbi	
ጊርቦ	Girbo	
ጊርጊሮ	Girgiro	
ጊቺሌ	Gičillé	
ጊንዳእ	Ginda'e	
ጊንዶ	Gindo	
ጊንጥ	Ginṭ	
ጊንጪ	Ginč̣i	
ጊዜ	Gizé	
ጊዜያዊ	Gizéyawi	
ጊዮርጊስ	Giyorgis	
ጊደር	Gidär	
ጊዶሌ	Gidollé	
ጊጤ	Giṭé	
ጋለሞታ	Galämota	
ጋሌብ	Galéb	
ጋማ	Gamma	
ጋሜ	Gammé	
ጋምቤላ	Gambélla	
ጋረደው	Garrädäw	
ጋሪ	Gari	
ጋራተኛ	Gfratäñña	
ጋራታኛ	Garatäñña	
ጋሬ	Garré	
ጋሬጣ	Garéṭa	
ጋርዛ	Garza	
ጋርዮሽ	Gareyyoš	
ጋሻ	Gašša	
ጋሻ ጃግሬ	GaššaJagré	
ጋሻው	Gaššaw	
ጋቢ	Gabi	
ጋብር	Gaber	
ጋተው	Gatäw	
ጋት	Gat	
ጋኔን	Ganén	
ጋን	Gan	
ጋንዛ	Ganza	
ጋንድያ	Gandeyya	
ጋንፉር	Ganfur	
ጋዜጠኛ	Gazéṭäñña	
ጋዜጣ	Gazéṭa	
ጋያ	Gayya	
ጋይንት	Gayent	
ጋዲ	Gadi	
ጋድ	Gad	
ጋጋሪ	Gagari	
ጋጋኖ	Gagano	
ጋጠ ወጥ	Gaṭä-Wäṭṭ	
ጋጥ	Gaṭ	
ጋፋት	Gafat	
ጌራ	Géra	
ጌሾ	Géšo	
ጌታ	Géta	
ጌታ ሁን	GétaHun	
ጌታ ነህ	GétaNäh	
ጌታቸው	Gétaččäw	
ጌታው	Gétaw	
ጌቴሴማኒ	Gétésémai	
ጌትነት	Gétennät	
ጌትዬ	Géteyyé	
ጌቺሌ	Gicillé	
ጌንዶ	Géndo	
ጌዴዎን	Gédéwon	
ጌዴዮን	Gédéyon	
ጌዶ	Gédo	
ጌጃ	Géjja	
ጌጡ	Géṭu	
ጌጣ ጌጥ	Géṭa-Géṭ	
ጌጤ	Géṭé	
ጌጤ ነሽ	GéṭéNäš	
ጌጥ	Géṭ	
ግለ ሂስ	Gellä-His	
ግለኛ	Gelläñña	
ግሉዝ	Ge'uz	
ግላ ነህ	GälaNäh	
ግላ ነሽ	GälaNäš	
ግላስ	Gelas	
ግላዊ	Gellawi	
ግል	Gell	
ግል ሰብ	Gellä-Säb	
ግልበጣ	Gelbäṭa	
ግልቢያ	Gelbiya	
ግልባጭ	Gelebbač̣	
ግልብ	Gelb	
ግልድም	Geldem	
ግልገል	Gelgäl	
ግልጽ	Gelṣ	
ግመል	Gemäl	
ግመሬ	Gemärré	
ግማሽ	Gemmaš	
ግማደ	Gemmadä-	
ግሜ	Gemé	
ግምል	Gemmel	
ግምበኛ	Gembäñña	
ግምባር	Gembar	
ግምት	Gemmet	
ግምጃ	Gemja	
ግምገማ	Gemgäma	
ግረት	Gerät	
ግሩም	Gerum	
ግራ	Gera	
ግራር	Gerar	
ግራኝ	Geraññ	
ግራዋ	Gerawwa	
ግራዝማች	Gerazmač	
ግራጫ	Gerač̣č̣a	
ግርማ	Germa	
ግርማ ሁን	GermaHun	
ግርማቸው	Germaččäw	
ግርማዊ	Germawi	
ግርማዊት	Germawit	
ግርማው	Germaw	
ግርማዬ	Germayé	
ግርማይ	Germay	
ግርምቢጥ	Germbiṭ	
ግርድፍ	Gerdef	
ግርዶሽ	Gerdoš	
ግርጌ	Ger-gé	
ግርግም	Gergem	
ግርግር	Gerregerr	
ግርግዳ	Gergedda	
ግርፊያ	Gerfiya	
ግርፋት	Gerrefat	
ግሰሰው	Gässäsäw	
ግስ	Gess	
ግስላ	Gessella	
ግስንግስ	Gesenges	
ግስጋሴ	Geseggasé	
ግሼ	Geššé	
ግሼን	Gešén	
ግሽጣ	Gešṭa	
ግቢ	Gebbi	
ግባተ መሬት	Geb'ätä-Märét	
ግብ	Geb	
ግብረ ሰዶም	Gebrä-Sädom	
ግብረ ስዶም	Gebrä-Sädom	
ግብረ ስጋ	Gebrä-Sega	
ግብረ በላ	Gebrä-Bälla	
ግብረ አበር	Gebrä-Äbbär	
ግብረ አበሮች	Gebrä-Äbbäročč	
ግብረ ጉንዳን	Gebrä-Gundan	
ግብረቱ	Gebrätu	
ግብር	Gebr	
ግብር	Geber	
ግብርና	Gebrenna	
ግብታዊ	Gebtawi	
ግብታዊነት	Gebtawinnät	
ግብአተ መሬት	Geb'ätä-Märét	
ግብዘና	Gebzenna	
ግብዝ	Gebbez	
ግብዝነት	Gebbezennät	
ግብዝና	Gebzenna	
ግብዣ	Gebz̃a	
ግብጦ	Gebṭo	
ግተት	Gettät	
ግትልትል	Geteltel	
ግትር	Getter	
ግትቻ	Getečča	
ግቻ	Gečča	
ግች	Gečč	
ግንባር	Genbar	
ግንብ	Genb	
ግንቦት	Genbot	
ግንኙነት	Geneññunnät	
ግንዘት	Genzät	
ግንደ በላ	Gendä-Bäll	
ግንደ በል	Gendä-Bäll	
ግንደ በረት	Gendä-Bärät	
ግንድ	Gend	
ግንጭል	Genč̣el	
ግኡዝ	Ge'uz	
ግእዝ	Ge'ez	
ግዛት	Gezat	
ግዛቸው	Gezaččäw	
ግዛው	Gezaw	
ግዝረት	Gezrät	
ግዝት	Gezzet	
ግዞተኛ	Gezotäñña	
ግዞት	Gezot	
ግዥ	Gez̃z̃	
ግዮን	Geyon	
ግደይ	Gedäy	
ግዳይ	Gedday	
ግዳጅ	Geddaj	
ግዴ	Geddé	
ግዴለሽ	Geddélläš	
ግዴሳ	Geddéssa	
ግዴታ	Geddéta	
ግድንግድ	Gedenged	
ግድያ	Gedeyya	
ግድግዳ	Gedgedda	
ግድፈት	Gedfät	
ግገን	Geggän	
ግግ	Gegg	
ግጥሚያ	Geṭmiya	
ግጦሽ	Geṭoš	
ግጫ	Geč̣č̣a	
ግጭት	Geč̣č̣et	
ግጻዌ	Geṣṣawé	
ግፈኛ	Gefäñña	
ግፊት	Geffit	
ግፍልፍል	Gefelfel	
ጐህ	Goh	
ጐለሻ	Goläšša	
ጐላ	Golla	
ጐላሽ	Goläšša	
ጐልማሳ	Golmassa	
ጐልማሶች	Golmassočč	
ጐልያድ	Goleyad	
ጐልጐታ	Golegota	
ጐመን	Gommän	
ጐመድ	Gomäd	
ጐማ	Gomma	
ጐማዳ	Gomada	
ጐረምሳ	Gorämsa	
ጐረቤት	Goräbét	
ጐረዶማን	Gorädoman	
ጐረጐማ	Gorägoma	
ጐራ	Gora	
ጐራው	Goraw	
ጐሬ	Goré	
ጐርምጥ	Gormeṭ	
ጐርባጣ	Gorbaṭṭa	
ጐርናና	Gornanna	
ጐርጐራ	Gorgora	
ጐርጐርዮስ	Gorgoreyos	
ጐርፉ	Gorfu	
ጐርፍ	Gorf	
ጐርፍ ነህ	GorfNäh	
ጐርፍነህ	GorfNäh	
ጐሮ	Goro	
ጐሮዶማን	Gorodoman	
ጐሳ	Gosa	
ጐሳዬ	Gosayé	
ጐስሜ	Gossemé	
ጐስቋላ	Gosqʷlla	
ጐሹ	Goššu	
ጐሽ	Gošš	
ጐሽዬ	Goššeyyé	
ጐበና	Gobäna	
ጐበኛ	Gobäñña	
ጐበዜ	Gobäzé	
ጐበዝ	Gobäz	
ጐባ	Gobba	
ጐባን	Gobban	
ጐባጣ	Gobaṭa	
ጐቤ	Gobé	
ጐብዬ	Gobbeyyé	
ጐተራ	Gotära	
ጐቸራ	Gočära	
ጐናፍር	Gonafer	
ጐንቾ	Gončo	
ጐንደሬ	Gondäré	
ጐንደር	Gondär	
ጐንፋ	Gonfa	
ጐኜ	Goññé	
ጐይትኦም	Goyte'om	
ጐይቶም	Goytom	
ጐደሎ	Godälo	
ጐዳና	Godana	
ጐዳዳ	Godada	
ጐጃሜ	Gojjamé	
ጐጃም	Gojjam	
ጐጆ	Gojjo	
ጐጣጉጥ	Goṭaguṭ	
ጐጣጐጥ	Goṭaguṭ	
ጐፈሬ	Gofäré	
ጐፈር	Gofär	
ጓል	Gʷl	
ጓሮ	Gʷro	
ጓሳ	Gʷssa	
ጓደኛ	Gʷddäñña	
ጓዱ	Gʷddu	
ጓዴ	Gʷddé	
ጓድ	Gʷdd	
ጓዶች	Gʷddočč	
ጓጉንቸር	Gʷgunčär	
ጠለለ	Ṭällälä	
ጠለለች	Ṭälläläčč	
ጠለላ	Ṭäläla	
ጠላ	Ṭälla	
ጠላት	Ṭälat	
ጠላፊ	Ṭälafi	
ጠልሰም	Ṭälsäm	
ጠመኔ	Ṭämäné	
ጠመንጃ	Ṭämänja	
ጠመዝማዛ	Ṭämäzmazza	
ጠመዥ	Ṭämäz̃	
ጠማማ	Ṭämama	
ጠረን	Ṭärän	
ጠረጴዛ	Ṭäräp̣p̣éza	
ጠረፍ	Ṭäräf	
ጠራራ	Ṭärara	
ጠርሙስ	Ṭärmus	
ጠርዝ	Ṭärz	
ጠቅላላ	Ṭäqlalla	
ጠቅላይ	Ṭäqlay	
ጠቋሚ	Ṭäqqʷmi	
ጠቋር	Ṭäqʷr	
ጠበል	Ṭäbäl	
ጠበቃ	Ṭäbäqa	
ጠበቆች	Ṭäbäqočč	
ጠበብት	Ṭäbbäbt	
ጠቢቡ	Ṭäbibu	
ጠቢባን	Ṭäbiban	
ጠቢብ	Ṭäbib	
ጠባባት	Ṭäbbabat	
ጠባብ	Ṭäbbab	
ጠባይ	Ṭäbay	
ጠብቃቸው	Ṭäbbeqaččäw	
ጠብቄ	Ṭäbbeqé	
ጠብቆች	Ṭäbäqočč	
ጠብታ	Ṭäbbeta	
ጠብደል	Ṭäbdäl	
ጠቦት	Ṭäbbot	
ጠና	Ṭänna	
ጠኔ	Ṭänné	
ጠንቀኛ	Ṭänqäñña	
ጠንቃቃ	Ṭänqaqqa	
ጠንቅ	Ṭänq	
ጠንቋይ	Ṭänqʷy	
ጠንበለል	Ṭänbäläl	
ጠንካራ	Ṭänkarra	
ጠንክራ	Ṭänkarra	
ጠንክር	Ṭänker	
ጠንፌ	Ṭänfé	
ጠንፍ የለሽ	ṬänfYälläš	
ጠንፍ ያለሽ	ṬänfYälläš	
ጠውላጋ	Ṭäwlagga	
ጠይቅ	Ṭäyyeq	
ጠይብ	Ṭäyeb	
ጠዲቅ	Ṭädiq	
ጠጂቱ	Ṭäjjitu	
ጠጄ	Ṭäjjé	
ጠጅ	Ṭäjj	
ጠገራ	Ṭägära	
ጠገናው	Ṭägänaw	
ጠገኔ	Ṭägäné	
ጠገግ	Ṭägäg	
ጠጋኝ	Ṭäggañ	
ጠጭ	Ṭäč̣č̣	
ጠፈር	Ṭäfär	
ጠፍ	Ṭäf	
ጠፍጣፋ	Ṭäfṭaffa	
ጡሃር	Ṭuhar	
ጡሉ	Ṭullé	
ጡሌ	Ṭullé	
ጡረታ	Ṭuräta	
ጡብ	Ṭub	
ጡት	Ṭut	
ጡንቻ	Ṭunčča	
ጡዝ	Ṭuz	
ጡጫ	Ṭuč̣č̣a	
ጡፋ	Ṭufa	
ጢም	Ṭim	
ጢሞቴዎስ	Ṭimotéwos	
ጢሮስ	Ṭiros	
ጢሰኛ	Ṭisäñña	
ጢስ	Ṭis	
ጢቆ	Ṭiqqo	
ጢብኛ	Ṭibbeñña	
ጢቾ	Ṭiččo	
ጢነኛ	Ṭinäñña	
ጢኖ	Ṭinno	
ጣሂም	Ṭahim	
ጣሂር	Ṭahir	
ጣሃ	Ṭaha	
ጣሃር	Ṭahar	
ጣልቃ	Ṭalqa	
ጣምራ	Ṭamra	
ጣረ ሞት	Ṭarä-Mot	
ጣራ	Ṭara	
ጣሰው	Ṭasäw	
ጣቃ	Ṭaqa	
ጣቢታ	Ṭabita	
ጣቢያ	Ṭabiya	
ጣባ	Ṭaba	
ጣት	Ṭat	
ጣና	Ṭana	
ጣእመ	Ṭa'emä	
ጣእሙ	Ṭa'emu	
ጣኦት	Ṭa'ot	
ጣውንት	Ṭawent	
ጣዝማ	Ṭazma	
ጣይቱ	Ṭaytu	
ጣጣቴ	Ṭaṭaté	
ጣፈጠ	Ṭaffäṭä	
ጣፊያ	Ṭaffiya	
ጣፋጭ	Ṭafač̣	
ጣፍያ	Ṭaffeya	
ጤነኛ	Ṭénäñña	
ጤና	Ṭéna	
ጤና አዳም	ṬénaÄddam	
ጤናዬ	Ṭénayé	
ጤናዳም	Ṭénaddam	
ጤዛ	Ṭéza	
ጤፍ	Ṭéf	
ጥህሎ	Ṭehelo	
ጥላ ሁን	ṬelaHun	
ጥላ ሸት	ṬelaŠät	
ጥላቻ	Ṭelačča	
ጥላዬ	Ṭelayé	
ጥልቀት	Ṭelqät	
ጥልቆ	Ṭelleqqo	
ጥልጣል	Ṭelṭal	
ጥልፍ	Ṭelf	
ጥሎሽ	Ṭeloš	
ጥሙጋ	Ṭemmugga	
ጥምቀት	Ṭemqät	
ጥሞና	Ṭemmona	
ጥረሾ	Ṭeräššo	
ጥሩ	Ṭeru	
ጥሩ ነህ	Ṭeru Näh	
ጥሩ ነሽ	Ṭeru Näš	
ጥሩ ንህ	ṬeruNäh	
ጥሩ ንሽ	ṬeruNäš	
ጥሩምባ	Ṭerumbba	
ጥሪ	Ṭerri	
ጥሪት	Ṭerit	
ጥራ ጥሬ	Ṭera-Ṭeré	
ጥራት	Ṭerat	
ጥራዝ	Ṭeraz	
ጥራዞች	Ṭerazočč	
ጥሬ	Ṭeré	
ጥር	Ṭerr	
ጥርኝ	Ṭereññ	
ጥርጊያ	Ṭergiya	
ጥርጣሬ	Ṭereṭṭaré	
ጥሻ	Ṭeša	
ጥቀ ሄር	Ṭeqqä-Hér	
ጥቀሄር	Ṭeqqä-Hér	
ጥቀርሻ	Ṭeqärša	
ጥቁር	Ṭequr	
ጥቃቅን	Ṭeqaqqen	
ጥቅል	Ṭeqell	
ጥቅምት	Ṭeqemt	
ጥቅስ	Ṭeqs	
ጥቅሻ	Ṭeqša	
ጥቋር	Ṭäqʷr	
ጥበቃ	Ṭebbäqa	
ጥበበ	Ṭebäbä	
ጥበበኛ	Ṭebäbäñña	
ጥበቡ	Ṭebäbu	
ጥበብ	Ṭebäb	
ጥባባኛ	Ṭebäbäñña	
ጥብቆ	Ṭebbeqqo	
ጥብኛ	Ṭebbeñña	
ጥብጣብ	Ṭebṭab	
ጥናት	Ṭenat	
ጥንስስ	Ṭenses	
ጥንቁቅ	Ṭenquq	
ጥንቅሽ	Ṭenqešš	
ጥንታዊ	Ṭentawi	
ጥንት	Ṭent	
ጥንቸል	Ṭenčäl	
ጥንዚዛ	Ṭenzizza	
ጥንድ	Ṭend	
ጥንጁት	Ṭenjut	
ጥንግ	Ṭeng	
ጥኡመ	Ṭe'unä	
ጥያቄ	Ṭeyyaqé	
ጥይት	Ṭeyyet	
ጥጃ	Ṭejja	
ጥገት	Ṭeggät	
ጥገና	Ṭeggäna	
ጥገናዊ	Ṭeggänawi	
ጥገኛ	Ṭeggäñña	
ጥጉ	Ṭeggu	
ጥጋቡ	Ṭegabu	
ጥጋብ	Ṭegab	
ጥግ ነህ	ṬeggNäh	
ጥጥ	Ṭeṭ	
ጥፊ	Ṭeffi	
ጥፍር	Ṭefer	
ጥፍጥሬ	Ṭefṭeré	
ጦሊት	Ṭolit	
ጦማር	Ṭomar	
ጦረኛ	Ṭoräñña	
ጦር	Ṭor	
ጦርነት	Ṭorennät	
ጦሳ	Ṭosa	
ጦስ	Ṭos	
ጦስኝ	Ṭoseññ	
ጦቢያው	Ṭobbiyaw	
ጦይብ	Ṭoyeb	
ጦጢት	Ṭoṭit	
ጦጣ	Ṭoṭa	
ጧት	Ṭʷt	
ጧፌ	Ṭʷfé	
ጧፍ	Ṭʷf	
ጨለለቅቱ	Č̣äläläqtu	
ጨለማ	Č̣älläma	
ጨለንቆ	Č̣älänqo	
ጨሌ	Č̣ällé	
ጨመዳ	Č̣ämäda	
ጨረቃ	Č̣äräqa	
ጨረታ	Č̣äräta	
ጨርቃ ጨርቅ	Č̣ärqa-Č̣ärq	
ጨርቅ	Č̣ärq	
ጨርቆስ	Č̣ärqos	
ጨቄ	Č̣äwé	
ጨቅላ	Č̣äqla	
ጨቋኝ	Č̣äqqʷññ	
ጨበጣ	Č̣äbäṭa	
ጨቡዴ	Č̣äbbudé	
ጨቡድ	Č̣äbbud	
ጨብሲ	Č̣äbsi	
ጨብጥ	Č̣äbṭ	
ጨንቻ	Č̣änč̣a	
ጨንገር	Č̣ängär	
ጨካኝ	Č̣äkkaññ	
ጨዋ	Č̣äwa	
ጨዋቃ	Č̣äwwaqa	
ጨዌ	Č̣äwé	
ጨው	Č̣äw	
ጨጐጐት	Č̣ägogot	
ጨጓራ	Č̣äggʷrra	
ጨጨሆ	Č̣äč̣äho	
ጨጨብሳ	Č̣äč̣č̣äbsa	
ጨፋ	Č̣äffa	
ጨፌ	Č̣äffé	
ጨፍቄ	Č̣äffeqé	
ጩቅ	Č̣uq	
ጩቤ	Č̣ubé	
ጩፋ	Č̣ufa	
ጫላ	Č̣ala	
ጫልቱ	Č̣altu	
ጫልፊት	Č̣elfitt	
ጫማ	Č̣amma	
ጫሜ	Č̣ammé	
ጫሞ	Č̣amo	
ጫት	Č̣at	
ጫኔ	Č̣anné	
ጫን	Č̣an	
ጫን ያለው	Č̣ann-Yaläw	
ጫንቃ	Č̣anqa	
ጫንጮ	Č̣anč̣o	
ጫካ	Č̣akka	
ጫጉ	Č̣agu	
ጫጉላ	Č̣agula	
ጫጩት	Č̣ač̣utt	
ጫጫ	Č̣ač̣a	
ጫፍ	Č̣af	
ጭላሎ	Č̣elalo	
ጭላት	Č̣elat	
ጭላንጭል	Č̣elanč̣el	
ጭሌ	Č̣ollé	
ጭልጋ	Č̣elga	
ጭልፊት	Č̣elfitt	
ጭማቂ	Č̣emmaqi	
ጭምብስብስ	Č̣embesbes	
ጭምት	Č̣emmet	
ጭምጭምታ	Č̣emč̣emta	
ጭረት	Č̣erät	
ጭራ	Č̣era	
ጭራሮ	Č̣eraro	
ጭራቅ	Č̣eraq	
ጭሬ	Č̣erré	
ጭርት	Č̣ert	
ጭሮ አዳሪ	Č̣ero-Ädari	
ጭሰኛ	Č̣esäñña	
ጭስ	Č̣es	
ጭቁን	Č̣eqqun	
ጭቁኖች	Č̣eqqunočč	
ጭቁኝ	Č̣eqquññ	
ጭቃ	Č̣eqa	
ጭቅቅት	Č̣eqeqqet	
ጭቅና	Č̣eqqenna	
ጭቆና	Č̣eqqona	
ጭቡድ	Č̣äbbud	
ጭብሳ	Č̣ebsa	
ጭብኛ	Č̣esäñña	
ጭብጥ	Č̣ebbeṭ	
ጭብጦ	Č̣ebbeṭo	
ጭቦኛ	Č̣ebboñña	
ጭነት	Č̣enät	
ጭን	Č̣en	
ጭንቀት	Č̣enqät	
ጭንቅላት	Č̣enqellat	
ጭንቅሎ	Č̣enqello	
ጭንጋፍ	Č̣engaf	
ጭንጫ	Č̣enč̣a	
ጭኮ	Č̣ekko	
ጭዳ	Č̣eda	
ጭድ	Č̣ed	
ጭገር	Č̣egär	
ጭጉጉት	Č̣egogot	
ጭጋግ	Č̣egag	
ጭጐጐት	Č̣egogot	
ጭፍጨፋ	Č̣efč̣äfa	
ጮሌ	Č̣ollé	
ጮማ	Č̣oma	
ጮራ	Č̣orra	
ጮርቃ	Č̣orqa	
ጮርናቄ	Č̣ornaqqé	
ጮቄ	Č̣oqqé	
ጮቤ	Č̣obbé	
ጮጮ	Č̣oč̣č̣o	
ጰራቅሊጦስ	P̣äraqliṭos	
ጰንጠሌዎን	P̣änṭälléwon	
ጰንጠቆስጤ	P̣änṭäqosṭé	
ጲላጦስ	P̣ilaṭos	
ጳኩሚስ	P̣akumis	
ጳውሎስ	P̣awelos	
ጳጉሜ	P̣agumé	
ጳጳሳት	P̣ap̣p̣asat	
ጳጳስ	P̣ap̣p̣as	
ጴጥሮስ	P̣éṭros	
ጵጉሜ	P̣agimé	
ጸሀዩ	Ṣähäyu	
ጸሀዬ	Ṣähäyyé	
ጸሀይ	Ṣähäy	
ጸሀይ ነሽ	ṢähäyNäš	
ጸሀይቱ	Ṣähäytu	
ጸሀይነሽ	ṢähäyNäš	
ጸሀፊ	Ṣähäfi	
ጸህዩ	Ṣähäyu	
ጸሎተ	Ṣälotä-	
ጸሎት	Ṣälot	
ጸረ	Ṣärä-	
ጸበል	Ṣäbäl	
ጸናጽል	Ṣänaṣel	
ጸዋሬ	Ṣäwaré	
ጸደቀ	Ṣäddäqä	
ጸደይ	Ṣädäy	
ጸዱ	Ṣäddu	
ጸዳለ	Ṣädalä	
ጸዳል	Ṣädal	
ጸድዋ	Ṣädwa	
ጸገዴ	Ṣägädé	
ጸጉራም	Ṣäguram	
ጸጉር	Ṣägur	
ጸጋ	Ṣägga	
ጸጋዬ	Ṣäggyé	
ጸጸት	Ṣäṣät	
ጻህል	Ṣahl	
ጻድቁ	Ṣadequ	
ጻድቃን	Ṣadeqan	
ጻድቅ	Ṣadeq	
ጽሁፍ	Ṣehuf	
ጽህፈት	Ṣehfät	
ጽላተ	Ṣellatä-	
ጽላት	Ṣellat	
ጽልመት	Ṣelmät	
ጽርሀ አርያም	Ṣerhä-Äreyam	
ጽርእ	Ṣer'e	
ጽብረቃ	Ṣebräqa	
ጽንሰ	Ṣensä-	
ጽንስ	Ṣens	
ጽንፈ አርእድ	Ṣenfä-Äre'ed	
ጽንፍ	Ṣenf	
ጽዋ	Ṣewwa	
ጽዮናዊነት	Ṣeyonawinnät	
ጽዮን	Ṣeyon	
ጽጋዬ	Ṣäggayé	
ጽጌ ረዳ	ṢeggéRäda	
ጾመ	Ṣomä-	
ጾም	Ṣom	
ጾር	Ṣor	
ጾታ	Ṣota	
ፈለቀ	Fälläqä	
ፈለቀች	Fälläqäčč	
ፈለገ	Fälägä	
ፈለግ	Fäläg	
ፈሊጥ	Fäliṭ	
ፈላ ምላጭ	Fälla-Melač̣č̣	
ፈላስመን	Fälasmän	
ፈላስፋ	Fälasfa	
ፈላሻ	Fälaša	
ፈላጭ	Fälač̣	
ፈልዳሶ	Fäldasso	
ፈረሱላ	Färäsulla	
ፈረቃ	Färäqa	
ፈረንጅ	Färänj	
ፈረደ	Färrädä	
ፈሪሳዊ	Färisawi	
ፈሪሳውያን	Färisaweyan	
ፈር	Fär	
ፈርስ	Färs	
ፈርኦን	Fär'on	
ፈርካሳ	Furkasa	
ፈርጅ	Färj	
ፈርጣጭ	Färṭač̣	
ፈርጥ	Färṭ	
ፈሰሰ	Fässäsä	
ፈሰሴ	Fäsäsé	
ፈሰስ	Fäsäs	
ፈሳሽ	Fäsaš	
ፈስ	Fäs	
ፈቃደ	Fäqadä	
ፈቃዱ	Fäqadu	
ፈቃዷ	Fäqadʷ	
ፈቄ	Fäqqé	
ፈቅ ይበሉ	Fäqq-Yebälu	
ፈተና	Fätäna	
ፈታይ	Fätay	
ፈትለ	Fätlä	
ፈትል	Fätel	
ፈንታሌ	Fäntalé	
ፈንቴ	Fänté	
ፈንቴሳ	Fäntéssa	
ፈንዜ	Fänzé	
ፈንደለሌ	Fändälälé	
ፈንጋይ	Fängay	
ፈንጠዝያ	Fänṭäzeyya	
ፈንጣጣ	Fänṭaṭa	
ፈዋሽ	Fäwwaš	
ፈይሳ	Fäyyesa	
ፈዲስ	Fädis	
ፈጀቦ	Räjät	
ፈጋራ	Fägara	
ፈጠነ	Fäṭṭänä	
ፈጠጋር	Fäṭägar	
ፈጣሪ	Fäṭari	
ፈጣን	Fäṭṭan	
ፈጫይ	Fäč̣ay	
ፈፋ	Fäfa	
ፉርካሳ	Furkasa	
ፉቅራ	Fuqra	
ፉኝት	Fuññet	
ፉካ	Fuka	
ፉጋ	Fuga	
ፉጨት	Fuč̣ät	
ፊልጶስ	Filep̣os	
ፊልጾስ	Filep̣p̣os	
ፊሽካ	Fiška	
ፊቅ	Fiq	
ፊቅጦር	Fiqṭor	
ፊታውራሪ	Fitawrari	
ፊቼ	Fiččé	
ፊች	Fičče	
ፊና	Fina	
ፊንጨአ	Finč̣ä'ä	
ፊኛ	Fiñña	
ፊደሉ	Fidälu	
ፊደል	Fidäl	
ፊዳ	Fida	
ፋሪስ	Faris	
ፋሮ	Faro	
ፋሲለደስ	Fasilädäs	
ፋሲል	Fasil	
ፋሲካ	Fasika	
ፋስ	Fas	
ፋሶሊያ	Fasoliya	
ፋሻ	Fašša	
ፋሽሽታዊ	Fašeštawi	
ፋሽሽት	Fašešt	
ፋቂ	Faqi	
ፋብሪካ	Fabrika	
ፋብሪካዎች	Fabrikawočč	
ፋታ	Fata	
ፋኑስ	Fanus	
ፋኑኤል	Fanu'él	
ፋና	Fana	
ፋናዬ	Fanayé	
ፋንቱ	Fantu	
ፋንታ	Fanta	
ፋንታ ሁን	FantaHun	
ፋንታይ	Fantay	
ፋንድያ	Fandeyya	
ፋኖ	Fanno	
ፋኖሴ	Fanosé	
ፋኖስ	Fanos	
ፋይዳ	Fayda	
ፋጉሎ	Fagullo	
ፋጡማ	Faṭuma	
ፋጢማ	Faṭima	
ፋጤ	Faṭé	
ፋፋ	Faffa	
ፌሮ	Férro	
ፌሽታ	Féšta	
ፌቆ	Féqo	
ፌንጣ	Fénṭa	
ፌጦ	Féṭo	
ፍላቴ	Felaté	
ፍላጐት	Fellagot	
ፍላጻ	Felaṣṣa	
ፍል	Fel	
ፍልሚያ	Felmiya	
ፍልሰታ	Felsäta	
ፍልስጥኤም	Felesṭe'ém	
ፍልስፍና	Felsefenna	
ፍልቅልቅ	Feleqleq	
ፍልፈል	Felfäl	
ፍልፍሉ	Felfelu	
ፍልፍሏ	Felfelʷ	
ፍሩሽካ	Feruška	
ፍሪዳ	Ferida	
ፍራሽ	Feraš	
ፍራቻ	Feračča	
ፍራፍሬ	Feraferé	
ፍሬ	Feré	
ፍሬምናጦስ	Ferémnaṭos	
ፍሬአማ	Feré'ämma	
ፍሬው	Feréw	
ፍርሃት	Ferhat	
ፍርምባ	Feremba	
ፍርንትት	Ferentet	
ፍርንዱስ	Ferendus	
ፍርኩታ	Ferkutta	
ፍርክርክ	Ferekrek	
ፍርዱ	Ferdu	
ፍርድ	Ferd	
ፍርጃ	Ferja	
ፍርፋሪ	Fereffari	
ፍስሀ	Fesseha	
ፍስሀዬ	Fessehayyé	
ፍስክ	Fessek	
ፍቅረ	Feqrä-	
ፍቅሩ	Feqru	
ፍቅሬ	Feqré	
ፍቅርተ	Feqertä	
ፍቱን	Fetun	
ፍታዬ	Fettayé	
ፍትሀ	Fethä-	
ፍትሀት	Fethät	
ፍትህ	Feth	
ፍትወት	Fetwät	
ፍትዊ	Fetewwi	
ፍትፍት	Fetfet	
ፍቼ	Feččé	
ፍች	Fečč	
ፍናጅ	Fennaj	
ፍናፍንት	Fenafent	
ፍንዳታ	Fendata	
ፍንጃል	Fenjal	
ፍንጢጣ	Fenṭiṭṭa	
ፍንጣሪ	Feneṭṭari	
ፍንጥር	Fenṭer	
ፍንጭት	Fenč̣et	
ፍንፍኔ	Fenfenné	
ፍኖተ ሰላም	Fenotä-Sälam	
ፍየል	Feyyäl	
ፍዳ	Fedda	
ፍጅት	Fejjet	
ፍጆታ	Fejjota	
ፍግ	Feg	
ፍጡር	Feṭur	
ፍጥምጥም	Feṭemṭem	
ፍጥረታት	Feṭrätat	
ፍጥረት	Feṭrät	
ፍጥነት	Feṭnät	
ፍጹም	Feṣṣum	
ፍጻሜ	Feṣṣamé	
ፍጽም	Feṣṣum	
ፎሌ	Follé	
ፎቃቃ	Foqaqa	
ፎቅ	Foq	
ፎናና	Fonana	
ፎከታም	Fokätam	
ፎኩ	Fokku	
ፎዬ	Foyyé	
ፎገራ	Fogära	
ፎጣ	Foṭa	
ፏፏቴ	Fʷfʷté	
ፏፏቴ	Fʷfʷté	
ፓስተኛ	Postäñña	
