#Amharic Name	Name Type	Alternate Spelling
ሀለቃ	Male	
ሀለፎም	Male	
ሀሊላ	Female	
ሀሊማ	Female	
ሀሊድ	Male	
ሀምለሰት	Female	
ሀልዮ	Male	
ሀመልማል	Female	
ሀመረ	Female	
ሀሙሲት	Place	
ሀሙስ	Other	
ሀሙድ	Male	
ሀሚድ	Male	
ሀማሴን	Place	ሐማሴን
ሀሜት	Other	
ሀምሌ	Other	ሐምሌ
ሀምሌው	Other	
ሀምራዊ	Other	
ሀምስ	Other	
ሀምዛ	Male	
ሀረር	Place	ሐረር
ሀረገ	Female	ሐረግ
ሀረጉ	Male	ሐረጉ
ሀረግ	Female	ሐረግ
ሀረግ ሬሳ	Other	ሐረግ ሬሳ
ሀረጐት	Female	
ሀረጓ	Female	ሐረጓ
ሀሩር	Other	ሐሩር
ሀራ	Male	ሐራ
ሀራማት	Other	
ሀራዋጫ	Other	
ሀራጅ	Other	
ሀር	Other	ሐር
ሀርቤ	Other	
ሀሰተኛ	Other	
ሀሰት	Other	
ሀሰን	Male	
ሀሰነት	Female	
ሀሳሳውያን	Unknown	
ሀሳባዊ	Other	
ሀሳባዊነት	Other	
ሀሳባውያን	Other	
ሀሳብ	Other	
ሀሳዊ	Other	
ሀሴት	Other	
ሀሺም	Male	
ሀቀኛ	Other	
ሀቂቃ	Don't Know	
ሀቅ	Other	
ሀበሻ	Male	
ሀቢብ	Male	ሐቢብ
ሀብለ	Don't Know	ሐብለ
ሀብለወርቅ	Female	
ሀብል	Other	
ሀብተ	Male	
ሀብተመስቀል	Male	
ሀብተሚካኤል	Male	
ሀብተማርያም	Male	
ሀብተጊዮርጊስ	Male	
ሀብተስላሴ	Male	
ሀብተአብ	Male	
ሀብተእዝጊ	Male	
ሀብተወልድ	Male	
ሀብተየሱስ	Male	
ሀብተዮሐንስ	Male	
ሀብተገብርኤል	Male	
ሀብተጽዮን	Male	
ሀብተየስ	Male	
ሀብቱ	Male	
ሀብታሙ	Male	
ሀብታም	Other	
ሀብታሟ	Female	
ሀብታይ	Don't Know	
ሀብቴ	Male	
ሀብት	Other	
ሀብትዬ	Male	
ሀብትህ	Male	
ሀብቶም	Male	
ሀቱን	Male	
ሀቲታ	Don't Know	
ሀቲታዊ	Don't Know	
ሀቲት	Don't Know	
ሀች	Don't Know	
ሀነዴ	Female	
ሀኒማ	Female	
ሀኒፋ	Female	
ሀና	Female	
ሀንሱ	Female	
ሀኪም	Male	
ሀኪተኛ	Don't Know	
ሀኬተኛ	Unknown	
ሀኬት	Don't Know	
ሀዋ	Female	
ሀዋላ	Other	
ሀዋሪያ	Male	ሐዋሪያ
ሀዋሪያት	Male	ሐዋሪያት
ሀዋርያ	Unknown	ሐዋርያ
ሀዋርያት	Unknown	ሐዋርያት
ሀዋዝ	Male	ሐዋዝ
ሀውልት	Other	
ሀይሎም	Male	ሐይሎም
ሀይመቴ	Male	
ሀይረዲን	Male	
ሀይቅ	Other	
ሀይኮታ	Don't Know	
ሀይዞ	Othe	
ሀይደር	Male	
ሀደራ	Male	
ሀደሮ	Don't Know	
ሀዲስ	Male	ሐዲስ
ሀዲድ	Place	
ሀዳር	Other	
ሀዳስ	Female	
ሀድያ	Other	
ሀድጉ	Male	
ሀድጐ	Male	
ሀዱጀ	Male	
ሀዲ	Male	
ሀዲሽ	Male	
ሀድራ	Male	
ሀድጊ	Male	
ሀድጋይ	Male	
ሀጀራ	Male	
ሀጂ	Male	
ሀገረ	Female	
ሀገረሕይወት	Both	
ሀገረሰላም	Both	
ሀገሪቱ	Female	
ሀገራይ	Male	
ሀገሬ	Both	
ሀገሬነሽ	Female	
ሀገር	Other	
ሀገርነሽ	Female	
ሀገርሽ	Female	
ሀጋይ	Don't Know	
ሀጉሽ	Male	
ሀጐሳ	Female	ሐጐሳ
ሀጐስ	Male	ሐጐስ
ሀፍቱ	Male	
ሀጢአተኛ	Other	
ሀጢአት	Other	
ሀጥአን	Other	
ሁለላ	Unknown	
ሁለመና	Other	
ሁለመናዬ	Female	
ሁለተኛ	Other	
ሁለት	Other	
ሁለንተና	Other	
ሁለንተኛ	Other	
ሁሉ አገርሽ	Female	
ሁሉሰው	Male	
ሁሉቃ	Other	
ሁላላ	Other	
ሁመራ	Other	
ሁምና	Other	
ሁረታ	Don't Know	
ሁሩሙ	Don't Know	
ሁሩታ	Othe	
ሁሪሳ	Other	
ሁር	Don't Know	
ሁስንያ	Female	
ሁሴን	Male	
ሁነኛ	Male	
ሁነኛው	Male	
ሁኒማት	Unknown	
ሁኔማት	Don't Know	
ሁኔታ	Other	
ሁኔታዎች	Other	
ሁንዴ	Male	
ሁከት	Other	
ሁክት	Other	
ሁዳ	Female	
ሁዳዴ	Other	
ሁዳድ	Female	
ሂሩተስላሴ	Female	
ሂሩት	Female	
ሂሪቲ	Female	
ሂርና	Other	
ሂርጳ	Male	
ሂርጳሳ	Male	
ሂርጶ	Male	
ሂስ	Other	
ሂቡ	Other	
ሂደት	Other	
ሃሊ	Other	
ሃሌ	Other	
ሃሌ ሉያ	Other	
ሃምሳ	Other	
ሃሳባዊ	Other	
ሃና	Female	
ሃያ	Other	
ሃያት	Female	
ሃያላን	Other	
ሃይለ	Male	ሐይለ
ሃይለኛ	Other	
ሃይሉ	Male	
ሃይላኛ	Other	
ሃይሌ	Male	
ሃይል	Other	
ሃይሎም	Male	ሐይሎም
ሃይመቴ	Other	
ሃይማኖተ	Other	
ሃይማኖት	Both	
ሃይረዲን	Male	
ሃይደር	Male	
ሄለና	Female	
ሄለን	Female	
ሄሪያ	Female	
ሄርጌይ	Other	
ሄርሜላ	Female	
ሄኖክ	Female	
ሄዋን	Female	
ህሊና	Both	
ህሊናዊ	Other	
ህሊናውያን	Other	
ህላዊ	Male	
ህላዌ	Male	
ህልሽት	Don't Know	
ህልውና	Other	
ህማማት	Other	
ህሩይ	Male	
ህርጊጐ	Other	
ህቡእ	Other	
ህብረ	Other	
ህብረወርቅ	Female	
ህብረተ ሰብ	Government	ሕብረተ ሰብ
ህብረተ ሰብአዊ	Government	ሕብረተ ሰብአዊ
ህብረተ ሰብአዊት	Government	ሕብረተ ሰብአዊት
ህብረተ ሰብአዊንት	Government	ሕብረተ ሰብአዊንት
ህብረተ ስብአዊነት	Government	ሕብረተ ስብአዊነት
ህብረት	Other	ሕብረት
ህብስተ	Other	
ህብስተመና	Male	
ህብሰቱ	Male	
ህብስቴ	Both	
ህብስት	Both	
ህትመት	Other	
ህንደኬ	Other	
ህንጻ	Other	
ህክምና	Other	
ህዋ	Other	
ህዋሳታዊ	Other	
ህዋሳት	Other	
ህዋስ	Other	
ህዝቅኤል	Male	
ህዝቅያስ	Male	
ህዝባዊ	Other	
ህዝባዊት	Other	
ህዝብ	Other	
ህያብ	Female	
ህይወት	Both	ሕይወት
ህደጐ	Male	
ህዳር	Other	
ህዳግ	Other	
ህዳት	Male	
ህዳጐ	Unknown	
ህድረት	Other	
ህድአት	Other	
ህገ	Government	
ህጋዊ	Government	
ህግ	Government	ሕግ
ህግጋት	Other	
ህጸጽ	Other	
ህጻናት	Other	
ህጻን	Other	
ህጻጽ	Unknown	
ሆሄ	Other	
ሆሄያት	Other	
ሆለታ	Other	
ሆምጣጤ	Other	
ሆራ	Other	
ሆሳ	Other	
ሆሳእና	Both	
ሆቴሌች	Other	
ሆቴሎች	Unknown	
ሆይ	Other	
ሆይናስኪ	Other	
ሆነልኝ	Male	
ሆደ ባሻ	Unknown	
ሆጃ	Other	
ሆጄሌ	Other	
ሆጤ	Other	
ለሀጭ	Other	
ለሆሳስ	Other	
ለሆቴ	Other	
ለሊሳ	Female	
ለማ	Male	
ለማሽ	Female	
ለማኝ	Other	
ለሜሳ	Male	
ለሜቻ	Male	
ለምለም	Female	
ለምባዳ	Other	
ለምድ	Other	
ለምጻም	Other	
ለምጽ	Other	
ለሳኝ	Other	
ለሴ	Other	
ለስላሳ	Other	
ለቀማ	Other	
ለቅሶ	Other	
ለበስ	Other	
ለበቅ	Other	
ለባሲ	Other	
ለባዊት	Other	
ለቤ	Other	
ለብላቢ	Other	
ለተ	Both	
ለተሃይማኖት	Both	
ለተመስቀል	Both	
ለተብርሃን	Both	
ለተሩፋኤል	Both	
ለተሥላሴ	Both	
ለተሚካኤል	Both	
ለተንሳይ	Male	
ለተንጉሥ	Male	
ለተአምላክ	Male	
ለተአብ	Male	
ለተኪዳን	Both	
ለተዝጊ	Male	
ለተየሱስ	Male	
ለተዮሐንስ	Male	
ለተድንግል	Female	
ለተገብርኤል	Male	
ለቱ	Don't Know	
ለታ	Male	
ለታይ	Female	
ለንቋጣ	Other	
ለንጨጭ	Other	
ለአብ	Male	
ለአለም	Both	
ለከት	Other	
ለወግነሽ	Female	
ለውዘገነት	Female	
ለውጤ	Other	
ለዘብተኛ	Other	
ለዛ	Other	
ለዝና	Both	
ለየህ	Male	
ለይላ	Female	
ለይስሙላ	Other	
ለይኩን	Male	
ለገሠ	Male	
ለገሰ	Male	
ለገሰች	Female	
ለገደች	Don't Know	
ለጊ	Other	
ለጋ	Other	
ለጋስ	Other	
ለግላጋ	Other	
ለጥ ይበሉ	Male	
ለፍቶ አደር	Other	
ለፍቶ አዳሪ	Other	
ለፍዳዳ	Other	
ሉሉ	Female	
ሉሊተ	Female	
ሉሊቱ	Don't Know	
ሉሊት	Female	
ሉላ	Female	
ሉላአበባ	Female	
ሉላደይ	Female	
ሉላዳይ	Don't Know	
ሉሌ	Male	
ሉል	Male	
ሉልእሸት	Male	
ሉልሰገድ	Male	
ሉባባ	Female	
ሉቃስ	Male	
ሉቦ	Place	
ሉንዳል	Don't Know	
ሉቺያ	Female	
ሊሻነወርቅ	Female	
ሉካንዳ	Other	
ሉክ	Other	
ሉጫ	Other	
ሊሙ	Other	
ሊማሊሞ	Place	
ሊስትሮ	Other	
ሊሻን	Female	
ሊቀ	Male	
ሊቁ	Male	
ሊቃውንት	Male	
ሊቅ	Male	
ሊበን	Male	
ሊባቦ	Other	
ሊያ	Female	
ሊዲያ	Female	
ሊጋባ	Male	
ላሁጫ	Don't Know	
ላሊበላ	Place	
ላል ይበላ	Unknown	
ላሎ	Don't Know	
ላመስግን	Male	
ላሚሶ	Male	
ላሜዳ	Other	
ላም	Other	
ላም እነት	Unknown	
ላምሮት	Both	
ላምባ	Other	
ላምባ ዲና	Unknown	
ላምፋ	Don't Know	
ላስቲክ	Other	
ላቀ	Male	
ላቀህ	Male	
ላቀች	Female	
ላቀዉ	Male	
ላቀው	Male	
ላብ አደር	Other	
ላንቲካ	Other	
ላንጋኖ	Other	
ላንፊያ	Don't Know	
ላእላይ	Other	ላዕላይ
ላእከ	Male	ላዕከ
ላእከማርያም	Male	ላዕከማርያም
ላእከሥላሴ	Male	ላዕከሥላሴ
ላእከፅዮን	Male	ላዕከፅዮን
ላኪ	Other	
ላካቸው	Male	
ላዛ	Other	
ላይኔ	Male	
ላይዳ	Other	
ላዳን	Other	
ላጲሶ	Male	
ላፒሶ	Unknown	
ሌማት	Other	
ሌባ	Other	
ሌንጫ	Other	
ሌንጮ	Male	
ሌዊ	Other	
ሌዋውያን	Other	
ሌጣ	Other	
ሌጦ	Other	
ልመነው	Male	
ልመንህ	Male	
ልሙጥ	Other	
ልማት	Other	
ልማድ	Other	
ልምጭ	Other	
ልሳነ	Male	
ልሳነወርቅ	Male	
ልሳኑ	Male	
ልሳን	Male	
ልሻን	Female	
ልቃሚ	Other	
ልቃቂት	Other	
ልቅ	Other	
ልበ	Other	
ልቡና	Other	
ልቡናዊ	Other	
ልባርጋቸው	Male	
ልባስ	Other	
ልባብ	Other	
ልባንጃ	Other	
ልባዊ	Other	
ልቤ	Other	
ልብሰ ተክህኖ	Other	
ልብስ ሰፊ	Other	
ልብነ ድንግል	Other	
ልት	Unknown	
ልትት	Unknown	
ልኡል	Male	ልዑል
ልኡካን	Other	ልዑካን
ልእልት	Female	ልዕልት
ልእልና	Other	ልዕልና
ልኬ	Female	
ልክ የለሽ	Female	ልኬለሽ
ልኮንክ	Male	
ልኳንዳ	Other	
ልዋጭ	Other	
ልውውጥ	Other	
ልዑል	Male	
ልዑለሥላሴ	Male	
ልዑልሰገድ	Male	
ልዑልወርቅ	Female	
ልዕልት	Female	
ልዝብ	Other	
ልየው	Male	
ልዩ	Female	
ልዩወርቅ	Both	
ልይህ	Male	
ልይሽ	Female	
ልደቱ	Male	
ልደታ	Other	
ልደት	Both	
ልጃም	Don't Know	
ልጃገረድ	Other	
ልጅ	Other	
ልጅቱ	Other	
ልጅነት	Other	
ልጆች	Other	
ልገሳ	Other	
ልግመኛ	Other	
ልጓም	Other	
ልጣጭ	Other	
ልጨኛ	Unknown	
ልፈፋ	Other	
ልፊያ	Other	
ልፋት	Other	
ልፍስፍስ	Other	
ልፍቶ አደር	Other	
ሎሌ	Male	
ሎቲ	Other	
ሎጊያ	Unknown	
ሎዛ	Female	
ሎሚናት	Female	
ሎሚ	Female	
ልጅአለም	Male	
ሐሌሉያ	Female	
ሐማሴን	Other	
ሐረገ	Both	
ሐረገወይን	Female	
ሐረግነሽ	Female	
ሐረጎት	Male	
ሐራ	Male	
ሐቢብ	Male	
ሐብለ	Other	
ሐና	Female	
ሐኔ	Female	
ሐዋ	Female	
ሐዋርያት	Male	
ሐዋዝ	Male	
ሐይለ	Male	
ሐይሎም	Male	
ሐዲስ	Male	
ሐጁ	Male	
ሐጐስ	Male	
ሐፍዝ	Don't Know	
ሕሩይ	Male	
ሕይወት	Both	
ሕይወትነሽ	Female	
ሕግ	Other	
ሕዝቅያስ	Male	
መሀለቅ	Other	
መሀሉ	Other	
መሀላ	Other	
መሀል	Other	
መሀል ሜዳ	Place	
መሀል ሰፋሪ	Other	
መሀመድ	Male	
መሀሙዲ	Male	
መሀሙዴ	Male	
መሀረኝ	Other	
መሀሪ	Male	መሐሪ
መሀንዲስ	Other	
መሀከለኛ	Other	
መሀከል	Other	
መሃባው	Male	
መሃቤ	Male	
መሃዲ	Male	
መሃይም	Other	
መሄኦ	Other	
መህረተ አብ	Male	
መህቡባ	Male	
መህዲ	Male	
መህዲያ	Male	
መህን	Unknown	
መሆዶ	Don't Know	
መለሎ	Other	
መለሰ	Male	
መለሰች	Female	
መለሱ	Other	
መለስ	Male	
መለስልኝ	Other	
መለስተኛ	Other	
መለከት	Other	
መለኪያ	Other	
መለኮታዊ	Other	
መለኮታዊነት	Other	
መለኮታውያን	Other	
መለኮት	Male	
መለዋወጫ	Other	
መለያ	Other	
መለዮ	Other	
መሊካ	Female	
መላ ምት	Other	
መላሂ	Other	
መላላጫ	Other	
መላሰኛ	Other	
መላተ ወርቅ	Female	
መላእክት	Both	
መላከ	Male	
መላከሕይወት	Male	
መላከሰላም	Male	
መላከስብከት	Male	
መላኩ	Male	
መላክ ሰገድ	Male	
መላክ ነሽ	Female	
መላጊያ	Other	
መላጣ	Other	
መሌአኩ	Male	
መልህቅ	Other	
መልሰው	Male	
መልሳቸው	Male	
መልአከ	Male	
መልአኩ	Male	
መልአክ	Male	
መልእል	Other	
መልእክተኛ	Other	
መልእክተኞችና	Other	
መልእክት	Both	
መልከ	Male	
መልከማርያም	Both	
መልከ ጼዴቅ	Male	
መልከኛ	Other	
መልከአ ምድር	Other	
መልኪቱ	Female	
መልካ	Male	
መልካ ቦሎ	Place	
መልካሙ	Male	
መልካሜ	Both	
መልካም	Both	
መልካም ነሽ	Female	
መልካሟ	Female	
መልካረፉ	Other	
መልካሰዲ	Place	
መልካሳ	Place	
መልካየሁ	Both	
መልኬ	Both	
መልኬነሽ	Female	
መልክ	Both	
መልክአ ምድር	Other	
መሎቲ	Other	
መሐመድ	Male	
መሐመድሰይድ	Male	
መሐመድባኒ	Male	
መሐመድኑር	Male	
መሐመድአሚን	Male	
መሐመድአወል	Male	
መሐመድአጣ	Male	
መሐመዲን	Male	
መሐሪ	Male	
መሕዲ	Male	
መመህራን	Other	
መመሪያ	Other	
መመኪያ	Other	
መመዘኛ	Other	
መመዝገቢያ	Other	
መመደቢያ	Other	
መማክርት	Other	
መምህራን	Other	
መምህር	Other	
መምሪያ	Other	
መምቻ	Other	
መሠረታዊ	Other	
መሠረት	Both	
መሥሪያ	Company	
መሥቀል	Other	
መረሬ	Other	
መረርቱ	Other	
መረሰ	Male	
መረሳ	Male	
መረተ	Male	
መረተወርቅ	Female	
መረጠች	Female	
መረቅ	Other	
መረባ	Other	
መረብ	Other	
መረን	Other	
መረዋ	Other	
መረጃ	Other	
መረግድ	Don't Know	
መሪ	Other	
መሪሃ	Male	
መሪም	Female	
መሪኮከብ	Female	
መራኒ	Male	
መሪዎች	Other	
መራ	Other	
መራሄ	Male	
መራራ	Male	
መራቤቴ	Place	
መራዊ	Male	
መራው	Male	
መራጃ	Other	
መሬት	Other	
መሬማ	Female	
መርሃ	Male	መርሐ
መርሐንከብ	Male	
መርሃፅዮን	Male	
መርህ	Other	
መርሆ	Other	
መርሐ	Male	
መርሞሌ	Don't Know	
መርሲ	Other	
መርሳ	Male	
መርሴ	Unknown	
መርስኤ	Male	መርስዔ
መርስዔ	Male	
መርሶ	Other	
መርሻ	Male	
መርሽ	Don't Know	
መርቆሬዎስ	Male	
መርቆርዮስ	Male	
መርኔ	Don't Know	
መርአዊ	Male	መርዓዊ
መርእድ	Male	መርዕድ
መርከበኛ	Other	
መርከብ	Other	
መርከቦች	Other	
መርዘኛ	Other	
መርዝ	Other	
መርዳሳ	Other	
መርዶ	Other	
መርዶፋ	Other	
መርገጫ	Don't Know	
መርገፍ	Other	
መርጊያ	Male	
መርጋ	Male	
መርግ	Other	
መርጡለ	Unknown	
መርጡለ ማርያም	Place	
መርፌ	Other	
መሮ	Other	
መሰለ	Male	
መሰለች	Female	
መሰሉ	Female	
መሰላል	Other	
መሰል	Other	
መሰረተ	Other	መሠረተ
መሰረታዊ	Other	መሠረታዊ
መሰረት	Both	መሠረት
መሰሪ	Other	
መሰርሰሪያ	Other	
መሰቅሰቂያ	Other	
መሰብሰቢያ	Other	
መሰናክል	Other	
መሰናዶ	Other	
መሰንቆ	Other	
መሰዊያ	Other	
መሱድ	Other	
መሲህ	Male	
መሳሪያ	Other	መሥሪያ
መሳይ	Male	
መሳደኛ	Other	
መሳፍቻ	Other	
መሳፍንታዊ	Other	
መሳፍንት	Male	
መስል	Other	
መስመር	Other	
መስሪ	Other	መሥሪያ
መስሪያ	Other	መሥሪያ
መስራች	Other	
መስቀሉ	Male	
መስቀሌ	Male	መስቀል
መስቀል	Other	
መስቀያ	Other	
መስቃ	Other	
መስተንግዶ	Other	
መስታወት	Both	
መስተዋት	Both	
መስተዋድድ	Other	
መስተጻምር	Other	
መስኖ	Other	
መስከረም	Both	
መስክ	Other	
መስዋእት	Both	መስዋዕት
መስጊድ	Other	
መስፈሪያ	Other	
መስፊያ	Unknown	
መስፍነ	Male	
መስፍን	Male	
መስፍያ	Other	
መስኡድ	Male	መስዑድ
መሶበ	Other	
መሶበወርቅ	Female	
መሶብ	Other	
መሸሻ	Male	
መሸተኛ	Other	
መሸታ	Other	
መሸጋገሪያ	Other	
መሽከርከሪያ	Other	
መሿለኪያ	Other	
መቀሌ	Place	
መቀመቅ	Other	
መቀመጫ	Other	
መቀራቅርት	Don't Know	
መቀበያ	Other	
መቀናጆ	Other	
መቀንጠቢያ	Other	
መቀጣጫ	Other	
መቀጫ	Other	
መቁረርት	Other	
መቁረጫ	Other	
መቁነን	Other	
መቁጠሪያ	Other	
መቂ	Place	
መቂናት	Unknown	
መቂናጥ	Don't Know	
መቃ	Other	
መቃ ልቅም	Other	
መቃርዮስ	Other	
መቃብር	Other	
መቃን	Other	
መቃጥን	Other	
መቅመቆ	Other	
መቅረዝ	Other	
መቅረጅ	Don't Know	
መቅሰፍት	Other	
መቅን	Other	
መቅዘፊያ	Other	
መቅደሰ	Both	
መቅደሴ	Both	
መቅደስ	Both	
መቅድም	Both	
መቆሚያ	Female	
መቆሚያ   	Other	
መቆስቆሻ	Other	
መቆናቁን	Other	
መቆንጠጫ	Other	
መቆያ	Female	
መቆጣጠሪያ	Other	
መቆፈሪያ	Other	
መቋቋሚያ	Other	
መቋደሻ	Other	
መበለት	Other	
መባለግ	Other	
መባቻ	Other	
መብረቅ	Other	
መብራህቱ	Male	
መብራቱ	Male	
መብራቴ	Both	
መብራት	Both	
መብርሃቱ	Male	
መብት	Other	
መብኣ	Male	መብዓ
መብኣሥላሴ	Male	መብዓሥላሴ
መብኣየሱስ	Male	መብዓየሱስ
መተኪያ	Male	
መተኪያሽ	Female	
መታደል	Both	
መቻሌ	Male	
መተሀራ	Place	
መተላለፊያ	Other	
መተመኛ	Other	
መተማመኛ	Other	
መተርኮሻ	Other	
መተተኛ	Other	
መተት	Other	
መተከል	Place	
መተያያ	Other	
መተዳደሪያ	Other	
መቱ	Place	
መታረሪያ	Other	
መታሰቢያ	Both	
መታጠቢያ	Other	
መታጠፊያ	Other	
መታፈሪያ	Male	
መት	Other	
መትረየስ	Other	
መቶ	Other	
መቸንከሪያ	Other	
መቻል	Male	
መቻራ	Don't Know	
መቻሬ	Other	
መነሻ	Other	
መነሾ	Other	
መነን	Female	
መነንወርቅ	Female	
መነኩሴ	Other	
መነኮሳት	Other	
መነጋገሪያ	Other	
መነጽር	Other	
መኑር	Male	
መና	Both	
መናብ	Other	
መናገሻ	Place	
መናፈሻ	Other	
መናፍስት	Other	
መናፍቅ	Other	
መን	Don't Know	
መንሱር	Other	
መንሽ	Other	
መንቀል	Other	
መንቀሳቀሻ	Other	
መንበረ	Both	
መንበረወርቅ	Both	
መንበረፀሐይ	Both	
መንበሩ	Male	
መንበር	Other	
መንበርነሽ	Female	
መንታ	Other	
መንትያ	Other	
መንአመኖ	Male	
መንእስ	Other	
መንክር	Male	
መንክሮስ	Don't Know	
መንኮራኩር	Other	
መንደረተኛ	Other	
መንደረታኛ	Other	
መንደረኛ	Other	
መንደሪን	Other	
መንደር	Other	
መንደርደሪያ	Other	
መንደሮች	Other	
መንደፈራ	Place	
መንዲ	Other	
መንዲል	Other	
መንዲስ	Other	
መንዲዳ	Place	
መንገሻ	Male	
መንገደኛ	Other	
መንገድ	Other	
መንጋ	Other	
መንጋጋ	Other	
መንግሥተ	Male	
መንግሥተአብ	Male	
መንግሥተአለም	Both	
መንግሥቱ	Male	
መንግሥት	Government	
መንግስተ	Male	መንግሥተ
መንግስቱ	Male	መንግሥቱ
መንግስታት	Government	መንግሥታት
መንግስታዊ	Government	መንግሥታዊ
መንግስቴ	Male	መንግሥቴ
መንግስት	Company	መንግሥተ
መንጐል	Other	
መንጠቆ	Other	
መንጦላእት	Other	
መንፈሳዊ	Other	
መንፈስ	Other	
መንፈቅ	Other	
መንፈያ	Other	
መንፊያ	Other	
መኖ	Other	
መኖሪያ	Other	
መአሾ	Male	
መኣተኛ	Other	መዓተኛ
መኣት	Other	መዓት
መኣዊ	Other	መዓዊ
መኣዛ	Both	መዓዛ
መኣዛሽ	Female	መዓዛሽ
መከላከያ	Government	
መከር	Other	
መከረች	Female	
መከታ	Male	
መከተ	Male	
መከት	Unknown	
መከኮታዊነት	Unknown	
መከዳ	Other	
መኩሪያ	Male	
መኪያ	Female	
መካ	Male	
መካለያ	Both	
መካሻ	Male	
መካነ	Other	
መካከለኛ	Other	
መካከል	Other	
መክሊት	Female	
መክረጅ	Don't Know	
መክሰስ	Other	
መክብብ	Male	
መክት	Other	
መክቴ	Male	
መክፈቻ	Other	
መክፈያ	Other	
መኮንን	Male	መኰንን
መኮንኖች	Government	
መኰንን	Male	
መኳስ	Other	
መኳንንታዊ	Other	
መኳንንት	Male	
መኸር	Male	
መወርወሪያ	Other	
መወጠሪያ	Other	
መዋስእት	Both	
መዋቅር	Other	
መዋእለ	Other	መዋዕል
መዋዕል	Other	
መዋጥ	Other	
መዋጮ	Other	
መውለጃ	Other	
መውሊድ	Other	
መውደድ	Both	
መውረጃ	Other	
መውዜር	Other	
መውጪያ	Other	
መዓዛ	Both	መአዛ
መዓዛሽ	Female	
መዓዛገነት	Female	
መዘምር	Male	
መዘራዘር	Other	
መዘንግእ	Other	
መዘክር	Other	
መዘውር	Other	
መዘዞ	Place	
መዛግብት	Other	
መዝለቂያ	Female	
መዝሙረ	Both	
መዝሙር	Male	
መዝራእተ	Other	
መዝናኛ	Other	
መዝገበ	Male	
መዝገቡ	Male	
መዝገብ	Male	
መዝገቦች	Other	
መዝጊያ	Other	
መዥገር	Other	
መይሙና	Female	
መይረማ	Don't Know	
መደለያ	Other	
መደምደሚያ	Both	
መደረቢያ	Other	
መደርደሪያ	Other	
መደበኛ	Other	
መደብ	Other	
መደብል	Other	
መደብር	Other	
መደዳ	Other	
መደጐሚያ	Other	
መዲና	Both	
መዳቢ	Other	
መዳብ	Other	
መዳፍ	Other	
መድሃኒ ዓለም 	Male	መድሐኒዓለም
መድሃኒት	Both	
መድሃኔ	Male	
መድህኔ	Male	
መድህን	Male	
መድልወ	Don't Know	
መድሐኒአለም	Male	መድሐኒዓለም
መድምም	Other	
መድረክ	Other	
መድበል	Other	
መድኃኒዓለም	Male	
መድኅን	Male	
መድነቅ	Male	
መድን	Male	
መድፈሪያሽ	Female	
መድፈሪያሽወርቅ	Female	
መድፈኛ	Other	
መድፋኛ	Other	
መድፍ	Other	
መዶሻ	Other	
መጀመሪያ	Unknown	
መጅ	Don't Know	
መጅሊስ	Other	
መጅመሪያ	Other	
መገለገያ	Other	
መገል	Other	
መገልገያ	Other	
መገርሳ	Male	
መገሮ	Other	
መገናኛ	Other	
መገንታ	Male	
መገዘዝ	Other	
መገድገጃ	Other	
መጋላ	Other	
መጋል	Other	
መጋረጃ	Other	
መጋቢ	Other	
መጋቢት	Other	
መጋኛ	Other	
መጋዞ	Other	
መግለጫ	Other	
መግል	Other	
መግቢያ	Other	
መግደላዊት	Female	
መጐናጸፊያ	Other	
መጓጓዝ	Other	
መጓጓዣ	Other	
መጠሪያ	Other	
መጠቅለያ	Other	
መጠን	Other	
መጠየቂያ	Other	
መጠየቅ	Other	
መጠይቅ	Other	
መጠጊያ	Other	
መጠጥ	Other	
መጡንጉሥ	Male	
መጢቃ	Other	
መጣምር	Other	
መጣጣ	Other	
መጣፈጥ	Other	
መጤ	Other	
መጥምቁ	Male	
መጥረቢያ	Other	
መጥረጊያ	Other	
መጥሪያ	Other	
መጥቅእ	Other	
መጨኔ	Other	
መጨጊያ	Other	
መጨጊያሽ	Female	
መጫሚያ	Other	
መጫኛ	Other	
መጫጫት	Other	
መጭ	Other	
መጸዳጃ	Other	
መጻህፍት	Other	መጽሕፍት
መጻሕፍት	Other	
መጻጉእ	Other	
መጽሀፈ	Male	መጽሐፍ
መጽሀፍ	Other	መጽሐፍ
መጽሄት	Both	መጽሔት
መጽሐፍ	Other	
መጽሕፍት	Other	
መፈልፈያ	Other	
መፈንቀለ	Other	
መፈንቅለ	Other	
መፈክር	Other	
መፋቀር	Male	
መፋቂያ	Other	
መፍቱህ	Male	
መፍትሄ	Both	
መፍቻ	Other	
ሙሃባ	Male	
ሙሄ	Male	
ሙህ የዲን	Male	
ሙህየዲን	Male	
ሙህሲን	Male	
ሙለታ	Male	
ሙሉ	Both	
ሙሉእመቤት	Female	
ሙሉመንዜ	Both	
ሙሉምራጭ	Both	
ሙሉሰው	Male	
ሙሉሸዋ	Both	
ሙሉቀን	Both	
ሙሉብርሃን	Both	
ሙሉወርቅ	Female	
ሙሉአዳም	Male	
ሙሉዓለም	Both	
ሙሉሕይወት	Both	
ሙሉዬ	Both	
ሙሉጎጃም	Both	
ሙሉጥላ	Both	
ሙሉፀሐይ	Both	
ሙላለት	Male	
ሙላተወርቅ	Female	
ሙረዲን	Male	
ሙረዳ	Male	
ሙሉ ነህ	Male	
ሙሉ ነሽ	Female	
ሙሉነሽ	Female	
ሙሉጌታ	Male	
ሙላቱ	Male	
ሙላት	Both	
ሙላቷ	Female	
ሙላጭ	Other	
ሙልሙል	Other	
ሙሐመድ	Male	
ሙሐሙድ	Male	
ሙሜ	Don't Know	
ሙሪ	Other	
ሙራድ	Male	
ሙሬ	Other	
ሙሰንባይ	Other	
ሙሰይድ	Male	
ሙሳ	Male	
ሙሴ	Male	
ሙሴላ	Don't Know	
ሙስሊህ	Don't Know	
ሙስላህ	Male	
ሙስባሀ	Male	
ሙስና	Other	
ሙስጠፋ	Male	
ሙሻዘር	Don't Know	
ሙሽራ	Other	
ሙሾ	Other	
ሙቃ	Don't Know	
ሙቅቢል	Male	
ሙባረክ	Male	
ሙታን	Other	
ሙታንታ	Other	
ሙኒራ	Female	
ሙኒር	Male	
ሙአዝ	Male	መዓዝ
ሙከራ	Other	
ሙካሽ	Male	
ሙካሽ 	Unknown	
ሙክታር	Male	
ሙክት	Other	
ሙዘይን	Male	
ሙዚቀኛ	Other	
ሙዚቃ	Other	
ሙዜ	Both	
ሙያ	Other	
ሙያተኛ	Other	
ሙያተኛች	Unknown	
ሙያተኞች	Other	
ሙደና	Don't Know	
ሙዳ	Other	
ሙዳይ	Other	
ሙግት	Other	
ሙጥሃር	Male	
ሙጥልቅ	Other	
ሙጫ	Other	
ሙጭጭላ	Other	
ሙጻአሮን	Male	
ሙፍታህ	Male	
ሚሊዮን	Both	
ሚሊያርድ	Male	
ሚሌና	Female	
ሚልባህ	Don't Know	
ሚልኪያስ	Unknown	
ሚልክያስ	Male	
ሚሚ	Female	
ሚራህ	Don't Know	
ሚኒስቴር	Other	
ሚኒስቴር።	Other	
ሚኒቴር	Other	
ሚና	Other	
ሚናስ	Male	
ሚኤሶ	Other	
ሚኪያስ	Male	
ሚካኤል	Male	
ሚዛን	Both	
ሚዛነወርቅ	Female	
ሚደቅሳ	Male	
ሚደቅሶ	Male	
ሚፍታህ	Male	
ሚዜ	Other	
ሚያዚያ	Other	
ሚዳቆ	Other	
ሚጣቅ	Other	
ሚጥሚጣ	Other	
ማህሌት	Both	
ማህሙድ	Male	
ማህር	Other	
ማህበረ	Other	ማኅበረ
ማህበራዊ	Other	ማኅበራዊ
ማህበር	Other	
ማህብር	Other	ማኅበር
ማህተመ	Male	
ማህተም	Other	
ማህቶት	Other	
ማህደረ	Both	
ማህደሩ	Male	
ማህደር	Both	
ማህዲ	Don't Know	መሕዲ
ማህጸን	Other	
ማህጸንተ	Female	
ማህፉዝ	Male	
ማለስለሻ	Other	
ማለደ	Other	
ማለዱ	Other	
ማለዳ	Both	
ማለፊያ	Both	
ማላሽ	Other	
ማላጭ	Other	
ማልመላ	Other	
ማልሚያ	Other	
ማሎ	Male	
ማሕበር	Other	
ማመላለሻ	Other	
ማመልከቻ	Other	
ማመልካቻ	Other	
ማመንጫ	Other	
ማመጫ	Male	
ማሙሸት	Male	
ማሙዬ	Male	
ማሚቱ	Female	
ማሚቴ	Female	
ማሚት	Female	
ማሚቶ	Female	
ማማ	Other	
ማሜ	Female	
ማምረቻ	Other	
ማሞ	Male	
ማሞካሸት	Other	
ማረሚያ	Other	
ማረሻ	Other	
ማረቆ	Male	
ማረፊያ	Male	
ማረከኝ	Male	
ማረፊያነሽ	Female	
ማሩ	Male	
ማሪታ	Don't Know	
ማራገፊያ	Other	
ማሬ	Both	
ማርሸት	Male	
ማርትሬዛ	Female	
ማርልኝ	Male	
ማርቆስ	Male	
ማርቲን	Male	foreign name
ማርታ	Female	
ማርከሻ	Other	
ማርኪያ	Other	
ማርያ	Female	
ማርያማዊት	Female	
ማርያም	Female	
ማርያ	Female	
ማርዳ	Other	
ማርገጃ	Other	
ማሰልጠኛ	Other	
ማሰማሪያ	Other	
ማሳመን	Other	
ማሳተሚያ	Other	
ማሳደሪያ	Other	
ማስመሪያ	Other	
ማስረሻ	Male	
ማስረጃ	Other	
ማስተዋል	Male	
ማስተላለፊያ	Other	
ማስተማሪያ	Other	
ማስተማር	Other	
ማስተባበሪያ	Other	
ማስተናገጃ	Other	
ማስተዋወቅ	Other	
ማስተዳደሪያ	Other	
ማስተዳደር	Other	
ማስታወሻ	Other	
ማስታወቂያ	Other	
ማስጠንቀቂያ	Other	
ማስፈር	Other	
ማሻሻያ	Other	
ማሽላ	Other	
ማሽንክ	Other	
ማቀዝቀዣ	Other	
ማቅ	Other	
ማቋቋሚያ	Other	
ማበጠሪያ	Other	
ማባዘቻ	Other	
ማብረጃ	Other	
ማብራሪያ	Other	
ማብራት	Other	
ማብሰያ	Other	
ማተሚያ	Other	
ማቲ	Don't Know	
ማቴዎስ	Male	
ማትያስ	Male	ማቲያስ
ማቶት	Other	
ማኅበር	Other	
ማኅተመ	Male	
ማኅተመሥላሴ	Male	
ማኅተመወርቅ	Male	
ማነቆ	Other	
ማና	Male	
ማናለ	Male	
ማናሌ	Both	
ማናሰበው	Male	
ማናቸውም	Other	
ማናየ	Male	
ማናየህ	Male	
ማናየሽ	Female	
ማናየው	Male	
ማናዬ	Both	
ማን	Other	
ማን አህሎህ	Male	
ማን አህሎሽ	Female	
ማን አለብሽ	Female	ማናለብሽ
ማን ዘራሽ	Female	
ማን ያህሉሃል	Male	
ማን ያህሉሻል	Female	
ማን ያህልሃል	Male	
ማን ያህልሻል	Female	
ማን ያዘዋል	Male	
ማን ደፍሮ	Male	
ማን ጠግቦሽ	Female	
ማንቆርቆሪያ	Other	
ማንተጋፍቶት	Male	
ማንችሎት	Male	
ማንእንዳንቺ	Female	
ማንኛውም	Other	
ማንካ	Other	
ማንያህልሃል	Male	
ማንገቻ	Other	
ማንጠልጠያ	Other	
ማንፍሬድ	Male	foreign name
ማኛ	Other	
ማዕላፍ	Male	ማእላፍ
ማእሙን	Other	
ማእረገ	Male	ማዕረገ
ማእረጉ	Male	ማዕረጉ
ማእረግ	Male	ማዕረግ
ማእርጉ	Male	ማዕርጉ
ማእበል	Male	
ማእከላዊ	Other	
ማእከላይ	Other	
ማእከል	Other	
ማእዘን	Other	
ማእዘንት	Other	
ማእድ	Other	
ማእድን	Other	
ማእዶት	Both	
ማእጠንት	Female	
ማከናወኛ	Other	
ማከፋፈል	Other	
ማከፋፈያ	Other	
ማኪቦ	Other	
ማካበት	Other	
ማኬቦ	Other	
ማክሰኞ	Other	
ማክተሚያ	Other	
ማክዳ	Female	
ማዋለድ	Other	
ማዕረጉ	Male	
ማዘንጊያ	Male	
ማዘጋጃ	Other	
ማዝ	Other	
ማዞሪያ	Other	
ማየ ህይወት	Unknown	
ማያ ህይወት	Unknown	
ማይ ሀባር	Unknown	
ማይ በላ	Place	
ማይ ቤላ	Place	
ማይ ቤቴ	Unknown	
ማይ ጨሆት	Unknown	
ማይ ጨው	Place	
ማይ ጸምሪ	Unknown	
ማይም	Other	
ማይክል	Male	foreign name
ማይጨው	Place	
ማደሪያ	Other	
ማደራጃ	Other	
ማደያ	Other	
ማደጐ	Other	ማደጎ
ማዳራጃ	Unknown	
ማዳበሪያ	Other	
ማዳወሪያ	Other	
ማዴቦ	Other	
ማድረቂያ	Other	
ማድያት	Other	
ማድጋ	Other	
ማዶ	Other	
ማጀራት መች	Unknown	
ማጀቴ	Male	
ማጀት	Other	
ማጅራት መች	Other	
ማገሩ	Other	
ማገገሚያ	Other	
ማጋጣ	Other	
ማግስት	Other	
ማጠራቀሚያ	Other	
ማጠቃለያ	Other	
ማጠናቀሪያ	Other	
ማጠናቀቂያ	Other	
ማጠናከሪያ	Other	
ማጠንከሪያ	Other	
ማጠንጠኛ	Other	
ማጣሪያ	Other	
ማጣፈጫ	Other	
ማጥ	Other	
ማጫ	Unknown	
ማጭድ	Other	
ማፈሪያ	Other	
ማፈንገጥ	Other	
ማፈኛ	Other	
ሜላት	Female	
ሜቲ	Female	
ሜሎ	Other	
ሜሪ	Female	
ሜሮን	Female	
ሜታ	Other	
ሜንዳ	Other	
ሜንጦ	Other	
ሜኖ	Don't Know	
ሜካኤል	Male	
ሜዞ	Other	
ሜዳ	Other	
ሜጫ	Other	
ምሁራን	Other	
ምሁር	Other	
ምህላ	Other	
ምህረተ አብ	Male	
ምህረቱ	Male	ምሕረቱ
ምህረቴ	Both	ምሕረቴ
ምህረት	Both	ምሕረት
ምህዋር	Other	
ምህጻረ ቃል	Other	
ምላሰኛ	Other	
ምላስ	Other	
ምላሹ	Male	
ምላሽ	Other	
ምላጭ	Other	
ምልመላ	Other	
ምልምል	Other	
ምልአተ	Both	ምልዓተ
ምልአተወርቅ	Both	ምልዓተወርቅ
ምልአተማርያም	Female	ምልዓተማርያም
ምልአተፀጋ	Both	ምልዓተፀጋ
ምልጣን	Other	
ምሐረት	Male	
ምሕረተ	Both	
ምሕረተአብ	Male	
ምሕረተስላሴ	Both	
ምሕረቱ	Male	
ምሕረቴ	Both	
ምሕረት	Both	
ምረቃ	Other	
ምሩጽ	Male	
ምራቅ	Other	
ምራት	Other	
ምራጭ	Other	
ምርት	Other	
ምርኮኛ	Other	
ምርጊት	Other	
ምርጥነህ	Male	
ምርጫ	Other	
ምርፋቅ	Don't Know	
ምሰሶ	Other	
ምሳሌ	Male	
ምሳር	Other	
ምስለኔ	Other	
ምስል	Other	
ምስማር	Other	
ምስማክ	Both	
ምስራቃውያን	Other	
ምስራቅ	Both	
ምስራች	Female	
ምስርች	Don't Know	
ምስቅልቅል	Other	
ምስኪን	Other	
ምስክረ	Other	
ምስክር	Both	
ምስጉን	Male	
ምስጋኑት	Other	
ምስጋና	Male	
ምስጋኔ	Male	
ምስጋናው	Male	ምስግናው
ምስግና	Male	
ምስጢራዊ	Other	
ምስጢረ	Both	
ምስጢር	Male	
ምስጥ	Other	
ምሽግ	Other	
ምቧይ	Other	
ምትሀት	Other	
ምትኩ	Male	
ምትካቸው	Other	
ምትኬ	Male	
ምትክ	Both	
ምትክነሽ	Female	
ምትኳ	Female	
ምቹ	Other	
ምች	Other	
ምኒልክ	Male	
ምናምን	Other	
ምናሰር	Other	
ምናሴ	Male	
ምናብ	Male	
ምናየ	Male	
ምን ተስኖት	Male	
ምን ትዋብ	Female	
ምን አለ	Male	
ምን ውየለት	Male	
ምንልክ	Male	
ምንሽር	Other	
ምንቅርቅር	Other	
ምንባብ	Other	
ምንታምር	Male	
ምንትራስ	Female	
ምንቸት	Other	
ምንችሌ	Other	
ምንዛሬ	Other	
ምንዝር	Other	
ምንደኛ	Other	
ምንዳ	Male	
ምንዳዬ	Male	
ምንጃር	Other	
ምንጅላት	Other	
ምንጠራ	Other	
ምንጭ	Other	
ምንአለሽዋ	Male	
ምንአሉ	Male	
ምንዋልኩለት	Male	
ምንውዬ	Male	
ምንያ	Male	
ምንያህል	Male	
ምንያሻል	Male	
ምንያሽዋል	Male	
ምኞታዊ	Other	
ምኞት	Both	
ምእመናን	Other	
ምእራባውያን	Other	
ምእራብ	Other	
ምእራፍ	Both	
ምእት	Other	
ምእዳን	Other	
ምኩራብ	Both	
ምክረ	Male	
ምክረስላሴ	Male	
ምክሩ	Male	
ምክር	Other	
ምዝበራ	Other	
ምዝብር	Other	
ምደባ	Other	
ምድረ በዳ	Other	
ምድር	Other	
ምድጃ	Other	
ምጃ	Other	
ምግባሩ	Male	
ምግብ	Other	
ምጣኔ	Other	
ምጥማጥ	Other	
ምጥበሻ	Unknown	
ምጥን	Female	
ምጽላል	Female	
ምጽዋ	Other	
ምጽዋት	Other	
ሞላ	Other	
ሞላሌ	Other	
ሞላልኝ	Male	
ሞልቶት	Male	
ሞሚና	Female	
ሞረሽ	Other	
ሞረቴ	Other	
ሞረዳ	Male	
ሞረድ	Other	
ሞራ	Other	
ሞሲሳ	Male	
ሞተራ	Other	
ሞት	Other	
ሞት ባይኖር	Other	
ሞንዳላ	Other	
ሞሼ	Male	
ሞካ	Don't Know	
ሞክሼ	Other	
ሞጃ	Other	
ሞጆ	Place	
ሞገሳ	Don't Know	
ሞገሴ	Male	
ሞገስ	Male	
ሞገደኛ	Other	
ሞገድ	Other	
ሞግሼ	Don't Know	
ሞግዚት	Other	
ሞጣ	Other	
ሞጣህት	Other	
ሞፈር	Other	
ሞፎ	Other	
ሟርተኛ	Other	
ሟች	Other	
ሠምሩ	Other	
ሠረቀ	Male	
ሠራዊት	Both	
ሠርፀ	Male	
ሠይፉ	Male	
ሣህለ	Male	
ሣህሉ	Male	
ሣራ	Female	
ሣኒ	Male	
ሥላሴ	Male	
ሥራ	Female	
ሥራህብዙ	Male	
ሥራነሽ	Female	
ሥራው	Male	
ሥርአት	Both	
ሥርግው	Male	
ሥነ	Male	
ሥነስብሃቱ	Male	
ሥነፀሐይ	Female	
ሥእሉ	Other	
ሥዩም	Male	
ረሃብ	Other	
ረሂማ	Female	
ረመዳን	Male	
ረዋዚ	Male	
ረመጥ	Other	
ረምሐ	Other	
ረስቲን	Male	
ረሺድ	Male	
ረቀታ	Unknown	
ረቂቁ	Other	
ረቂቅ	Both	
ረቡእ	Other	
ረቢ	Other	
ረባዳ	Other	
ረታ	Male	
ረውዳ	Female	
ረኮ	Other	
ረኸጥ	Other	
ረዘነ	Male	
ረዲ	Male	
ረዳ	Male	
ረዳት	Other	
ረዳእ	Other	
ረዴ	Other	
ረድ	Male	
ረድማን	Male	
ረድኤቱ	Male	
ረድኤት	Both	
ረድፍ	Other	
ረጀቦ	Unknown	
ረጀት	Other	
ረጃ	Male	
ረጅ	Other	
ረጅም	Other	
ረገዱ	Female	
ረገድ	Female	
ረጋሳ	Male	
ረጋሽ	Unknown	
ረፋድ	Other	
ሩቂያ	Female	
ሩር	Don't Know	
ሩት	Female	
ሩካቤ	Other	
ሩጋ	Male	
ሩጐን	Don't Know	
ሩፋኤል	Male	
ሪሃና	Female	
ሪህ	Other	
ሪሻን	Female	
ሪቅ	Other	
ሪዝ	Other	
ሪጋ	Other	
ሪፖርት	Other	
ራሂማ	Female	
ራሄል	Female	
ራህመቶ	Male	
ራህማ	Female	
ራሜት	Don't Know	
ራም	Don't Know	
ራስ	Other	
ራስ ቁር	Unknown	
ራስጌ	Other	
ራቢያ	Don't Know	
ራብእ	Unknown	
ራእይ	Both	
ራዘነ	Unknown	
ራጉ	Unknown	
ራጉኤል	Male	
ራጐ	Don't Know	
ራፋኤል	Male	
ሬሳ	Other	
ሬድማን	Male	
ሬድዋን	Male	
ርሚጦ	Other	
ርስ ቁር	Unknown	
ርስቱ	Male	
ርስት	Other	
ርስትነሽ	Female	
ርቄ	Don't Know	
ርቢ	Other	
ርብራብ	Other	
ርብቃ	Female	
ርብእ	Don't Know	
ርቱእ	Other	
ርችት	Other	
ርእስ	Other	
ርእሶም	Male	
ርእዮተ ኣለም	Unknown	
ርእዮት	Other	
ርካሽ	Other	
ርዝመት	Other	
ርዝራዥ	Other	
ሮ/	Don't Know	
ሮሀ	Other	
ሮማነ	Female	
ሮማነወርቅ	Female	
ሮማን	Female	
ሮበሌ	Don't Know	
ሮቢ	Other	
ሮቢት	Other	
ሮባ	Male	
ሮቤ	Other	
ሮብ	Other	
ሮዛ	Female	
ሰለሄ መለሄ	Unknown	
ሰለባ	Other	
ሰለክላካ	Other	
ሰለጠነ	Other	
ስለሃዲን	Male	
ሰሊሆም	Other	
ሰላመ	Other	
ሰላሙ	Male	
ሰላማ	Male	
ሰላማዊ	Other	
ሰላማዊት	Female	
ሰላም	Both	
ሰላምነሽ	Female	
ሰላሱት	Other	
ሰላሳ	Other	
ሰላቢ	Other	
ሰላይ	Other	
ሰላጣ	Other	
ሰላጤ	Other	
ሰሌን	Other	
ሰሌዳ	Other	
ሰልማን	Male	
ሰልፈኛ	Other	
ሰልፍ	Other	
ሰሎሜ	Female	
ሰሎሞን	Male	
ሰመመን	Other	
ሰመረ	Other	
ሰመነ	Male	
ሰመተር	Other	
ሰሙ	Male	
ሰሙነሽ	Female	
ሰሙንጉስ	Male	
ሰሚራ	Female	
ሰሚር	Male	
ሰማኒያ	Other	
ሰማን	Other	
ሰማእታት	Other	
ሰማእትነት	Other	
ሰማያት	Other	
ሰማያዊ	Other	
ሰማይ	Other	
ሰማይ ነሽ	Female	
ሰማሁ	Male	
ሰማእግዜር	Male	
ሰማኸኝ	Male	
ሰማው	Male	
ሰማይቱ	Female	
ሰምሩ	Male	
ሰምረ	Male	
ሰረቀብርሃን	Male	
ሰርቤሳ	Male	
ሰሜ ነህ	Male	
ሰሜናዊ	Other	
ሰሜን	Other	
ሰም	Other	
ሰምና ወርቅ	Other	
ሰሞነኛ	Other	
ሰሞን	Other	
ሰረሰር	Other	
ሰረቀ	Male	ሠረቀ
ሰረገላ	Other	
ሰሪ	Other	
ሰራተኛ	Other	
ሰራተኛች	Other	
ሰራተኞት	Other	
ሰራዊት	Male	
ሰርቦ	Other	
ሰርቶ በላ	Other	
ሰርኔሳ	Other	
ሰርክ	Other	
ሰርክአዲስ	Both	
ሰርክአለም	Both	ሰርክዓለም
ሰረጋጋ	Male	
ሰርጎብርሃን	Male	
ሰርፃይ	Male	
ሰበነ	Both	
ሰርዱ	Other	
ሰርዶ	Other	
ሰርገኛ	Other	
ሰርጸ	Male	ሠርፀ
ሰርጹ	Male	ሠርፁ
ሰሳ	Other	
ሰቀላ	Other	
ሰቃ	Other	
ሰቅ	Other	
ሰቆጣ	Other	
ሰቋር	Other	
ሰበ ነክ	Female	
ሰበታ	Other	
ሰበከት	Other	
ሰበዝ	Other	
ሰባ	Other	
ሰባራ	Other	
ሰባተኛ	Other	
ሰባት	Other	
ሰባኪ	Other	
ሰብለ	Both	
ሰብለወርቅ	Female	
ሰብለወንጌል	Female	
ሰብለገነት	Female	
ሰብሉ	Male	
ሰብል	Both	
ሰብሳቢ	Other	
ሰብስቤ	Male	
ሰብአ ሰገል	Other	
ሰብአ ስገል	Other	
ሰብአዊ	Other	
ሰብአዊነት	Other	
ሰቦቃ	Male	
ሰታቴ	Other	
ሰነድ	Other	
ሰኒያ	Female	
ሰናይ	Male	
ሰናይት	Female	
ሰናድር	Other	
ሰናፊል	Other	
ሰናፍጭ	Other	
ሰኔ	Other	
ሰንሰለት	Other	
ሰንሰል	Other	
ሰንበሌጥ	Other	
ሰንበር	Other	
ሰንበቱ	Male	
ሰንበታ	Male	
ሰንበቴ	Male	
ሰንበት	Other	
ሰንበቶ	Male	
ሰንአፈ	Other	
ሰንኮፍ	Other	
ሰንደል	Other	
ሰንደቅ	Other	
ሰንደቁ	Male	
ሰንዳፋ	Other	
ሰንጋ	Other	
ሰንጠረጅ	Other	
ሰንጢ	Other	
ሰኞ	Other	
ሰአት	Other	
ሰኣታት	Other	
ሰኣት	Other	
ሰኮሩ	Other	
ሰኮና	Other	
ሰዉ	Other	
ሰዋሰው	Other	
ሰዊ	Male	
ሰዊተ	Female	
ሰዊት	Female	
ሰውነቴ	Both	
ሰውአገኝ	Both	
ሰውአለም	Both	
ሰው	Other	
ሰው በላ	Other	
ሰውነት	Both	
ሰያፍ	Other	
ሰይድ	Male	
ሰይዳ	Female	
ሰይጣን	Other	
ሰይፈ	Male	
ሰይፈ አርእድ	Unknown	
ሰይፈ እርእድ	Unknown	
ሰይፈሚካኤል	Male	
ሰይፈስላሴ	Male	
ሰይፈገብርኤል	Male	
ሰይፈዲን	Male	
ሰይፉ	Male	
ሰይፉዲን	Male	
ሰይፍ	Other	
ሰዮ	Other	
ሰደሪያ	Other	
ሰደርያ	Other	
ሰደቃ	Other	
ሰደቻ	Other	
ሰደድ	Other	
ሰደፍ	Other	
ሰዲ	Other	
ሰዶም	Other	
ሰገራ	Other	
ሰገባ	Other	
ሰገነት	Other	
ሰገነይቲ	Other	
ሰገዱ	Male	
ሰገድ	Male	
ሰገዱልሽ	Female	
ሰጠ	Male	
ሰጠኝ	Male	
ሰጥአርጋቸው	Male	
ሰጥአርጌ	Male	
ሰገን	Other	
ሰገድ	Other	
ሰጐን	Other	
ሰጠኝ	Male	
ሰፈራ	Other	
ሰፈር	Other	
ሰፈፍ	Other	
ሰፈፍ የለሽ	Other	
ሰፈፌ	Female	
ሰፊ	Other	
ሰፊው	Other	
ሰፊጌታ	Male	
ሰፋ	Male	
ሰፋሸዋ	Male	
ሰፋኒት	Female	
ሰፋአለም	Both	
ሰፎንያስ	Male	
ሰፋሰፋ	Other	
ሰፌድ	Other	
ሰፍሳፋ	Other	
ሰፍነግ	Other	
ሱለሂማን	Male	
ሱሌ	Male	
ሱሌማን	Male	
ሱልጣን	Male	
ሱረት	Other	
ሱሪ	Other	
ሱሪያ	Female	
ሱሩር	Male	
ሱራፌል	Male	
ሱርቦ	Male	
ሱርና	Male	
ሱስንዮስ	Male	
ሱቅ	Other	
ሱቢህ	Other	
ሱባኤ	Other	
ሱቲ	Other	
ሱፋጭ	Other	
ሱፍያን	Male	ሱፊያን
ሲሚሎ	Other	
ሲሚንቶ	Other	
ሲሞን	Male	foreign name
ሲራክ	Male	
ሲራጅ	Male	
ሲርሃን	Don't Know	
ሲሳይ	Male	
ሲሳይነሽ	Female	
ሲሶ	Other	
ሲትራ	Female	
ሲቃላ	Other	
ሲባጐ	Other	
ሲቤንስን	Don't Know	
ሲኖዶስ	Other	
ሲኦል	Other	
ሲዳ	Other	
ሲዳማ	Other	
ሲዳሞ	Other	
ሲጃራ	Male	
ሳህለ	Male	
ሳህለመድህን	Male	
ሳህለሚካኤል	Male	
ሳህለማርያም	Both	
ሳህለሥላሴ	Male	
ሳህለየሱስ	Male	
ሳህለወርቅ	Both	
ሳህለድንግል	Female	
ሳህልነሽ	Female	
ሳህሏ	Female	
ሳህም	Male	
ሳህሉ	Male	ሣህሉ
ሳህሊቱ	Female	
ሳህሌ	Male	
ሳሆ	Don't Know	
ሳለ አይሰጥ	Other	
ሳለህ	Don't Know	
ሳሊ	Other	
ሳሊህ	Other	
ሳሊም	Male	
ሳሊያ	Female	
ሳላ	Male	
ሳሌህ	Other	
ሳልህ	Don't Know	
ሳልልሽ	Female	
ሳልስ	Other	
ሳልሃዲን	Male	ሳላህአዲን
ሳሙና	Other	
ሳሙኤል	Male	
ሳሚ	Male	
ሳሚር	Male	
ሳሚያ	Female	
ሳማ	Other	
ሳምራዊ	Male	
ሳምራዊት	Female	
ሳምሶን	Male	
ሳምባ	Other	
ሳምንታዊ	Other	
ሳምንት	Other	
ሳበሸዋ	Male	
ሳበይፋት	Male	
ሳባ	Female	
ሳሪስ	Other	
ሳራ	Female	
ሳሳሁልሽ	Female	
ሳቡሬ	Don't Know	
ሳቢ	Other	
ሳቢር	Male	
ሳቢሳ	Other	
ሳቢያ	Other	
ሳቢያን	Other	
ሳባ	Female	
ሳብእ	Other	
ሳኒ	Male	ሣኒ
ሳኒያ	Female	
ሳንቃ	Other	
ሳንባ	Other	
ሳንቲም	Other	
ሳንዱቅ	Other	
ሳንድቬድ	Other	
ሳንጃ	Other	
ሳኣል	Unknown	
ሳኣዳ	Female	
ሳኢዳ	Female	
ሳይሽ	Female	
ሳይድ	Male	
ሳዲ	Male	
ሳዳ	Male	
ሳይዳ	Female	
ሳዱላ	Other	
ሳድስ	Other	
ሳድያ	Other	ሳዲያ
ሳጠራ	Other	
ሳጥናኤል	Other	
ሴም	Male	
ሴረኛ	Other	
ሴራ	Other	
ሴሰኛ	Other	
ሴሰኛነት	Other	
ሴቴ	Other	
ሴት	Other	
ሴት አውል	Other	
ሴትነት	Other	
ሴትኛ አዳሪ	Other	
ስሁል	Other	
ስሂን	Female	ስኂን
ስህነ	Both	
ስህን	Both	
ስለእናት	Female	
ስህተት	Other	
ስለሺ	Male	
ስለሽ	Other	
ስለት	Other	
ስሉስ	Don't Know	
ስላስ	Female	
ስልስ	Other	
ስልቅ	Other	
ስልባቦት	Other	
ስልብ	Other	
ስልተ	Other	
ስልቻ	Other	
ስልክ	Other	
ስልጣን	Other	
ስመኝ	Both	
ስመኘው	Male	
ስመኝሽ	Female	
ስሙኒ	Other	
ስሚንቶ	Other	
ስማዳ	Other	
ስማ	Male	
ስማቸው	Male	
ስሜ	Male	
ስሜ ነህ	Male	
ስሜ ነሽ	Female	
ስሜት	Other	
ስም	Other	
ስምምነት	Other	
ስምረት	Both	
ስምረተአብ	Male	
ስምሪት	Other	
ስምንተኛ	Other	
ስምንት	Other	
ስምኦን	Male	
ስምዛ	Other	
ስሪት	Other	
ስራ	Other	
ስራ አስኪያጅ	Other	
ስራ አጥ	Other	
ስር	Other	
ስር ነቀል	Other	
ስርቅታ	Other	
ስርቆሽ	Other	
ስርቻ	Other	
ስርኣተ	Other	
ስርኣተ አልባነት	Government	
ስርወ	Other	
ስርየት	Other	
ስርገው	Other	ሥርገው
ስርጉት	Female	
ስርግው	Male	ሥርግው
ስቃይ	Other	
ስቅለት	Other	
ስቋር	Other	
ስብሀቱ	Male	ስብሐቱ
ስብሀት	Male	ስብሐት
ስብሀትለ አብ	Other	
ስብሐት	Male	
ስብራት	Other	
ስብሰባ	Other	
ስብስቴ	Other	
ስብስቴያኖስ	Other	
ስታንስሉዉ	Other	
ስኂን	Female	
ስነ	Other	
ስነሕይወት	Male	
ስኒ	Other	
ስና	Other	
ስናር	Don't Know	
ስናፍቅሽ	Female	
ስኔ	Other	
ስንሐት	Other	
ስንቄ	Female	
ስንቅ ነህ	Male	
ስንቅ ነሽ	Female	
ስንቡል	Other	
ስንብል	Other	
ስንት አየሁ	Male	ስንታየሁ
ስንኩል	Other	
ስንደዶ	Other	
ስንዱ	Female	
ስንድድ	Other	
ስንጥር	Other	
ስንጥቅ	Other	
ስእለ	Male	ሥእለ
ስእላዊ	Other	ሥእላዊ
ስእል	Other	ሥእል
ስዕሊቱ	Female	
ስዕላይ	Male	
ስኳሬ	Female	
ስኳር	Other	
ስዋሰው	Other	
ስውር	Other	
ስዩም	Male	ሥዩም
ስደተኛ	Other	
ስደተኞች	Other	
ስደት	Other	
ስድሳ	Other	
ስድስተኛ	Other	
ስድስት	Other	
ስድስቶ	Other	
ስጋ	Other	
ስጋ ሜዳ	Place	
ስጋ ወደሙ	Other	
ስጋዊ	Other	
ስጋጃ	Other	
ስግብግብ	Other	
ስጦታው	Male	
ስፌት	Other	
ስፍራሽ	Female	
ስፖርት	Other	
ሶሎግ	Other	
ሶምሶማ	Other	
ሶራ	Female	
ሶስተኛ	Other	
ሶስት	Other	
ሶስና	Female	
ሶታ	Don't Know	
ሶደሬ	Other	
ሶዶ	Other	
ሶፊያ	Female	
ሸህ	Other	
ሸሆና	Other	
ሸለመው	Other	
ሸለማይ	Other	
ሸለሸል	Other	
ሸለመ	Male	
ሸለቆ	Other	
ሸመገለ	Other	
ሸሚዝ	Other	
ሸማ	Other	
ሸማኔ	Other	
ሸማገለ	Other	
ሸምሱ	Male	
ሸምሲ	Male	
ሸምቃቃ	Other	
ሸምበቆ	Other	
ሸረሪት	Other	
ሸረኛ	Other	
ሸሩባ	Other	
ሸሪፍ	Male	
ሸራ	Other	
ሸርሙጣ	Other	
ሸቀጣ ሸቀጥ	Other	
ሸቀጥ	Other	
ሸቃጭ	Other	
ሸበሌ	Other	
ሸበል	Other	
ሸቤ	Other	
ሸንቁጤ	Male	
ሸንቁጥ	Male	
ሸንቂጤ	Male	
ሸንተረር	Other	
ሸንኮሩ	Other	
ሸንኮሬ	Female	
ሸንኮር	Male	
ሸንጐ	Other	
ሸንጐበት	Other	
ሸንፈተኛ	Other	
ሸኖ	Other	
ሸክላ	Other	
ሸሽጌ	Male	
ሸዊት	Female	
ሸዋ	Male	
ሸዋመብራት	Both	
ሸዋማማሽ	Female	
ሸዋረገድ	Both	
ሸዋረጋ	Male	
ሸዋረጋሽ	Female	
ሸዋእርካብሽ	Female	
ሸዋሰገድ	Male	
ሸዋቀና	Male	
ሸዋበዛ	Both	
ሸዋብርሃን	Both	
ሸዋነሽ	Female	
ሸዋላንቺ	Female	
ሸዋንቅጣው	Male	
ሸዋንዳኝ	Male	
ሸዋንግዢው	Female	
ሸዋአማረ	Male	
ሸዋአነሰሽ	Female	
ሸዋአፈራ	Male	
ሸዋአፈራሁ	Both	
ሸዋወርቅ	Both	
ሸዋአለም	Both	
ሸዋዘውድ	Both	
ሸዋፀሐይ	Both	ሸዋፀሃይ
ሸዋጌጥ	Both	
ሸዋፀጋ	Both	
ሸዋፈራው	Male	
ሸጋ	Male	
ሸጌ	Male	
ሹመቴ	Male	
ሺረጋ	Male	
ሺፋ	Male	
ሻሚል	Male	
ሻሽወርቅ	Female	
ሻሺቱ	Female	
ሸዋ ረገድ	Both	
ሸዋ ርካብሽ	Female	
ሸዋ ፈራ	Both	
ሸዋን ግዛው	Male	
ሸዋዬ	Female	
ሸዌ	Don't Know	
ሸው ፈራ	Unknown	
ሸውራራ	Other	
ሸዎንግዛዉ	Male	
ሸፋፋ	Other	
ሹሉዳ	Other	
ሹልክታ	Other	
ሹልዳ	Other	
ሹማምንት	Other	
ሹሜ	Male	
ሹም	Other	
ሹምሲያ	Female	
ሹምዬ	Male	
ሹሩባ	Other	
ሹራብ	Other	
ሹርቤ	Other	
ሹካ	Other	
ሺህ	Other	
ሺመልስ	Male	
ሺምልጃሽ	Female	
ሺሬ	Other	
ሺበሺ	Male	
ሺበት	Other	
ሺብሬ	Other	
ሺታ	Female	
ሺታዬ	Female	
ሺቶ	Female	
ሺፈራው	Male	
ሺፋው	Male	
ሻህላ	Other	
ሻለቃ	Other	
ሻላ	Other	
ሻሚል	Male	
ሻማ	Other	
ሻሜ	Other	
ሻሜል	Other	
ሻምላ	Other	
ሻምበል	Male	
ሻምቡ	Male	
ሻረው	Male	
ሻሸ	Female	
ሻሸመኔ	Other	
ሻሼ	Female	
ሻሽ	Other	
ሻሾ	Other	
ሻንቅላ	Other	
ሻንቆ	Male	
ሻንጣ	Other	
ሻኛ	Other	
ሻውል	Male	
ሻይ	Other	
ሻጉራ	Other	
ሻግያ	Other	
ሻፊ	Male	
ሼባ	Other	
ሼቻ	Other	
ሽለላ	Other	
ሽል	Other	
ሽልማት	Other	
ሽልቀቃ	Other	
ሽልጦ	Other	
ሽመል	Other	
ሽመልስ	Male	
ሽማግሌ	Other	
ሽምቃቅ	Other	
ሽምቅ	Other	
ሽምብራ	Other	
ሽምጥ	Other	
ሽረት	Other	
ሽርሽር	Other	
ሽርጥ	Other	
ሽሮ	Other	
ሽሽት	Other	
ሽሽግ	Other	
ሽቅብ	Other	
ሽበሺ	Male	
ሽባ	Other	
ሽባባው	Male	
ሽቤ	Don't Know	
ሽብልቅ	Other	
ሽብሩ	Male	
ሽብር	Other	
ሽብሬ	Male	
ሽቦ	Other	
ሽቱ	Both	
ሽታ	Female	
ሽታ ሽቶ	Other	
ሽታሽቶ	Other	
ሽታነሽ	Female	
ሽታሁን	Male	
ሽታው	Male	
ሽታዬ	Female	
ሽቶ	Both	
ሽንቅጡ	Male	
ሽንቅጥ	Male	
ሽንተ ማጥ	Unknown	
ሽንገላ	Other	
ሽንጥ	Other	
ሽንፈተኛ	Other	
ሽንፈተኞች	Other	
ሽንፈት	Other	
ሽንፊላ	Other	
ሽኩር	Other	
ሽኩቻ	Don't Know	
ሽኮኮ	Other	
ሽውራራ	Unknown	
ሽውታ	Other	
ሽያጭ	Other	
ሽጉጥ	Other	
ሽጉጤ	Male	
ሽግግር	Other	
ሽፈራው	Male	
ሽፋሽፍት	Other	
ሽፋው	Male	
ሽፋጭ	Other	
ሽፍታ	Other	
ሽፍን	Other	
ሽፍጠኛ	Other	
ሾላ	Other	
ሾርባ	Other	
ሾርኒ	Other	
ሾተል	Other	
ሾኔ	Other	
ሾገሬ	Other	
ቀለህ	Other	
ቀለመ	Other	
ቀለመወርቅ	Female	
ቀለሙ	Male	
ቀለም	Both	
ቀለምሲስ	Other	
ቀለሟ	Female	
ቀለበት	Other	
ቀለብ	Other	
ቀለታ	Male	
ቀላቲ	Other	
ቀላዋጭ	Other	
ቀላድ	Other	
ቀላጤ	Other	
ቀላፎ	Other	
ቀልባሽ	Other	
ቀልቤሳ	Male	
ቀልደኛ	Other	
ቀልድ	Other	
ቀልጣፋ	Other	
ቀመር	Other	
ቀመሪያ	Female	
ቀሚስ	Other	
ቀማኛ	Other	
ቀምበጥ	Other	
ቀረርቶ	Other	
ቀረጥ	Other	
ቀረፋ	Other	
ቀራንዮ	Other	
ቀርሳ	Other	
ቀርሺ	Other	
ቀርቀሃ	Other	
ቀርበታ	Other	
ቀርጨሞ	Other	
ቀሰም	Other	
ቀሰስተኛ	Other	
ቀሲስ	Other	
ቀስቃሽ	Other	
ቀስተኛ	Other	
ቀስት	Other	
ቀበሌ	Other	
ቀበርቾ	Other	
ቀበሮ	Other	
ቀበቶ	Other	
ቀበና	Place	
ቀበኛ	Other	
ቀብርቾ	Other	
ቀብድ	Other	
ቀነአ	Other	
ቀነኒ	Male	
ቀነኒሳ	Male	ቀነኒሣ
ቀነአ	Male	ቀነዓ
ቀኑብሽ	Female	
ቀና	Other	
ቀናተኛ	Other	
ቀናኢ	Other	
ቀናው	Other	
ቀን	Other	
ቀንበር	Other	
ቀንበጥ	Other	
ቀንብር	Other	
ቀንደኛ	Other	
ቀንዲል	Other	
ቀንድ	Other	
ቀንዶ	Other	
ቀንጠፋ	Other	
ቀኖ	Other	
ቀኖና	Other	
ቀኖናዊ	Other	
ቀኖናዊያን	Other	
ቀኖናውያን	Other	
ቀኛዝማች	Other	
ቀኝ	Other	
ቀውላላ	Other	
ቀውስ	Other	
ቀውጢ	Other	
ቀያሽ	Other	
ቀያቴ	Other	
ቀዬ	Other	
ቀይ	Other	
ቀይ ባህር	Place	
ቀይህ	Other	
ቀደም	Other	
ቀደር	Other	
ቀዳማዊ	Other	
ቀዳማይ	Other	
ቀዳዳ	Other	
ቀዶ ጥገና	Other	
ቀጁላ	Other	
ቀጄላ	Male	
ቀጋ	Other	
ቀጠሮ	Other	
ቀጠና	Other	
ቀጥቃጭ	Other	
ቀጥታ	Other	
ቀጨሞ	Other	
ቀጨኔ	Other	
ቀጭ	Other	
ቀጭኔ	Other	
ቀጭን	Other	
ቀጸላ	Male	
ቀጸላማርያም	Female	
ቀጸላወርቅ	Female	
ቁምነገር	Male	
ቀፈት	Other	
ቀፎ	Other	
ቁልል	Other	
ቁልቁለት	Other	
ቁልቁል	Other	
ቁልቋል	Other	
ቁልቢ	Other	
ቁልፍ	Other	
ቁማር	Other	
ቁማርተኛ	Other	
ቁማጭ	Other	
ቁም ነገር	Male	
ቁምላቸው	Male	
ቁምጣ	Other	
ቁምጥና	Other	
ቁረን	Other	
ቁረንጮ	Other	
ቁረኛ	Other	
ቁራ	Other	
ቁራኛ	Other	
ቁራጭ	Other	
ቁር	Other	
ቁርሴ	Other	
ቁርስ	Other	
ቁርቁራ	Other	
ቁርበት	Other	
ቁርባ	Other	
ቁርባን	Other	
ቁርአን	Other	
ቁርእን	Other	
ቁርዝ	Other	
ቁርጠት	Other	
ቁርጠኛ	Other	
ቁርጥ	Other	
ቁርጥማት	Other	
ቁርጥራጭ	Other	
ቁርጭምጭምት	Other	
ቁስ አካላነት	Other	
ቁስ አካላዊ	Other	
ቁስ አካል	Other	
ቁስ አካልነት	Other	
ቁስለኛ	Other	
ቁስል	Other	
ቁስቋም	Other	
ቁስጥንጥንያ	Other	
ቁኒ	Other	
ቁና	Other	
ቁንቁን	Other	
ቁንዲ	Other	
ቁንዶ በርበሬ	Other	
ቁንጣን	Other	
ቁንጥጫ	Other	
ቁንጫ	Other	
ቁንጮ	Other	
ቁንጽል	Other	
ቁጠባ	Other	
ቁጢት	Other	
ቁጥር	Other	
ቁጥቋጦ	Other	
ቁጥጥር	Other	
ቁፋሮ	Other	
ቂል	Other	
ቂም	Other	
ቂርቆስ	Other	
ቂንድ	Other	
ቂጣ	Other	
ቂጥኝ	Other	
ቃለ አጋኖ	Other	
ቃለ ጉባኤ	Other	
ቃለአብ	Male	
ቃለክርስቶስ	Male	
ቃሊድ	Male	
ቃሉ	Male	
ቃሊብ	Other	
ቃሊቲ	Other	
ቃላት	Other	
ቃሌም	Other	
ቃል	Other	
ቃልቻ	Other	
ቃሪያ	Other	
ቃሬዛ	Other	
ቃርያ	Other	
ቃሲም	Male	
ቃተኛ	Other	
ቃታ	Other	
ቃና	Other	
ቃና ዘገሊላ	Place	
ቃንቄ	Other	
ቃኖ	Other	
ቃኘው	Male	
ቃየል	Male	
ቃዲ	Other	
ቃጤ	Other	
ቃጫ	Other	
ቃጭል	Other	
ቄራ	Other	
ቄርሎስ	Other	
ቄሳር	Other	
ቄስ	Other	
ቄብ	Other	
ቄንሳ	Other	
ቄንሶ	Other	
ቄንጠኛ	Other	
ቄንጥ	Other	
ቄደር	Other	
ቄጠማ	Other	
ቅሌት	Other	
ቅል	Other	
ቅልሞሽ	Other	
ቅልበሳ	Other	
ቅልብ	Other	
ቅልጣን	Other	
ቅልጥም	Other	
ቅመማ	Other	
ቅመም	Other	
ቅማል	Other	
ቅማት	Other	
ቅማንት	Other	
ቅምቡርስ	Other	
ቅምብቻ	Other	
ቅምጥ	Other	
ቅምጥል	Other	
ቅምጦት	Other	
ቅምጫና	Other	
ቅምጭብ	Other	
ቅሪላ	Other	
ቅሪት	Other	
ቅራቅንቦ	Other	
ቅራኔ	Other	
ቅሬ	Other	
ቅሬታ	Other	
ቅርሩ	Other	
ቅርሴ	Other	
ቅርስ	Other	
ቅርሶች	Other	
ቅርሻት	Other	
ቅርቃብ	Other	
ቅርንጫፍ	Other	
ቅርንጫፎች	Other	
ቅርንጭፎች	Other	
ቅርንፉድ	Other	
ቅርጫ	Other	
ቅርጫት	Other	
ቅርጽ	Other	
ቅርፊት	Other	
ቅሲም	Other	
ቅስም	Other	
ቅስቀሳ	Other	
ቅስት	Other	
ቅስና	Other	
ቅቅል	Other	
ቅበላ	Other	
ቅባ ኑግ	Other	
ቅባት	Other	
ቅባቱ	Male	
ቅቤ	Other	
ቅብአ ቅዱስ	Other	
ቅብኣት	Other	
ቅብዝብዝ	Other	
ቅብጥ	Other	
ቅናሽ	Other	
ቅናት	Other	
ቅናጅ	Other	
ቅኔ	Other	
ቅንስናሽ	Other	
ቅንቀና	Other	
ቅንአት	Other	
ቅንጅት	Other	
ቅንጣት	Other	
ቅንጦት	Other	
ቅንጭብት	Unknown	
ቅንፍ	Other	
ቅኝ	Other	
ቅዘን	Other	
ቅየሳ	Other	
ቅያስ	Other	
ቅዱሰ	Other	
ቅዱሳት	Other	
ቅዱሳን	Other	
ቅዱስ	Male	
ቅዳሜ	Other	
ቅዳሜ ሱር	Other	
ቅድመ	Other	
ቅድሚያ	Other	
ቅድስተ	Female	
ቅድስት	Female	
ቅጠል	Other	
ቅጣት	Other	
ቅጣው	Male	
ቅጣቸው	Male	
ቅጥራን	Other	
ቅጥር	Other	
ቅጥቅጣት	Other	
ቅጥያ	Other	
ቅጽ	Other	
ቅጽል	Other	
ቅጽበታዊ	Other	
ቅጽበት	Other	
ቅፍርናሆም	Other	
ቆለኛ	Other	
ቆላ	Other	
ቆላ ድባ	Place	
ቆላፋ	Other	
ቆሌ	Other	
ቆሎ	Other	
ቆመጥ	Other	
ቆማጣ	Other	
ቆምስ	Other	
ቆሞስ	Unknown	
ቆረቆር	Other	
ቆሪ	Other	
ቆራጥ	Other	
ቆራጭ	Other	
ቆርቆሮ	Other	
ቆርቾ	Other	
ቆርነሌዎስ	Other	
ቆሮንጦስ	Other	
ቆሳቁስ	Other	
ቆስጠንጢኖስ	Male	
ቆስጣ	Other	
ቆሽማዳ	Other	
ቆሽት	Other	
ቆቃ	Other	
ቆበ	Other	
ቆበር	Other	
ቆብ	Other	
ቆቦ	Other	
ቆቱ	Other	
ቆንስል	Other	
ቆንዳላ	Other	
ቆንዶ በርበሬ	Other	
ቆንጅት	Female	ቆንጂት
ቆንጥር	Other	
ቆዳ	Other	
ቆጠራ	Other	
ቆጥ	Other	
ቆጭቶ	Other	
ቆጮ	Other	
ቆፈን	Other	
ቋሊማ	Other	
ቋሚ	Other	
ቋር	Other	
ቋቁቻ	Other	
ቋት	Other	
ቋንጃ	Other	
ቋንጣ	Other	
ቋያ	Other	
ቋግሚት	Other	
ቋጥኝ	Other	
በሀኪም	Other	
በሀብቱ	Male	
በሀብትሽ	Female	
በለሳ	Other	
በለስ	Male	
በለው	Male	
በለጠ	Male	
በለጠች	Female	
በለጡ	Female	
በለጤ	Female	
በለጥሻቸው	Female	
በለጥሽ	Female	
በላተኛ	Other	
በላቸው	Male	
በላይ	Male	
በላይ ሁን	Male	
በላይ ነህ	Male	
በላይ ነሽ	Female	
በላይነህ	Male	
በልሁ	Male	
በልዩ	Female	
በልዩወርቅ	Female	
በልግ	Other	
በረሀ	Other	
በረሃ	Other	
በረህ	Unknown	
በረራ	Other	
በረት	Other	
በረንዳ	Other	
በረኛ	Other	
በረከተአብ	Male	
በረከት	Male	
በረክ	Other	
በረኸት	Male	
በረደድ	Other	
በረዳ	Male	
በረዶ	Other	
በረጋ	Other	
በረጋህልኝ	Male	
በሪ	Other	
በሪሁን	Male	
በሪዳ	Other	
በራሪ	Other	
በራኪ	Other	
በራኺ	Other	
በራዡ	Other	
በራዥ	Other	
በራፍ	Other	
በሬ	Other	
በሬሳ	Other	
በር	Other	
በርካ	Male	
በር ይሁን	Male	
በርሄ	Male	
በርሚል	Other	
በርሜል	Other	
በርሞሌ	Unknown	
በርሳ ሰዲ	Unknown	
በርበሬ	Other	
በርባን	Other	
በርቱማ	Other	
በርቱካ	Other	
በርታ	Male	
በርቶሎሜዎስ	Other	
በርናባስ	Male	
በርኖስ	Other	
በርጨቃ	Other	
በርጩማ	Other	
በሰጊድ	Other	
በሱ ፈቃድ	Male	
በስተርጅና	Other	
በስፋ ነሽ	Unknown	
በሶ	Other	
በሶ ብላ	Other	
በሹ	Other	
በሺር	Other	
በሻህ	Male	
በሻዳ	Other	
በሽሎ	Other	
በሽር	Male	
በሽታ	Other	
በቀለ	Male	
በቀለች	Female	
በቀሉ	Female	
በቀል	Other	
በቀልት	Other	
በቀት	Other	
በቁሙ	Other	
በቃሉ	Male	
በቆልት	Other	
በተሀ	Other	
በትረ	Male	
በትረማርያም	Male	
በትረስላሴ	Male	
በትረወርቅ	Male	
በትሩ	Male	
በትእዛዙ	Male	
በቸረር	Other	
በነበሩ	Male	
በኒአምር	Male	
በንቲ	Male	
በአሉ	Male	
በአካል	Male	
በኣሉ	Male	
በኣላት	Other	
በኣል	Other	
በእምነት	Both	
በእውቀቱ	Male	
በእውቀት	Other	
በእደ	Male	በዕደ
በኩረ	Male	
በኩረማርያም	Male	
በኩረብርሃን	Male	
በኩረፅዮን	Male	
በክሪ	Male	
በኩራይ	Male	
በኩር	Male	
በክሩ	Male	
በክሪ	Male	
በዘፈቀደ	Other	
በዙ	Both	
በዛ	Other	
በዛሽ	Female	
በዛወርቅ	Female	
በዝናሽ	Female	
በዛበህ	Don't Know	
በዛብህ	Male	
በዜ	Other	
በዝባዥ	Other	
በየነ	Male	
በየነች	Female	
በያን	Male	
በዬነ	Don't Know	
በይነ ትግብርት	Unknown	
በይን	Male	
በደሌ	Other	
በደል	Other	
በደኖ	Other	
በደዊ	Male	
በደዌ	Other	
በዲሳ	Other	
በዳኔ	Male	
በዳይ	Other	
በዳዳ	Male	
በድሉ	Male	
በድሏ	Female	
በድሩ	Male	
በድሪ	Male	
በድሪያ	Female	
በድን	Other	
በድአሶ	Male	
በድጋፍ	Other	
በጅሮንድ	Other	
በጊ	Other	
በጋ	Other	
በጋሻው	Male	
በጌምድር	Place	
በግ	Other	
በጎ	Other	
በጐ	Other	በጎ
በጣጢስ	Other	
በጨር	Other	
በጸሃ	Other	
በጽሃ	Male	
በጽሃሰናይ	Male	
በፈቃደ	Other	
በፈቃዱ	Male	
በፍርዱ	Male	
በፍታ	Other	
በኃይሉ	Male	
በኃይሏ	Female	
ቡሀቃ	Other	
ቡሄ	Other	
ቡሆ	Don't Know	
ቡሊ	Other	
ቡላ	Other	
ቡሌ	Other	
ቡልቲ	Male	
ቡልቻ	Male	
ቡልጋ	Place	
ቡልቶ	Male	
ቡራቡሬ	Other	
ቡራኬ	Other	
ቡሬ	Other	
ቡርቃ	Male	
ቡሰር	Male	
ቡሰይሪ	Male	
ቡሴይር	Male	
ቡሽራ	Male	
ቡቃያ	Other	
ቡቅሬ	Other	
ቡባሞ	Don't Know	
ቡቱቶ	Other	
ቡታ	Other	
ቡታ ጅራ	Place	
ቡችላ	Other	
ቡችሎች	Other	
ቡና	Other	
ቡናማ	Other	
ቡንኝ	Other	
ቡአ	Other	
ቡከን	Other	
ቡይት	Other	
ቡድን	Other	
ቡጢ	Other	
ቢሆነኝ	Male	
ቢለዋ	Other	
ቢልልኝ	Male	
ቢልባህ	Other	
ቢምረው	Male	
ቢረሳ	Male	
ቢረዳ	Male	
ቢረጋ	Male	
ቢሻው	Male	
ቢራ	Other	
ቢራቢሮ	Other	
ቢራቱ	Male	
ቢርመጂ	Male	
ቢሰውር	Male	
ቢሻሽ	Female	
ቢሾፍቱ	Place	
ቢቂላ	Male	
ቢተው	Male	
ቢተውልኝ	Male	
ቢትወደድ	Male	
ቢነጋ	Other	
ቢዘን	Other	
ቢያዝን	Other	
ቢያድጉ	Other	
ቢያድግልኝ	Male	
ቢጫ	Other	
ቢፍቱ	Male	
ባሃር	Other	
ባሃዳድ	Other	
ባህረ	Male	
ባህረ ነጋሽ	Place	
ባህረኛ	Other	
ባህር	Other	
ባህር ማሽላ	Unknown	
ባህር ነጋሽ	Place	
ባህር ዳር	Place	
ባህርያት	Other	
ባህርይ	Other	
ባህታ	Male	ባሕታ
ባህታዊ	Other	
ባህሮም	Male	
ባለ	Other	
ባለ ሟል	Other	
ባለ እኩል	Other	
ባለ እጅ	Other	
ባለስልጣን	Other	
ባለቤት	Other	
ባለኩል	Other	
ባለጅ	Other	
ባሊላ	Other	
ባላ	Other	
ባላምበራስ	Unknown	
ባላምባራስ	Male	
ባላባታዊ	Other	
ባላባታዊነት	Other	
ባላባት	Other	
ባላንጋራ	Other	
ባላንጣ	Other	
ባላገር	Other	
ባላጋራ	Other	
ባሌ	Other	
ባል	Other	
ባል ሟል	Other	
ባልቴት	Other	
ባልትና	Other	
ባልቻ	Male	
ባልቾ	Other	
ባልንጀራ	Other	
ባልንጅራ	Other	
ባልከው	Male	
ባልደረባ	Other	
ባልደራስ	Other	
ባልዲ	Other	
ባልዳ	Other	
ባልጭት	Other	
ባሕረ	Male	ባህረ
ባሕረስላሴ	Male	ባህረስላሴ
ባሕረጥበብ	Male	ባህረጥበብ
ባሕሪ	Male	ባህሪ
በሕርነሽ	Female	በህርነሽ
ባሕሯ	Female	ባህሯ
ባሕሩ	Male	ባህሩ
ባራኪ	Male	
ባምቡሌ	Other	
ባምነው	Male	
ባረንቱ	Other	
ባሩዳ	Other	
ባሩድ	Other	
ባሪእ	Other	
ባሪያ	Other	
ባሪያዎች	Other	
ባራቱማ	Other	
ባሬታ	Other	
ባሬንቱ	Other	
ባርነት	Other	
ባርኔጣ	Other	
ባርካ	Other	
ባርያ	Other	
ባሮች	Other	
ባሳዝነው	Male	
ባስሊኒ	Other	
ባስልዮስ	Male	
ባሻ	Male	
ባሻገር	Other	
ባቅላባ	Other	
ባቆየች	Female	
ባቡ	Other	
ባቡር	Other	
ባቢሌ	Place	
ባተሌ	Other	
ባቲ	Place	
ባት	Other	
ባት ወሰን	Unknown	
ባት ይርጉ	Unknown	
ባት ይዋሉ	Unknown	
ባኒ	Other	
ባና	Other	
ባንት አየሁ	Male	ባንታየሁ
ባንት ይርጉ	Male	
ባንት ይወሰን	Male	
ባንት ይዋሉ	Male	
ባንች ይርጉ	Female	
ባንች ይርጋ	Female	ባንቺይርጋ
ባንቺአምላክ	Female	
ባንክ	Don't Know	
ባንዲራ	Other	
ባንዳ	Other	
ባንጃው	Male	
ባእዳን	Other	
ባእድ	Other	
ባካሉ	Male	
ባኮ	Other	
ባኰ	Place	
ባዕላይ	Other	
ባዘቶ	Male	
ባዙቃ	Other	
ባዚን	Male	
ባዝራ	Other	
ባዩ	Male	
ባዩሽ	Female	
ባዪ	Both	
ባየቻ	Male	
ባዩልኝ	Male	
ባዬ	Male	
ባያብል	Male	
ባዩአለም	Male	
ባይህ	Male	
ባደገች	Female	
ባደገ	Male	
ባይለየኝ	Male	
ባይሩ	Don't Know	
ባይሳ	Male	
ባይተዋር	Other	
ባይነሳኝ	Male	
ባይንሳኝ	Male	
ባይከዳኝ	Male	
ባደንጋ	Don't Know	
ባደግ	Male	
ባዲያብ	Don't Know	
ባድማ	Other	
ባዶ	Other	
ባጥ	Other	
ባፈና	Female	
ቤለማ	Other	
ቤላማ	Unknown	
ቤላም	Other	
ቤሳ	Other	
ቤተ	Both	
ቤተልሄም	Female	
ቤተመድህን	Male	
ቤተስላሴ	Male	
ቤተ ሰብ	Other	
ቤተማርያም	Both	
ቤት	Other	
ቤቶች	Other	
ቤኛ	Male	
ቤካ	Other	
ቤዛ	Both	
ቤዛነሽ	Female	
ቤዛቸው	Both	
ቤዛወርቅ	Both	
ቤዛዊት	Female	
ቤዶ	Other	
ብሄረ ሰብ	Other	
ብሄረ ሰቦች	Other	
ብሄረ ስብ	Unknown	
ብሄረተኛ	Other	
ብሄረተኛነት	Other	
ብሄራዊ	Other	ብሔራዊ
ብሄር	Other	ብሔር
ብሄርነት	Other	
ብሄሮች	Other	
ብለሽ	Other	
ብላሽ	Other	
ብላታ	Other	
ብላቴና	Other	
ብላቴን	Other	
ብሌን	Female	
ብል	Other	
ብልሀተኛ	Other	
ብልሀት	Other	
ብልሃተኛ	Other	
ብልሃት	Other	
ብልህ	Other	
ብልማ	Other	
ብልሽት	Other	
ብልቃጥ	Other	
ብልብላ	Other	
ብልት	Other	
ብልኮ	Other	
ብልጭታ	Other	
ብሎን	Other	
ብሔራዊ	Other	
ብሔር	Other	
ብረታ ብረት	Other	
ብረት	Other	
ብረት ለበስ	Other	
ብሩ	Male	
ብሩህ	Male	
ብሩህአለም	Male	
ብሩሽ	Other	
ብሩኬ	Male	
ብሩክ	Male	
ብሩክታዊት	Female	
ብሩክት	Female	
ብሪቱ	Female	
ብሪንጥ	Other	
ብራና	Other	
ብራኳ	Other	
ብሬ	Other	
ብር	Other	
ብር ነሽ	Female	
ብርሀነ	Male	
ብርሃነ	Male	
ብርሃነሕይወት	Male	
ብርሃነመስቀል	Male	
ብርሃነስላሴ	Male	
ብርሃነየሱስ	Male	
ብርሃኑ	Male	
ብርሃኔ	Both	
ብርሃን	Both	
ብርሌ	Other	
ብርቂቱ	Female	
ብርቄ	Both	
ብርቁ	Male	
ብርቅ	Other	
ብርቅ ነሽ	Female	
ብርቅነሽ	Female	
ብርብራ	Other	
ብርብር	Other	
ብርቱ	Other	
ብርቱካን	Female	
ብርታት	Other	
ብርንዶ	Other	
ብርኩማ	Other	
ብርክቲ	Female	
ብርክት	Other	
ብርዛፍ	Male	
ብርዝ	Other	
ብርዞ	Other	
ብርዬ	Other	
ብርዳም	Other	
ብርድ	Other	
ብርጩፋ	Other	
ብርጭቆ	Other	
ብሳና	Other	
ብስለት	Other	
ብስል	Other	
ብስል ተቀሊል	Unknown	
ብስራተ	Both	ብሥራተ
ብስራት	Both	ብሥራት
ብስኩቴ	Female	
ብስኩት	Female	
ብሶት	Other	
ብሽሽት	Other	
ብቃት	Other	
ብቅል	Other	
ብብት	Other	
ብታ ጅራ	Don't Know	
ብትወጣ	Other	
ብቸሬ	Other	
ብቸና	Place	
ብቸኛ	Other	
ብናኝ	Other	
ብንያሚን	Male	
ብንያም	Male	
ብእር	Other	
ብኩርና	Other	
ብኩን	Other	
ብዙ	Both	
ብዙ ነህ	Male	
ብዙ ነሽ	Female	
ብዙሃን	Other	
ብዙነህ	Male	
ብዙአየሁ	Both	
ብዙወርቅ	Both	
ብዙዓለም	Both	
ብዝበዛ	Other	
ብዝባዛ	Other	
ብድር	Other	
ብጉር	Other	
ብጉንጅ	Other	
ብጡል	Male	
ብጤ	Other	
ብጹዕን	Male	
ብጽአት	Female	
ብጽእት	Female	ብፅዕት
ብጽእቲ	Female	ብፅዕቲ
ቦለቄ	Other	
ቦለቅያ	Other	
ቦላሌ	Other	
ቦሌ	Other	
ቦልቦሌ	Other	
ቦረና	Other	
ቦረን	Other	
ቦረንትቻ	Other	
ቦረዳ	Other	
ቦሩ	Other	
ቦራ	Other	
ቦሬ	Other	
ቦርሳ	Other	
ቦርዴ	Other	
ቦርጌ	Male	
ቦርጋ	Male	
ቦርጭ	Other	
ቦሰና	Female	
ቦቃ	Other	
ቦቆጂ	Place	
ቦታ	Other	
ቦና	Other	
ቦንሳ	Other	
ቦንዳ	Other	
ቦንጋ	Male	
ቦኩ	Other	
ቦካ	Other	
ቦኮ	Other	
ቦዘና	Other	
ቦዘኔ	Other	
ቦዘኔነት	Other	
ቦይና	Other	
ቦዲቲ	Unknown	
ቦዲቴ	Other	
ቦዳ	Other	
ቦጄ	Other	
ቦጋለ	Male	
ቦጋለች	Female	
ቦጌ	Both	
ቦጐስ	Don't Kno	ቦጎስ
ቧ ያለው	Male	
ቧንቧ	Other	
ቧያለው	Male	
ቧጋች	Don't Know	
ቨርሙጥ	Other	
ተሀድሶ	Other	
ተሁለደሬ	Don't Know	
ተለዋዋጭ	Other	
ተሊላ	Male	
ተላሌ	Male	
ተላይነህ	Male	
ተላላኪ	Other	
ተላላፊ	Other	
ተልአል	Male	
ተልእል	Other	
ተልእኮ	Other	
ተመልሶ	Other	
ተመልካች	Other	
ተመሳሳይ	Other	
ተመስገን	Male	
ተመናይ	Other	
ተመን	Other	
ተመኙ	Other	
ተመኙሽ	Female	
ተመኝ	Other	
ተሙን	Other	
ተማም	Male	
ተማሪዎች	Other	
ተምር	Other	
ተምቤን	Other	
ተምትሜ	Other	
ተምች	Other	
ተምኔታዊ	Other	
ተምኔታዊነት	Other	
ተምኔት	Other	
ተሟጋች	Other	
ተረበኛ	Other	
ተረብ	Other	
ተረተር	Other	
ተረኛ	Other	
ተረፈ	Male	
ተረፈች	Female	
ተረፉ	Other	
ተራ	Other	
ተራማጅ	Other	
ተራራማ	Other	
ተራቢ	Other	
ተራዳ	Other	
ተራድኦ	Other	
ተርብ	Other	
ተርታ	Other	
ተርፉ	Other	
ተርፋ	Other	
ተርፋሳ	Other	
ተሰሎንቄ	Don't Know	
ተሰማ	Male	
ተሰራ	Male	
ተሰራች	Female	
ተሰነይ	Other	
ተሰፋ ሁን	Male	
ተሳቢ	Other	
ተሳትፎ	Other	
ተስማሚ	Other	
ተስቦ	Other	
ተስፉ	Male	
ተስፋ	Male	
ተስፋስላሴ	Male	
ተስፋኪሮስ	Male	
ተስፋዓለም	Male	
ተስፋጊዮርጊስ	Male	
ተስፋጽዮን	Male	
ተስፋጋብር	Male	
ተስፋ የሱስ	Male	
ተስፋ የስ	Male	
ተስፋ-ሁን	Male	
ተስፋ-ቢስ	Other	
ተስፋ-ነሽ	Female	ተስፋዬነሽ
ተስፋው	Male	
ተስፋዝጊ	Other	ተስፋእዝጊ
ተስፋየስ	Male	
ተስፋዬ	Male	
ተስፋይ	Male	
ተስፍ	Other	
ተስፍዬ	Male	
ተሻለ	Other	
ተሻገር	Male	
ተሽከርካሪ	Other	
ተሽከርካሪዎች	Don't Know	
ተሾመ	Male	
ተሾመች	Female	
ተቀባ	Other	
ተቀባሽ	Female	
ተቀባይ	Other	
ተቀታ	Other	
ተቀናቃኝ	Other	
ተቀዳ	Male	
ተቀዳሚ	Other	
ተቀጥላ	Other	
ተቃዋሚ	Other	
ተቃውሞ	Other	
ተቆጣጣሪ	Other	
ተቋመ	Female	
ተቋመወርቅ	Female	
ተቋም	Female	
ተበዝባዥ	Other	
ተበዳሪ	Other	
ተበዳይ	Other	
ተበርህ	Male	
ተባባሪ	Other	
ተባእታይ	Other	
ተባእት	Other	
ተባይ	Other	
ተቻለ	Other	
ተነቃናቂ	Other	
ተነፋነፍ	Other	
ተናሳሂ	Other	
ተናኘ	Female	
ተናኘወርቅ	Female	
ተናካሽ	Other	
ተናጋሪ	Other	
ተናጠል	Other	
ተንቀሳቃሽ	Other	
ተንኮለኛ	Other	
ተንኮል	Other	
ተንዳሆ	Other	
ተአምረ	Male	
ተአምሩ	Male	
ተአምራት	Male	
ተአምር	Male	
ተአበኛ	Don't Know	
ተአብ	Other	
ተከላካይ	Other	
ተከራካሪ	Other	
ተከሳሽ	Other	
ተከስተ	Male	
ተከስተብርሃን	Male	
ተከስት	Male	
ተከተል	Male	
ተከታይ	Other	
ተከኢ	Male	
ተከዜ	Place	
ተኪ	Other	
ተኪኤ	Male	
ተካ	Male	
ተካልኝ	Male	
ተካበ	Male	
ተካበች	Female	
ተካነች	Female	
ተካፋይ	Other	
ተካቸው	Male	
ተካበወርቅ	Both	
ተካች	Female	
ተካዬ	Male	
ተኬ	Male	
ተክለ	Male	
ተክለስላሴ	Male	
ተክለሰንበት	Male	
ተክለአረጋይ	Male	
ተክለአብ	Male	
ተክለእዝጊ	Male	
ተክለወልድ	Male	
ተክለወይን	Male	
ተክለወይኒ	Female	
ተክለዮሐንስ	Male	
ተክለጊዮርጊስ	Male	
ተክለፃዲቅ	Male	
ተክለፅዮን	Male	
ተክለሃዋርያት	Male	
ተክለማርያም	Male	
ተክለብርሃን	Male	
ተክለኃይማኖት	Male	
ተክለአረጋዊ	Male	
ተክሉ	Male	
ተክሊል	Other	
ተክላይ	Male	
ተክሌ	Male	
ተክል	Don't Know	
ተክኤ	Male	
ተኮላ	Male	
ተኸርቁት	Don't Know	
ተኽላይ	Male	
ተወልደ	Male	
ተወካይ	Other	
ተወዲዳ	Other	
ተወዳዳሪ	Other	
ተወዳዳሪዎች	Other	
ተዋህዶ	Other	
ተዋበች	Female	
ተዋጊ	Other	
ተውህቦ	Other	
ተውላጠ ስም	Other	
ተውሳከ ግስ	Other	
ተውሳካም	Other	
ተውሳክ	Other	
ተውኔት	Other	
ተውፊቅ	Male	
ተዘራ	Male	
ተዘዋዋሪ	Other	
ተዝካር	Other	
ተደራቢ	Other	
ተደነቀ	Male	
ተደጋጋሚ	Other	
ተድላ	Male	
ተድባበ	Unknown	
ተድባብ	Unknown	
ተጂ	Male	
ተጂባ	Don't Know	
ተገኔ	Male	
ተገንጣይ	Other	
ተገኘ	Male	
ተገኘወርቅ	Female	
ተገኙ	Other	
ተገኝ	Male	
ተገድራ	Other	
ተጋዳይ	Other	
ተጌጠ	Other	
ተግሳጽ	Other	
ተግባረ እድ	Other	
ተግባሩ	Male	
ተግባር	Other	
ተጠሪ	Other	
ተጠራጣሪ	Other	
ተጠቃሚ	Other	
ተጠባባቂ	Other	
ተጠያቂ	Other	
ተጨማሪ	Other	
ተጨቋኝ	Other	
ተጨባጭ	Other	
ተጫነ	Male	
ተጻራሪ	Other	
ተጽእኖ	Other	
ተፈሪ	Male	
ተፈራ	Male	
ተፈራወርቅ	Male	
ተፈጥሮ	Other	
ተፍኪ	Place	
ቱሁኔ	Female	
ቱለማ	Other	
ቱሉ	Male	
ቱሉ ቦሎ	Place	
ቱሉማ	Other	
ቱልቱላ	Other	
ቱልት	Other	
ቱማታ	Other	
ቱምሳ	Other	
ቱሩፋት	Female	
ቱሬ	Male	
ቱቢት	Don't Know	
ቱባ	Other	
ቱቻ	Other	
ቱከምቢያ	Other	
ቱፈር	Other	
ቱፋ	Male	
ቱፍታ	Other	
ቲመርጋ	Male	
ቲማቲም	Other	
ቲባ	Other	
ቲያትር	Other	
ቲዮብስታ	Other	
ታመነች	Female	
ታህሳስ	Other	
ታህታይ	Other	
ታላላቅ	Other	
ታመነ	Male	
ታማኝ	Male	
ታምሩ	Male	
ታምሪያለሽ	Other	
ታምራት	Male	
ታረቀ	Male	
ታረቀች	Female	
ታረቀኝ	Male	
ታሪኩ	Male	
ታሪካዊ	Other	
ታሪክ	Male	
ታሪኳ	Female	
ታሲሳ	Other	
ታቦር	Male	
ታቦት	Other	
ታታሪ	Other	
ታች በሌ	Other	
ታኒካ	Other	
ታንኳ	Other	
ታንጉት	Female	
ታከለ	Male	
ታከለልን	Other	
ታከለልኝ	Other	
ታዛቢ	Other	
ታዛዥ	Other	
ታየ	Male	
ታየች	Female	
ታዬ	Male	
ታደለ	Male	
ታደለች	Female	
ታደመ	Male	
ታደሰ	Male	
ታደሰች	Female	
ታደስች	Female	
ታዲሽ	Other	
ታዳጊ	Other	
ታዴዋስ	Male	
ታዴዎስ	Male	
ታጀበ	Male	
ታገል	Male	
ታጋሽ	Other	
ታጋይ	Other	
ታጠረ	Other	
ታጠቅ	Male	
ታፈረ	Male	
ታፈሰ	Male	
ታፈሰወርቅ	Male	
ታፈሰች	Female	
ታፈሱ	Female	
ታፋ	Other	
ታፍላ	Other	
ቴምብር	Other	
ቴሶ	Other	
ቴዎድሮስ	Male	
ቴዎዶስዮስ	Unknown	
ቴዎዶድዮስ	Don't Know	
ቴዎፍሎስ	Male	
ት/ቤት	Other	
ትሁኔ	Female	
ትልም	Other	
ትምህርተ	Other	
ትምህርት	Other	ትምሕርት
ትምባሆ	Other	
ትምክህተኛነት	Other	
ትምክህት	Other	
ትሁት	Both	
ትህትና	Both	
ትልቅሰው	Male	
ትሩፋት	Female	
ትራስ	Female	
ትራፊ	Other	
ትርሃስ	Female	
ትርሲት	Female	
ትርስእት	Other	
ትርንጐ	Female	
ትርኪ ምርኪ	Other	
ትርካሶ	Other	
ትርጁማን	Male	
ትርጉም	Other	
ትርጓሜ	Other	
ትርፍነህ	Male	
ትርፍነሽ	Female	
ትርፉ	Male	
ትርፌ	Female	
ትርፍ	Other	
ትርፍራፊ	Other	
ትርፏ	Other	
ትሰሚያለሽ	Female	
ትሰሜ	Female	
ትሳሴ	Other	
ትስሚያለሽ	Female	
ትስሜ	Female	
ትስፍህቴ	Female	
ትስፍህት	Female	
ትበርህ	Female	
ትበይን	Other	
ትቢያ	Other	
ትብቃ	Female	
ትብለጽ	Female	
ትብለጥ	Female	
ትብብር	Other	
ትችት	Other	
ትኋን	Other	
ትንሣኤ	Both	
ትንሳኤ	Both	ትንሣኤ
ትንቅንቅ	Other	
ትንቢት	Both	
ትንተና	Other	
ትንታግ	Other	
ትንኝ	Other	
ትንፋሽ	Other	
ትንፋገም	Other	
ትንፋገን	Unknown	
ትእዛዙ	Male	ትዛዙ
ትእዛዝ	Other	
ትእይንት	Other	
ትእግስት	Both	ትዕግስት
ትእግስቱ	Male	ትዕግስቱ
ትእግስቴ	Both	ትዕግስቴ
ትዕበ	Male	
ትኩ	Other	
ትኩሳት	Other	
ትኩዬ	Other	
ትክትክ	Other	
ትክክለኛ	Other	
ትውልድ	Other	
ትውፊቅ	Don't Know	
ትዛዙ	Male	ትዕዛዙ
ትዝታ	Both	
ትደነቂያለሽ	Female	
ትደነቅ	Female	
ትደንቂያለሽ	Other	
ትዳር	Other	
ትድባበ	Other	
ትድባብ	Other	
ትገኛ	Unknown	
ትጉህ	Other	
ትጉባ	Other	
ትግል	Other	
ትግበርት	Unknown	
ትጥቅ	Other	
ትፈራ	Other	
ትፋት	Other	
ትፍስህተ	Female	
ትፍስህት	Female	
ቶለሳ	Male	
ቶላ	Male	
ቶልቻ	Male	
ቶሎሳ	Male	
ቶማስ	Male	
ቶበተኛ	Other	
ቶፊቅ	Male	
ቶፊክ	Male	
ቶጋ	Male	
ቶፋ	Other	
ቸሀ	Other	
ቸልተኛ	Other	
ቸልታ	Other	
ቸሩ	Male	
ቸርቻሪ	Other	
ቸርነት	Male	
ቸሬ	Male	
ቸነፈር	Other	
ቸኮለ	Other	
ቸኮል	Male	ቸኰል
ቻለው	Male	
ቻርልስ	Male	foreign name
ችሎታ	Male	
ችሎት	Other	
ችርቻሮ	Other	
ችቦ	Other	
ችካል	Other	
ችኮላ	Other	
ችግረኛ	Other	
ችግሬ	Other	
ችግር	Other	
ችግኝ	Other	
ችፌ	Other	
ችፍርግ	Other	
ኃብተ	Male	
ኃዘን	Other	
ኃይለ	Male	
ኃይለልዑል	Male	
ኃይለመለከት	Male	
ኃይለመስቀል	Male	
ኃይለሚካኤል	Male	
ኃይለማርያም	Male	
ኃይለማርቆስ	Male	
ኃይለሥላሴ	Male	
ኃይለአብ	Male	
ኃይለአእዝጊ	Male	
ኃይለየሱስ	Male	
ኃይለድንግል	Male	
ኃይለገብርኤል	Male	
ኃይለጊዬርጊስ	Male	
ኃይለጽዮን	Male	
ኃይሎም	Male	
ኃይለምርያም	Male	
ኃይሉ	Male	
ኃይሌ	Male	
ኃይል	Other	
ኃይማኖት	Both	
ኅሩይ	Male	
ኅዙናን	Other	
ኋላ	Other	
ነሀሴ	Other	
ነሀስ	Other	
ነህምያ	Don't Know	
ነመራ	Male	
ነሚር	Don't Know	
ነሲቡ	Male	
ነሲብ	Male	
ነስሩ	Male	
ነስሩዲን	Male	
ነስር	Other	
ነቀምቴ	Place	
ነቀርሳ	Other	
ነቀዝ	Other	
ነቁጥ	Other	
ነቂስ	Other	
ነቅንቅ	Other	
ነቅአ ጥበብ	Male	
ነቅእ ጥበብ	Don't Know	
ነበልባል	Other	
ነቢሃ	Male	
ነበበ	Other	
ነበበች	Other	
ነቢብ	Male	
ነቢየ	Male	
ነቢየልዑል	Male	
ነቢዩ	Male	
ነቢያት	Male	
ነቢይ	Other	
ነባራዊ	Other	
ነባር	Other	
ነባቢት	Other	
ነባይ	Unknown	
ነብራይ	Don't Know	
ነብር	Other	
ነብሮ	Other	
ነብየ	Other	
ነብያት	Male	
ነት	Don't Know	
ነነዌ	Other	
ነአሚ	Female	
ነኢማ	Female	
ነአኩቶ ለአብ	Place	
ነኢብ	Other	
ነካሽ	Other	
ነክ	Other	
ነዋሪ	Other	
ነዋየማርያም	Male	
ነዋይ	Male	
ነዋይነሽ	Female	
ነዋሪዎች	Other	
ነውረኛ	Other	
ነዝናዛ	Other	
ነዲድ	Other	
ነዳይ	Other	
ነዳጅ	Other	
ነዶ	Other	
ነጂባ	Male	
ነጂብ	Male	
ነጃ	Male	
ነጃት	Female	
ነጆ	Place	
ነገ	Other	
ነገሌ	Place	
ነገሥት	Other	
ነገረ ሰሪ	Unknown	
ነገረ በላ	Other	
ነገረ ፈጅ	Other	
ነገር	Other	
ነገር በላ	Other	
ነገሮ	Other	
ነገሮች	Other	
ነገሰ	Other	
ነገስታት	Other	
ነገስት	Other	
ነገዎ	Male	
ነገደ	Male	
ነገደወርቅ	Both	
ነጋ	Male	
ነጋሪት	Other	
ነጋሲ	Male	
ነጋሳ	Male	
ነጋሴ	Male	
ነጋሽ	Male	
ነጋዴ	Other	
ነጋዴዎች	Other	
ነጋድራስ	Other	
ነጐዴ	Other	
ነጐድጓድ	Other	
ነጠረች	Other	
ነጠብጣብ	Other	
ነጣቂ	Other	
ነጥር	Other	
ነጥብ	Other	
ነጥቦች	Other	
ነጭ	Other	
ነጭናጫ	Other	
ነጮ	Other	
ነጸረ	Other	
ነጸብራቅ	Other	
ነጻ	Other	
ነጻነት	Both	
ነፊሳ	Female	
ነፋሲት	Other	
ነፋስ መውጫ	Other	
ነፋሻ	Other	
ነፍራቃ	Other	
ነፍሰ ገዳይ	Other	
ነፍሳት	Other	
ነፍስ	Other	
ነፍስ ወከው	Unknown	
ነፍስ ወከፍ	Other	
ነፍስ ገዳይ	Other	
ነፍሶ	Other	
ነፍጠኛ	Other	
ነፍጥ	Other	
ነፍጥ 	Other	
ኑማን	Other	
ኑረዲን	Male	
ኑሩ	Male	
ኑሪ	Male	
ኑሪያ	Male	
ኑር	Male	
ኑርሁሴን	Male	
ኑርሴቦ	Male	
ኑርአህመድ	Male	
ኑርአሊ	Male	
ኑርአይኔ	Male	
ኑርልኝ	Male	
ኑሮ	Other	
ኑኑ	Female	
ኑዛዜ	Male	
ኑፋቄ	Don't Know	
ኒማን	Don't Know	
ኒሻን	Male	
ኒቆዲሞስ	Male	
ኒነት	Don't Know	
ኒኮላስ	Male	
ኒያላ	Other	
ናሁ ሰናይ	Male	
ናሁሰናይ	Male	
ናሆም	Male	
ናላ	Other	
ናሙና	Other	
ናርዶስ	Both	
ናርጅ	Don't Know	
ናስ	Other	
ናስር	Male	
ናቄ	Other	
ናቅፋ	Other	
ናቡከደነጾር	Male	
ናትራ	Other	
ናትናኤል	Male	
ናኣድ	Male	
ናኦድ	Male	
ናዝራዊ	Male	
ናዝሬት	Place	
ናይዝጊ	Male	
ናደው	Male	
ናጂ	Don't Know	
ናጫ	Don't Know	
ኔሞ	Don't Know	
ንረዮ	Unknown	
ንርእዮ	Don't Know	
ንሰብሆ	Don't Know	
ንሴብሆ	Unknown	
ንስጥሮስ	Don't Know	
ንሽ	Don't Know	
ንቁ	Other	
ንቃቃት	Other	
ንቃተ ህሊና	Other	
ንቃት	Other	
ንቅሳት	Other	
ንቅናቄ	Other	
ንበርጋ	Other	
ንቢይ	Unknown	
ንባቡ	Male	
ንባብ	Other	
ንብ	Other	
ንብረት	Both	
ንኡስ	Other	
ንክ	Other	
ንዋየ	Male	
ንዋይ	Male	
ንዳደ	Other	
ንዳድ	Other	
ንዴት	Other	
ንድፈ	Other	
ንድፍ	Other	
ንጉማ	Male	
ንጉሠነልዩ	Other	
ንጉሤ	Male	
ንጉሩ	Other	
ንጉሰ	Male	
ንጉሱ	Male	
ንጉሳዊ	Other	
ንጉሳይ	Other	
ንጉሴ	Male	
ንጉስ	Male	
ንጋቱ	Male	
ንጋት	Male	
ንጋቷ	Female	
ንግስተ	Female	
ንግስተሳባ	Female	
ንግስቲ	Female	
ንግስት	Female	
ንግድ	Other	
ንግግር	Other	
ንጣፍ	Other	
ንጥረ	Other	
ንጥር	Other	
ንጥቂያ	Other	
ንጹሄ	Other	
ንጹህ	Both	
ንጽህና	Other	
ንፉግ	Other	
ንፍሮ	Other	
ንፍቀ	Other	
ንፍቅ	Other	
ንፍታሌም	Other	
ንፍጥ	Other	
ንፍፊት	Other	
ኖህ	Male	
ኖላዊ	Male	
ኖራ	Other	
ኖባ	Other	
ኞኞ	Male	
አሀዝ	Other	
አሀዱ	Male	አሐዱ
አሁን	Other	
አህሎት	Other	
አህመዲን	Male	
አህመድ	Male	
አህሙ	Other	
አህያ	Other	
አህያ ፈጅ	Unknown	
አህደሮም	Other	
አህጉራዊ	Other	
አህጉር	Other	
አህጽሮተ	Other	
አለ	Other	
አለላ	Other	
አለሌ	Other	
አለልኝ	Male	
አለሎ	Other	
አለሙ	Male	
አለሙሽ	Female	
አለሚ	Other	
አለማሁ	Male	አለማየሁ
አለማሽ	Female	ዓለማሽ
አለማየሁ	Male	
አለም	Both	ዓለሙ
አለምንህ	Unknown	
አለባቸው	Male	
አለብላቢት	Other	
አለነ	Male	
አለንጋ	Other	
አለኝታ	Male	
አለካክ	Other	
አለኸኝ	Male	
አለዊ	Male	
አሉ ባልታ	Other	
አሉላ	Male	
አሉብልታ	Other	
አሉታ	Other	
አሊ	Male	
አሊ ሚራህ	Male	
አሊ አምረው	Male	
አሊጋዝ	Male	
አሊማ	Female	
አሊዩ	Male	
አሊያ ነሽ	Female	
አሊፍ	Unknown	
አላማጣ	Place	
አላምረው	Male	
አላምንህ	Male	
አላሰቡ	Other	
አላባ	Place	
አላባ ቁሊቶ	Place	
አላዪ	Other	
አላድ	Other	
አሌፍ	Male	
አል አሚን	Unknown	
አል አሜን	Unknown	
አልማማው	Other	
አልማው	Male	
አልማዝ	Female	
አልሞት ባይ	Other	
አልሞት ባይ 	Other	
አልቃሽ	Other	
አልቅት	Other	
አልቅትት	Unknown	
አልባ	Other	
አልባሳት	Other	
አልባቤ	Unknown	
አልባብ	Other	
አልባነት	Other	
አልብቤ	Other	
አልቦ	Other	
አልቦ 	Other	
አልቲት	Other	
አልታሽ	Other	
አልታየ	Female	
አልታዩ	Female	
አልታዬ	Female	
አልታዬወርቅ	Female	
አልትዩ	Unknown	
አልአዛር	Male	
አልዩ	Don't Know	
አልጋ	Other	
አልጋ ነሽ	Female	
አልጋነሽ	Female	
አልጣሽ	Female	
አልጫ	Other	
አሐዱ	Male	
አመሀ የስ	Male	
አመሄ	Don't Know	
አመለ	Female	
አመለወርቅ	Female	
አመለኛ	Other	
አመለጥ	Other	
አመልሳ	Other	
አመልካች	Other	
አመሏ		
አመራር	Other	
አመራሮ	Other	
አመርጋ	Other	
አመተሚካኤል	Male	
አመተማርያም	Female	
አመተወልድ	Male	
አመረጽዮን	Female	
አመቱ	Male	
አመት	Other	
አመነ	Male	
አመንቴ	Male	
አመኑ	Male	
አመንሲሳ	Unknown	
አመንሲስ	Don't Know	
አመንዝራ	Other	
አመክሮ	Other	
አመዘነች	Female	
አመዳም	Other	
አመዳይ	Other	
አመዴ	Male	
አመድ	Other	
አመጣጥ	Other	
አመጸኛ	Other	
አመጽ	Other	
አሙካ	Other	
አሚር	Male	
አሚነ	Don't Know	
አሚኑ	Don't Know	
አሚና	Female	
አሚን	Male	
አማላጅ	Other	
አማረ	Male	
አማረች	Female	
አማራ	Other	
አማራጭ	Other	
አማሬሳ	Other	
አማርኛ	Other	
አማት	Other	
አማች	Other	
አማኑኤል	Male	
አማን	Male	
አማአክለ	Unknown	
አማእከለ	Other	
አማከለች	Female	
አማካሪ	Other	
አማካይ	Other	
አሜን	Both	
አሜከላ	Other	
አምሀ	Male	
አምሀ የስ	Male	
አምሄ	Unknown	
አምለሰት	Female	
አምላኪ	Other	
አምላክ	Male	
አምላክነት	Other	
አምልኮ	Other	
አምልኮት	Other	
አምራች	Other	
አምሳለ	Both	
አምሳለች	Female	
አምሳሉ	Male	
አምሳያ	Other	
አምስተኛ	Other	
አምስት	Other	
አምሾ	Other	
አምበሉ	Other	
አምበል	Other	
አምበርበር	Don't Know	
አምበርብር	Male	
አምበዛ	Unknown	
አምቡላ	Don't Know	
አምባ ላይ	Place	
አምባ ላጌ	Place	
አምባ ቄጦ	Unknown	
አምባ ገነን	Other	
አምባ ገነንነት	Other	
አምባ ጓሮ	Other	
አምባር	Other	
አምባሻ	Other	
አምባቸው	Male	
አምባው	Male	
አምባዛ	Other	
አምባዬ	Male	
አምቦ	Other	
አምና	Other	
አምደ	Male	ዐምደ
አምደ የሱስ	Male	
አምደሚካኤል	Male	
አምዴ	Male	
አምድ	Other	
አምዶም	Male	
አሞሌ	Other	
አሞራ	Other	
አሞተ ቢስ	Other	
አሞተ ኩሩ	Other	
አሞት	Other	
አሞጭ	Don't Know	
አሞጽ	Other	
አሠጌ	Male	
አሥረስ	Male	
አረሆ	Other	
አረመኔ	Other	
አረማሞ	Other	
አረማዊ	Other	
አረም	Other	
አረሩ	Other	
አረስእት	Unknown	
አረቄ	Other	
አረቦ	Other	
አረቦን	Other	
አረንዛ	Other	
አረንጓዴ	Other	
አረዳ	Other	
አረጋ	Male	
አረጋሽ	Female	
አረጋኸኝ	Male	
አረጋኽኝ	Male	
አረጋዊ	Male	
አረጋይ	Male	
አረግ	Female	
አረጓ	Female	
አረጣ	Unknown	
አረፈ	Male	
አረፈ ኣይኔ	Male	አረፈዓይኔ
አረፋ	Other	
አሩሲ	Other	
አሩት	Other	
አራሙቻ	Other	
አራሚ	Other	
አራራይ	Other	
አራስ	Other	
አራሽ	Other	
አራቢ	Other	
አራባ	Other	
አራተኛ	Other	
አራት	Other	
አራዊት	Other	
አራዳ	Other	
አራጅ	Other	
አራጌ	Male	
አራጋው	Male	
አራጣ	Other	
አሬራ	Other	
አሬው	Other	
አርማ	Other	
አርምሞ	Other	
አርምዴ	Other	
አርሲ	Other	
አርስጣጣሊስ	Other	
አርሶ አደር	Other	
አርሽም	Other	
አርበኛ	Other	
አርበኞች	Other	
አርቢ	Other	
አርባ	Other	
አርባ ምንጭ	Place	
አርባጫ	Other	
አርብ	Other	
አርነት	Other	
አርአያ	Male	
አርእስት	Other	
አርዌ	Other	
አርያም	Female	
አርዮስ	Other	
አርድእት	Other	
አርጃኖ	Other	
አርጆ	Other	
አርጋኖን	Other	
አርጋው	Male	
አርጐባ	Place	
አርጩሜ	Other	
አርፍጮ	Other	
 አሮን	Male	
አሮንቃ	Other	
አሮጊት	Other	
አሮጌ	Other	
አሰለጥ	Other	
አሰለፈች	Female	
አሰለፍ	Female	
አሰላ	Other	
አሰልፍ	Other	
አሰማ	Other	
አሰማኸኝ	Male	
አሰማኽኝ	Male	
አሰሜ	Male	
አሰሪ	Other	
አሰራት	Both	
አሰሳ	Other	
አሰስ ገሰስ	Other	
አሰበ	Male	
አሰበ ተፈሪ	Place	
አሰብ	Place	
አሰቦ	Unknown	
አሰቦት	Unknown	
አሰን	Unknown	
አሰንዳቦ	Unknown	
አሰገሰች	Unknown	
አሰገደች	Female	
አሰጋሽ	Female	
አሰጋኸኝ	Male	
አሰግደው	Male	
አሰግድ	Male	
አሰፉ	Female	
አሰፋ	Male	
አሰፋሽ	Female	
አሰፋች	Female	
አሲምባ	Other	
አሲዳም	Other	
አሳ	Other	
አሳልፍ	Other	
አሳመረ	Other	
አሳመነች	Female	
አሳማ	Other	
አሳምነው	Male	
አሳረኛ	Other	
አሳሽ	Other	
አሳብ	Other	
አሳታሚ	Other	
አሳቻ	Other	
አሳዝነው	Male	
አሳየኸኝ	Male	
አሳየኽኝ	Unknown	
አሳይታ	Place	
አሳዳሪ	Other	
አሳዳጅ	Other	
አሳዳጊ	Other	
አሳፋሪ	Other	
አስለቃሽ	Other	
አስላ	Unknown	
አስልቃሽ	Unknown	
አስልፍ	Unknown	
አስመላሽ	Male	
አስመረት	Both	
አስመሪና	Other	
አስመራ	Other	
አስመሮም	Male	
አስመነች	Female	
አስመጭና	Other	
አስማ	Male	
አስማማው	Male	
አስማረ	Male	
አስማተኛ	Other	
አስማት	Other	
አስማይት	Female	
አስሜ	Unknown	
አስምራቸው	Male	
አስረሳኸን	Other	
አስረሳኸኝ	Male	
አስረሴ	Male	
አስረስ	Male	
አስረኛ	Other	
አስረጅ	Other	
አስረግደው	Male	
አስራተ	Both	ዐስራተ
አስራቴ	Both	
አስራት	Both	አሥራት
አስራጋ	Male	
አስር	Other	
አስቦት	Other	
አስተላላፊ	Other	
አስተርእዮ	Other	
አስተርጓሚ	Other	
አስተሳሰብ	Other	
አስተባባሪ	Other	
አስተናባሪ	Other	
አስተናጋጅ	Other	
አስተናግር	Other	
አስተካካይ	Other	
አስተዋይ	Male	
አስተዋጽኣ	Other	
አስተዋጽኦ	Other	
አስተያየት	Other	
አስተዳር	Other	
አስተዳደር	Other	
አስተዳደግ	Other	
አስተዳዳሪ	Company	
አስተድዳሪ	Unknown	
አስታ	Other	
አስታማሚ	Other	
አስታጥቄ	Male	
አስቴር	Female	
አስትላላፊ	Unknown	
አስትማሚዎች	Other	
አስትረእዮ	Unknown	
አስትናባሪ	Unknown	
አስትናጋጅ	Unknown	
አስቸጋረ	Unknown	
አስቸጋሪ	Other	
አስቻለው	Male	
አስናቀ	Male	
አስናቀች	Female	
አስንቀ	Don't Know	
አስከልካይ	Other	
አስከሬን	Other	
አስኪያጅ	Other	
አስካለ	Both	
አስካል	Both	
አስካለማርያም	Female	
አስካለወይን	Female	
አስክልካይ	Male	
አሰካለች	Female	
አስካሉ	Female	
አስኳል	Female	
አስገባረ	Other	
አስገባሪ	Other	
አስገዶም	Male	
አስጨናቂ	Male	
አስጨንቀው	Male	
አስፈሪ	Other	
አስፈራቸው	Other	
አስፈስ	Other	
አስፈጻሚ	Company	
አስፋ ወሰን	Male	
አስፋወሰን	Male	አስፋውወሰን
አስፋው	Male	
አስፍሀ	Male	አስፍሐ
አስፍሐ	Male	
አሸባሪ	Other	
አሸብር	Male	
አሸቦ	Other	
አሸነ	Male	
አሸናፊ	Male	
አሸንክታብ	Other	
አሸንዳ	Other	
አሸንጌ	Other	
አሸዋ	Other	
አሹቅ	Other	
አሻ	Both	
አሻሚ	Other	
አሻራ	Other	
አሻሮ	Other	
አሻሻ	Other	
አሻሻጭ	Other	
አሻንጉሊት	Other	
አሻገረች	Other	
አሻግሬ	Other	
አሻጥረኛ	Other	
አሻጥር	Other	
አሽሙር	Other	
አሽሟጣጭ	Other	
አሽብራቂ	Other	
አሽብር	Male	
አሽኔ	Male	
አሽከር	Other	
አሽከርካረ	Other	
አሽከርካሪ	Other	
አሽከርካሪዎች	Other	
አሽካኪታ	Other	
አሽክላ	Other	
አሽክት	Other	
አቀበት	Other	
አቀባባይ	Other	
አቀባይ	Other	
አቀንቃኝ	Other	
አቀፍ	Other	
አቁባ	Other	
አቃቂ	Other	
አቃቂር	Other	
አቃቅማ	Other	
አቃቢ	Other	
አቃቢት	Other	
አቃቤ	Other	
አቃጣሪ	Other	
አቅመ ቢስ	Other	
አቅማዳ	Other	
አቅም	Other	
አቅራቢያ	Other	
አቅቢ	Other	
አቅኚ	Other	
አቅድ	Unknown	
አቅጣጫ	Other	
አቆልቋይ	Other	
አቆማዳ	Other	
አቆርዳት	Other	
አቆአጣጠር	Other	
አቆጣጠር	Other	
አቋም	Other	
አበ	Other	
አበል	Other	
አበረ	Male	
አበሩ	Female	
አበራ	Male	
አበራሽ	Female	
አበርገል	Other	
አበሱዳ	Other	
አበሳ	Other	
አበሻ	Male	
አበቅቴ	Unknown	
አበበ	Male	
አበበች	Female	
አበባ	Female	
አበባየሁ	Male	
አበባዬ	Both	
አበባው	Male	
አበው	Other	
አበዙ	Both	
አበዛሽ	Female	
አበዛች	Female	
አበዝ	Both	
አበያ	Other	
አበይት	Other	
አበዳሪ	Other	
አበጀ	Male	
አበጋር	Other	
አበጋዝ	Male	
አቡ	Male	
አቡሻከር	Male	
አቡሻክር	Unknown	
አቡቀዳዲ	Don't Know	
አቡበከር	Male	
አቡነ	Male	
አቡን	Other	
አቡዬ	Male	
አቡድ	Other	
አቡጀዲ	Don't Know	
አቢ	Male	
አቢራር	Other	
አቢይ	Male	
አቢጋር	Don't Know	
አባ	Other	
አባሆይ	Male	
አባ ወራ	Other	
አባ ዲና	Other	
አባ ድሽቃ	Other	
አባ ጨጓሬ	Other	
አባል	Other	
አባል ዘርእ	Other	
አባስ	Male	
አባቡ	Male	
አባተ	Male	
አባቴነህ	Male	
አባት	Other	
አባትሁን	Male	
አባያ	Male	
አባይ	Male	
አባይ 	Both	
አባይነህ	Male	
አባይነሽ	Female	
አባዲ	Male	
አባዲሽቃ	Unknown	
አባዲና	Male	
አባድር	Other	
አባጣ	Other	
አቤ	Male	
አቤል	Male	
አቤሴሎም	Male	
አቤቱታ	Other	
አቤቶ	Other	
አቤቶ ሁን	Unknown	
አብ	Male	
አብለ ዘርእ	Unknown	
አብላሊት	Don't Know	
አብረሃ	Male	አብርሃ
አብራር	Male	
አብራክ	Other	
አብርሂት	Female	
አብርሃ	Male	
አብርሃጽዮን	Male	
አብርሃም	Male	
አብርሐም	Male	
አብርኸት	Female	
አብስራ	Male	
አብሱዳ	Unknown	
አብሲት	Other	
አብሽ	Other	
አብሽር	Male	
አብሽሮ	Male	
አብሽሎ	Other	
አብሾ	Other	
አብሿም	Other	
አብቅቴ	Other	
አብተው	Male	
አብቹ	Other	
አብችሃ	Other	
አብችሃም	Other	
አብነት	Both	
አብየ	Other	
አብያተ	Other	
አብይ	Male	
አብዮተኛ	Government	
አብዮተኞች	Government	
አብዮታዊ	Government	
አብዮታዊት	Government	
አብዮታውያን	Government	
አብዮት	Both	
አብደላ	Male	
አብደረብ	Other	
አብደታ	Other	
አብዱ	Male	
አብዱ ራህማን	Male	
አብዱላሂ	Male	
አብዱል	Male	
አብዱልራሂም	Male	
አብዱልቃኒ	Male	
አብዱልቃድር	Male	
አብዱልከሪም	Male	
አብዱልሀሚድ	Male	
አብዱልሀቅ	Male	
አብዱልሀኪም	Male	
አብዱልሀዲ	Male	
አብዱልሀፊዝ	Male	
አብዱልመሊክ	Male	
አብዱልመናን	Male	
አብዱልመጅድ	Male	
አብዱልሰላም	Male	
አብዱልሰመድ	Male	
አብዱልሺኩር	Male	
አብዱልናሽር	Male	
አብዱልአቲፍ	Male	
አብዱልአዘዝ	Male	
አብዱልአየ	Male	
አብዱልዋሃብ	Male	
አብዱልዋሲ	Male	
አብዱልጀሊል	Male	
አብዱልጀዋድ	Male	
አብዱልጋፋር	Male	
አብዱልፈታህ	Male	
አብዱረሺድ	Male	
አብዱራሂም	Male	
አብዱራህማን	Male	
አብዱራዛቅ	Male	
አብዱር ቃድር	Male	
አብዲ	Male	
አብዲሳ	Male	
አብድል ጋውሪ	Male	
አብድረህማን	Male	
አብድረቦ	Male	
አብዶ	Male	
አብዶሽ	Male	
አብጠው	Male	
አብጤ	Male	
አቦነሽ	Female	
አቦል	Other	
አቦማ	Don't Know	
አቦሬ	Don't Know	
አቦዘነች	Female	
አቦዬ	Male	
አቧራ	Other	
አቧሬ	Place	
አተላ	Other	
አተቴ	Other	
አቲከም	Unknown	
አቲካም	Don't Know	
አታለል	Don't Know	
አታላ	Don't Know	
አታለለች	Female	
አታላይ	Male	
አታሞ	Other	
አታክልቴ	Both	
አታክልት	Both	
አቴና	Don't Know	
አትለይ	Male	
አትርሳው	Male	
አትሮንስ	Don't Know	
አትባራ	Don't Know	
አትናቴዎስ	Don't Know	
አትናጐ	Don't Know	
አትክልተኛ	Other	
አትክልት	Both	
አትገኝ	Male	
አትጠገብ	Female	
አቸነፈች	Other	
አቸናፊ	Male	
አቸዘ	Unknown	
አቸዘን	Don't Know	
አቸፈር	Other	
አቻ	Other	
አቻሜ	Female	
አቻምየለህ	Male	
አቻምየለሽ	Female	
አቻምና	Other	
አችፈር	Unknown	
አነር	Other	
አነሳሽ	Female	
አነስተኛ	Other	
አነባበሮ	Other	
አኒሳ	Female	
አናጉንስጢስ	Don't Know	
አናጋው	Male	
አናጢ	Other	
አንለይ	Male	
አንልይ	Don't Know	
አንርሃም	Don't Know	
አንሴቦ	Don't Know	
አንስታይ	Don't Know	
አንሶላ	Other	
አንሻ	Female	
አንቀልባ	Other	
አንቀጸ	Both	
አንቀጽ	Other	
አንቃ	Other	
አንቃር	Other	
አንበሳ	Other	
አንበሴ	Male	
አንበጣ	Other	
አንባቢዎች	Other	
አንቦልክ	Other	
አንተ	Other	
አንተ ነህ	Male	
አንተነህ	Male	
አንችን አሉ	Female	
አንቺነሽ	Female	
አንቺንለማ	Female	
አንቺንአሉ	Female	
አንከሊስ	Other	
አንከርት	Unknown	
አንከሮ	Other	
አንካሳ	Other	
አንካሴ	Other	
አንክርትት	Don't Know	
አንክሮ	Other	
አንኮ	Other	
አንኮ በር	Place	
አንኮበር	Place	
አንኳር	Other	
አንዋር	Male	
አንደርብ	Other	
አንደበት	Other	
አንደብርሃን	Male	
አንደታ	Other	
አንደኛ	Other	
አንዱ	Male	
አንዱአለም	Male	አንዱዓለም
አንዳርጋቸው	Male	
አንዳርጌ	Male	
አንዳች	Other	
አንዳፍታ	Other	
አንዴ	Other	
አንድ	Other	
አንድሸት	Male	
አንድምታ	Other	
አንድሬ	Male	foreign name
አንድነት	Male	
አንዶም	Male	ዓንዶም
አንጀት	Other	
አንጀኛ	Don't Know	
አንጃ	Other	
አንጆ	Other	
አንገረብ	Other	
አንገርብ	Other	
አንገሶም	Male	
አንጉላላ	Other	
አንጋሬ	Other	
አንጋው	Male	
አንጋጋው	Male	
አንጋፋ	Male	
አንጐለላ	Other	
አንጐል	Male	
አንጐት	Other	
አንጓ	Other	
አንጓቼ	Female	
አንጓዴ	Unknown	
አንጥረኛ	Other	
አንጥጮ	Other	
አንጸባራቂ	Other	
አንጻራዊ	Other	
አንጻር	Other	
አንፊላ	Other	
አንፊሎ	Other	
አንፋር	Other	
አንፋሮ	Other	
አአምስካየ	Don't Know	
አአቅዱስ	Don't Know	
አአብርሃንና	Don't Know	
አአተፈሪ	Don't Know	
አአአስፋው	Don't Know	
አአየትግራይ	Don't Know	
አአደጃዝማች	Don't Know	
አእላፍ	Don't Know	
አእምሮ	Male	
አእዋፍ	Other	
አከለ	Male	
አከርካሪ	Other	
አከፋፋይ	Other	
አካሉ	Male	
አካላት	Other	
አካላዊ	Other	
አካል	Male	
አካሏ	Female	
አካባቢ	Other	
አካባች	Other	
አካዳሚ	Company	
አካፋ	Other	
አክሊለ	Both	
አክሊሉ	Male	
አክሊል	Both	
አክሎግ	Male	
አክምባሎ	Other	
አክራሪ	Other	
አክርማ	Other	
አክሱም	Place	
አክሲዮን	Company	
አክስት	Other	
አክበረት	Female	
አክበር	Male	
አክበሮም	Male	
አክብሮም	Unknown	
አክብሮት	Other	
አክታ	Other	
አኮርባጅ	Other	
አኮፋዳ	Other	
አኳኋን	Other	
አኳያ	Other	
አወል	Male	
አወቀ	Male	
አወናባጅ	Other	
አወዛጋቢ	Other	
አወዳሽ	Other	
አወዳደቅ	Other	
አወጣሽ	Female	
አወጣኸኝ	Male	
አዋላጅ	Other	
አዋሳ	Place	
አዋሳኝ	Other	
አዋሽ	Place	
አዋቆ	Other	
አዋዜ	Other	
አዋድ	Male	
አዋጁ	Other	
አዋጅ	Other	
አውላላ	Other	
አውላቸው	Male	
አውላችው	Male	
አውሎ ነፋስ	Other	
አውራ	Other	
አውራሪስ	Other	
አውራጃ	Government	
አውራጅ	Other	
አውሬ	Other	
አውባቸው	Don't Know	
አውታር	Other	
አውታታ	Other	
አውእሎም	Don't Know	
አውደ	Other	
አውደልዳይ	Other	
አውድ	Other	
አውድማ	Other	
አውግስጢኖስ	Other	
አውግስጦስ	Other	
አውግቸው	Other	
አውግዛቸው	Male	
አውጣ እኬ	Other	
አውጣአኬ	Unknown	
አውጥ	Other	
አውጫጭኝ	Other	
አዕምሮ	Male	
አዘራር	Other	
አዘቅት	Other	
አዘቦ	Other	
አዘቦት	Other	
አዘነ	Male	
አዘነጋሽ	Female	
አዘነች	Female	
አዘዜ	Other	
አዘዞ	Other	
አዘዘ	Male	
አዙሪት	Other	
አዚዛ	Female	
አዚዝ	Male	
አዚፋ	Other	
አዛለች	Female	
አዛለወርቅ	Female	
አዛማጅ	Other	
አዛርያ	Male	
አዛርያስ	Male	
አዛባ	Other	
አዛናው	Male	
አዛውንት	Other	
አዛገ	Male	
አዛዥ	Other	
አዜብ	Female	
አዝመራ	Both	
አዝሙድ	Other	
አዝማሚያ	Other	
አዝማረ	Other	
አዝማሪ	Other	
አዝማች	Other	
አዝማጅ	Other	
አዝራር	Other	
አዝርእት	Other	
አዝጋሚ	Other	
አዞ	Other	
አየሁ	Male	
አየለ	Male	
አየለች	Female	
አየሉ	Female	
አየር	Other	
አየነው	Male	
አያሌ	Male	
አያሌው	Male	
አያል ነህ	Male	
አያል ነሽ	Female	
አያት	Other	
አያና	Male	
አያኔ	Male	
አያንቱ	Male	
አያኖ	Male	
አይሁድ	Other	
አይመለል	Other	
አይሸሽም	Other	
አይሻ	Both	
አይብ	Other	
አይተነው	Male	
አይተንፍሱ	Male	
አይታ	Male	
አይታገድ	Other	
አይትክቱ	Other	
አይትገድ	Other	
አይቸህ	Male	
አይናዲስ	Female	
አይከል	Other	
አይደርቄ	Other	
አይዳ	Female	
አይዳኝ	Other	
አይድ	Don't Know	
አይድሩስ	Male	
አይጠ መጐጥ	Unknown	
አይጠየፍ	Other	
አይጠገብ	Male	
አይጥ	Other	
አዮ	Other	
አደላ	Male	
አደመ	Other	
አደም	Male	
አደራ	Male	
አደራዬ	Male	
አደራው	Male	
አደሬ	Other	
አደነቁሽ	Female	
አደስ	Other	
አደባባይ	Other	
አደንጓሬ	Other	
አደይ	Female	
አደገ	Other	
አደገኛ	Other	
አደጉ	Other	
አደጋ	Other	
አደፍርስ	Male	
አዱሊስ	Other	
አዱኛ	Male	
አዲ ሸሁ	Place	
አዲ ቀይህ	Place	
አዲ ተከለዛን	Place	
አዲ አርቃይ	Place	
አዲ ኡግሪ	Other	
አዲ ኳላ	Place	
አዲ ግራት	Place	
አዲሱ	Male	
አዲሲቷ	Other	
አዲሴ	Female	
አዲስ	Both	
አዲስወርቅ	Both	
አዲስ አለም	Both	አዲስዓለም
አዲስ አበባ	Place	
አዲስ ኣለም	Both	
አዲስፋና	Both	
አዲቦ	Male	
አዳል	Other	
አዳሙ	Male	
አዳም	Male	
አዳምነሽ	Female	
አዳሚቱ	Female	
አዳራሽ	Other	
አዳስ	Other	
አዳሽ	Other	
አዳባ	Other	
አዳነ	Male	
አዳነች	Female	
አዳኑ	Female	
አዳጋ	Other	
አዳፍሬ	Male	
አዳወርቅ	Female	
አድሀሪ	Other	
አድሀርያን	Other	
አድሃና	Male	
አድሃኖም	Male	
አድህኖም	Don't Know	
አድላዊ	Other	
አድላዎ	Other	
አድልዎ	Other	
አድሐነ	Male	
አድመኛ	Other	
አድሚኒስትሬሽን	Company	english word
አድማ	Other	
አድማሱ	Male	
አድማሴ	Male	
አድማስ	Both	
አድማስወርቅ	Both	
አድማሷ	Female	
አድምቄ	Male	
አድምጤ	Male	
አድሩስ	Other	
አድራጐት	Other	
አድር ባይ	Other	
አድባራት	Other	
አድባር	Other	
አድነው	Male	
አድአ	Other	
አድዋ	Male	
አድጉይ	Unknown	
አድጐይ	Male	
አጀብ	Other	
አጀንዳ	Other	
አጃቢ	Other	
አጅሬ	Other	
አጅበው	Other	
አጅቢ	Other	
አገልግል	Other	
አገረ	Other	
አገር	Other	
አገናዛቢ	Other	
አገኘሁ	Male	
አገው	Other	
አገያ	Other	
አገዳ	Other	
አገጭ	Other	
አጉላ	Other	
አጉል	Other	
አጊቦ	Unknown	
አጋ	Male	
አጋሙዳ	Don't Know	
አጋሚዶ	Don't Know	
አጋማሽ	Other	
አጋሜ	Other	
አጋም	Other	
አጋር	Both	
አጋሮ	Other	
አጋሰስ	Other	
አጋቦስ	Other	
አጋንንት	Other	
አጋዘን	Other	
አጋዤ	Other	
አጋጣሚ	Other	
አጋጭ	Unknown	
አጋፋሪ	Other	
አጌቦ	Other	
አግ አዚ	Unknown	
አግማሴ	Other	
አግቦ	Other	
አግአዚ	Male	
አግአዚት	Female	
አግአዚያን	Other	
አግአዝያን	Unknown	
አግዛቸው	Other	
አግደው	Male	
አግዳሚ	Other	
አግዴ	Other	
አግድም	Other	
አጐበር	Other	
አጐብጓቢ	Other	
አጐት	Other	
አጐናፍር	Male	
አጐዛ	Other	
አጓት	Other	
አጓዳኝ	Other	
አጓጓሽ	Female	
አጓጓሽኝ	Female	
አጠቃላይ	Other	
አጠባበቅ	Other	
አጣሪ	Other	
አጣና	Other	
አጣዳፊ	Other	
አጣጥ	Other	
አጥላባቸው	Male	
አጥላው	Male	
አጥሌ	Male	
አጥረሽዋል	Female	
አጥሚት	Other	
አጥማጅ	Other	
አጥቂ	Other	
አጥቂነት	Other	
አጥቢያ	Other	
አጥናፈ	Male	
አጥናፈወርቅ	Both	
አጥናፉ	Male	
አጥናፌ	Male	
አጥናፍ	Male	
አጥናፍሰገድ	Male	
አጥንት	Other	
አጥፊ	Other	
አጨሌ	Don't Know	
አጨዳ	Other	
አጭር	Other	
አጵሎስ	Don't Know	
አጸቀ	Unknown	
አጸደ	Female	
አጸደማርያም	Female	
አጸደወይን	Female	
አጸድ	Female	
አጸፋ	Other	
አጼ	Male	
አጼነሽ	Female	
አጽመ ርስት	Other	
አጽሜ	Other	
አጽም	Other	
አጽም ርስት	Other	
አጽቀ	Male	
አጽቅ የለሽ	Female	
አጽቅ ያለሽ	Don't Know	
አጽብሀ	Male	አጽብሃ
አጽዋማት	Other	
አጽደ	Unknown	
አፈ	Other	
አፈ ላማ	Other	
አፈ ወርቂ	Male	
አፈ ወርቅ	Male	
አፈሩ	Don't Know	
አፈራ	Male	
አፈራሁ	Male	
አፈር	Other	
አፈርሳታ	Other	
አፈሳ	Other	
አፈና	Other	
አፈንጋጭ	Other	
አፈንጋጭ 	Other	
አፈኛ	Other	
አፈወርቂ	Male	
አፈወርቅ	Male	
አፋፍ	Other	
አፍለኛ	Other	
አፍሊ	Other	
አፍላ	Other	
አፍላል	Other	
አፍላኛ	Other	
አፍሌ	Other	
አፍረተ ስጋ	Other	
አፍራሽ	Other	
አፍርሳታ	Other	
አፍርንጅ	Other	
አፍቻለ	Unknown	
አፍቻል	Other	
አፍአዊ	Other	
አፍደም	Other	
አፍጼ	Other	
አፎቄ	Other	
አፎት	Other	
ኡላላ	Male	
ኡማ	Male	
ኡል	Other	
ኡመር	Male	
ኡራኤል	Other	
ኡርጋ	Male	
ኡርጌ	Male	
ኡርጌሳ	Male	
ኡስማን	Male	ዑስማን
ኡኡታ	Other	
ኡውሱን	Other	
ኡደት	Other	
ኢላላ	Male	
ኢላል	Male	
ኢላማ	Other	
ኢላበርእድ	Other	
ኢምንት	Other	
ኢማም	Male	
ኢማኑኤል	Male	
ኢማኒ	Male	
ኢማን	Male	
ኢርቱእ	Other	
ኢሰብአዊ	Other	
ኢሳ	Male	
ኢሳቅ	Male	
ኢሳያስ	Male	
ኢሳይያስ	Male	
ኢብራሂም	Male	
ኢብሳ	Male	
ኢቦ	Other	
ኢተያ	Unknown	
ኢቱ	Other	
ኢታፋ	Male	
ኢታና	Male	
ኢትየጵያ	Other	
ኢትያ	Other	
ኢትዮጲስ	Other	
ኢትዮጵያ	Female	
ኢትዮጵያዊ	Other	
ኢትዮጵያውያን	Other	
ኢትዮጵያ	Place	
ኢንራሂም	Don't Know	
ኢንስቲትዪት	Other	
ኢውሱን	Unknown	
ኢዘንበርግ	Other	
ኢዘዝ	Unknown	
ኢዛዝ	Other	
ኢየሩሳሌም	Both	
ኢየሱስ	Other	
ኢየሱስ ሞላ	Unknown	
ኢየሱስ ሞኣ	Unknown	
ኢያሪኮ	Other	
ኢያሱ	Male	
ኢያቄም	Male	
ኢዮብ	Male	
ኢዮአስ	Male	
ኢዮአብ	Male	
ኢዮኤል	Male	
ኢደኤ	Don't Know	
ኢዴሳ	Male	
ኢዴቻ	Male	
ኢድሪ	Male	
ኢድሪስ	Male	
ኢዶሳ	Male	
ኣለመ	Other	
ኣለሙ	Male	ዓለሙ
ኣለሚቱ	Female	
ኣለማ ማያ	Unknown	
ኣለማየሁ	Male	አለማየሁ
ኣለሜ	Male	
ኣለም	Both	
ኣለም ማያ	Place	
ኣለም ነህ	Male	
ኣለም ነሽ	Female	
ኣላማ	Male	
ኣመተ	Other	አመት
ኣመተ የስ	Other	
ኣመቱ	Other	
ኣመቴ	Other	
ኣመት	Other	
ኣምሀጀር	Other	
ኣሞናዳ	Other	
ኣርጋው	Male	
ኣስማ	Other	
ኣይነ በጐ	Other	
ኣይነ ኩሉ	Other	
ኣይነተኛ	Other	
ኣይነት	Other	
ኣይን	Other	
ኣይን አውጣ	Other	
ኣዲ ቀይህ	Place	
ኣዲ ተከለዛን	Place	
ኣዲ አርቃይ	Place	
ኣዲ ኡግሪ	Place	
ኣዲ ኳላ	Place	
ኣዲ ግራት	Place	
ኤ	Unknown	
ኤሌክትሪክ	Other	
ኤል	Other	
ኤልሲ	Female	
ኤልሳ	Female	ኤልሣ
ኤልሳቤጥ	Female	ኤልሣቤጥ
ኤልሻዳይ	Female	
ኤልያስ	Male	
ኤልዳር	Both	
ኤም	Other	
ኤረር	Other	
ኤሬክስን	Other	
ኤርምያስ	Male	
ኤርትራ	Place	
ኤርትራዊ	Other	
ኤርትራውያን	Other	
ኤሳው	Other	
ኤባ	Male	
ኤቶ	Other	
ኤደን	Female	
ኤዲቶ	Other	
ኤዳ	Other	
ኤገኖ	Other	
ኤፌሶን	Other	
ኤፍሬም	Male	
እሁድ	Other	
እህል	Other	
እህተ	Female	
እህተመላክ	Female	
እህተሚካኤል	Female	
እህተማርያም	Female	
እህተሥላሴ	Female	
እህተጊዮርጊስ	Female	
እህቴ	Other	
እህት	Other	
እህትትሁን	Female	
እህትአበዛሁ	Female	
እህደጋ	Don't Know	
እህዳጋ	Unknown	
እለት	Other	
እሌኒ	Female	
እልልታ	Female	
እልመለክ	Other	
እልም ነህ	Male	
እልቂት	Other	
እልቆ መሳፍርት	Other	
እልበት	Other	
እልባት	Other	
እልኸኛ	Other	
እልኽ	Other	
እልፍ	Other	
እልፍ ነሽ	Female	
እልፍነሽ	Female	
እልፍኝ	Other	
እመ	Other	
እመቤት	Female	
እመ ምኔት	Unknown	
እመርታ	Other	
እሙና	Other	
እማማ	Other	
እማዋይሽ	Female	
እማኙ	Other	
እማኝ	Other	
እሜቴ	Other	
እምላእሉ	Other	
እምሩ	Male	
እምር	Other	
እምሻው	Male	
እምቡሽቡሽ	Other	
እምቡጥ	Other	
እምቢ	Other	
እምቢልታ	Other	
እምቢተኛ	Other	
እምቢተኛነት	Other	
እምቢታ	Other	
እምባሶይራ	Other	
እምባትካላ	Other	
እምባትክላ	Unknown	
እምባዬ	Male	
እምባጮ	Other	
እምቦሳ	Other	
እምቦቃቅላ	Other	
እምቧይ	Other	
እምቧጮ	Other	
እምአእላፍ	Male	
እምወድሽ	Female	
እምድብር	Other	
እምዩ	Female	
እምነት	Both	
እረኛ	Other	
እረኛው	Other	
እረፍት	Other	
እራሪ	Other	
እራቁት	Other	
እራት	Other	
እሬት	Other	
እርማት	Other	
እርምጃ	Other	
እርሳስ	Other	
እርስ በርስ	Other	
እርስቴ	Other	
እርስዎ	Other	
እርቅይሁን	Male	
እርሻ	Other	
እርሾ	Other	
እርቁ	Other	
እርቃን	Other	
እርቅ	Other	
እርቢ	Other	
እርባር	Other	
እርባታ	Other	
እርባን	Other	
እርብራብ	Other	
እርቦ	Other	
እርከን	Other	
እርኩም	Other	
እርካብ	Other	
እርካብሽወርቅ	Female	
እርኰት	Unknown	
እርዝቅ	Other	
እርያ	Other	
እርዳታ	Other	
እርዳው	Male	
እርድ	Other	
እርጅና	Other	
እርገቱ	Male	
እርገት	Male	
እርገጤ	Male	
እርጉዝ	Other	
እርጋጭ	Other	
እርግማን	Other	
እርግብ	Other	
እርግነሽ	Female	
እርግብግቢት	Other	
እርግጫ	Other	
እርጥባን	Other	
እርጥብ	Other	
እሰዬ	Other	
እሱባለው	Male	
እሱእነዳለ	Male	
እሱ ነህ	Other	
እሳተ ገሞራ	Other	
እሳቱ	Other	
እሳት	Other	
እሴተ	Female	
እሴተመድህን	Female	
እሴተማርያም	Female	
እሴተጽዮን	Female	
እስላም	Other	
እስማኤል	Male	
እስራኤል	Both	
እስራት	Other	
እስር	Other	
እስስት	Other	
እስተዳር	Both	
እስከዳር	Both	
እስትንፋስ	Other	
እስትንፍስ	Other	
እስክስታ	Other	
እስክንድር	Male	
እስጢፋኖስ	Male	
እሸቱ	Male	
እሸቴ	Male	
እሸቴነሽ	Female	
እሸቷ	Female	
እሸት	Male	
እሽቅድምድም	Other	
እሽታ	Other	
እቁበ	Male	
እቁባ	Other	ዕቁባ
እቁባት	Other	
እቁባይ	Male	
እቁብ	Other	
እቃ	Other	
እቃዎች	Other	
እቅድ	Other	
እቅፍ	Other	
እበት	Other	
እቡያን	Other	
እቡይ	Other	
እቡይት	Other	
እባብ	Other	
እባጭ	Other	
እብሪተኛ	Other	
እብሪት	Other	
እብራይስጥ	Other	
እብቅ	Other	
እብነ በረድ	Other	
እብነመለክ	Other	
እብነበ በረድ	Other	
እብድ	Other	
እቱቤ	Other	
እታለማሁ	Female	
እታለም	Female	
እታበዛሁ	Female	
እታገኘሁ	Female	
እታገኝ	Female	
እታፈራሁ	Female	
እታፍራሁ	Female	
እቴነሽ	Female	
እቴናት	Female	
እቴቱ	Female	
እቴጌ	Other	
እትማማች	Other	
እትም	Other	
እትብት	Other	
እነሞር	Other	
እነርሱ	Other	
እነቆር	Other	
እነዋሪ	Place	
እነዚህ	Other	
እነዚያ	Other	
እነፍሴ	Unknown	
እናርያ	Other	
እናቲቱ	Other	
እናት	Female	
እናትዓለም	Female	
እናቴነሽ	Female	
እናኑ	Female	
እናኒ	Female	
እናንተ	Other	
እናንጐ	Other	
እናውጋው	Other	
እኔ	Other	
እንሰት	Other	
እንሳሮ	Other	
እንስላል	Other	
እንስሳ	Other	
እንስሳት	Other	
እንስት	Other	
እንሶስላ	Other	
እንሽላሊት	Other	
እንቀት	Other	
እንቁ	Both	
እንቁላል	Other	
እንቁጣጣሽ	Female	
እንቃቅላ	Other	
እንቅልፋም	Other	
እንቅልፍ	Other	
እንቅርት	Other	
እንቅስቃሴ	Other	
እንቅብ	Other	
እንቅፋት	Other	
እንቆቅልሽ	Other	
እንቆቆ	Other	
እንባ	Other	
እንብርት	Other	
እንቧይ	Other	
እንተኔ	Other	
እንተን	Other	
እንትና	Other	
እንትን	Other	
እንትክትክ	Other	
እንከን	Other	
እንከንየለሽ	Female	
እንኩሮ	Other	
እንክርዳድ	Other	
እንክብል	Other	
እንክብካቤ	Other	
እንክብክብ	Other	
እንኳየሁ	Male	
እንኳየሽ	Female	
እንኮይ	Other	
እንዘዝ	Other	
እንዝህላል	Other	
እንዝርት	Other	
እንየ	Other	
እንየው	Male	
እንያት	Female	
እንይሽ	Female	
እንደራሴ	Other	
እንደርታ	Other	
እንደሻው	Male	
እንደኋሁላ	Other	
እንዳ ስላሴ	Place	
እንዳ ይላሉ	Male	
እንዳሁላ	Other	
እንዳለ	Male	
እንዳለው	Male	
እንዳልሽ	Female	
እንዳልካቸው	Male	
እንዳየን	Other	
እንድሪስ	Male	
እንድሬ	Other	
እንድርያስ	Male	
እንድይላሉ	Male	
እንዶድ	Female	
እንጀራ	Other	
እንጅልሽ	Don't Know	
እንጅራ	Other	
እንጆሪ	Female	
እንጉርጉሮ	Other	
እንጉዳይ	Female	
እንግርግብ	Other	
እንግዳ	Male	
እንግዳአየሁ	Male	
እንግዳ እሸት	Male	
እንግዳሰው	Male	
እንግዳሸት	Male	
እንግዳየሁ	Male	
እንግዳወርቅ	Both	
እንግዳዘር	Both	
እንግዳጌጥ	Both	
እንግዴልጅ	Other	
እንግጫ	Other	
እንጐቻ	Other	
እንጥል	Other	
እንጦንስ	Other	
እንጦጦ	Place	
እንጨት	Other	
እንጭጭ	Other	
እንፋሎት	Other	
እንፍሴ	Other	
እኛ	Other	
እኝኝ ብላ	Other	
እእዛዝ	Other	
እከደከ	Other	
እኩሌታ	Other	
እኩል	Other	
እኩልህ	Other	
እኩልነት	Other	
እኩያ	Other	
እኩይ	Other	
እክል	Other	
እውቀቱ	Male	
እውቀት	Male	
እውነቱ	Male	
እውነታ	Male	
እውነት	Both	
እዘዜ	Unknown	
እዝል	Other	
እዝራ	Male	
እዝጊእ	Other	
እየሱስወርቅ	Male	
እየሱሳዊት	Female	
እያዩ	Both	
እደማርያም	Male	
እደግልኝ	Male	
እደ	Other	
እዳ	Other	
እዳሪ	Other	
እዳይት	Other	
እዳጋ	Other	
እድሉ	Male	
እድል	Both	
እድሜ	Other	
እድምተኛ	Other	
እድሞ	Other	
እድሪስ	Male	
እድር	Other	
እድገት	Male	
እጀ እዙር	Other	
እጀ ጠባብ	Other	
እጃጂ	Other	
እጅ	Other	
እጅ መንሻ	Other	
እጅ አዙር	Other	
እጅ ይንሱ	Other	
እጅ ጠባብ	Other	
እጅጉ	Male	
እጅግአየሁ	Female	
እግረ ተማሪ	Unknown	
እግረኛ	Other	
እግር	Other	
እግዚሃሪያ	Male	
እግዚህ	Other	
እግዚአ	Other	
እግዚአብሄር	Other	እግዚአብሔር
እግዚአብሔር	Other	
እግዚእ	Other	
እግዜር	Other	
እጓለ	Other	
እጓለጽዮን	Male	
እጓሌ	Male	
እጓለ ማውታ	Other	
እጢ	Other	
እጣ	Other	
እጣቢ	Other	
እጣን	Other	
እጥረት	Other	
እጥፍ	Both	
እጥፍወርቅ	Both	
እጥፍነሽ	Female	
እጨጌ	Other	
እጭ	Other	
እጮኛ	Other	
እጸ	Other	
እጸገነት	Female	እፀገነት
እጹብ	Both	
እጹብወርቅ	Female	
እጽ	Other	
እፉኝት	Other	
እፍታ	Other	
እፍኝ	Other	
እፍያ	Other	
ኦሉማ	Unknown	
ኦላማ	Don't Know	
ኦላና	Other	
ኦመር	Male	
ኦሜድላ	Other	
ኦምሀጀር	Unknown	
ኦሞናዳ	Unknown	
ኦሪታዊ	Other	
ኦሪት	Female	
ኦርማ	Other	
ኦርቶዶክስ	Other	
ኦስማን	Male	
ኦዳ	Other	
ከሀሊ	Other	
ከሃሊ	Unknown	
ከሃዲ	Other	
ከለለው	Male	
ከለሜዳ	Other	
ከለቻ	Male	
ከለው	Other	
ከሊል	Male	
ከሊፋ	Male	
ከላሽ	Other	
ከል	Other	
ከልሌ	Male	
ከልታማ	Other	
ከልካይ	Male	
ከልክለው	Other	
ከልክሌ	Male	
ከሙን	Other	
ከማል	Male	
ከምሱር	Male	
ከምሲ	Male	
ከምሴ	Male	
ከረን	Other	
ከረዩ	Other	
ከሪማ	Male	
ከሪም	Male	
ከረጢት	Other	
ከርሲማ	Other	
ከርሴ	Other	
ከርስ	Other	
ከርቢ	Other	
ከርቤ	Other	
ከርታታ	Other	
ከርቸሌ	Other	
ከርከሮ	Other	
ከርዳዳ	Other	
ከሰል	Other	
ከሰም	Other	
ከሰተ	Male	
ከሰተብርሃን	Male	
ከሳሽ	Other	
ከሳቴ	Other	
ከሳቴ ከርስ	Unknown	
ከሺሸያ	Other	
ከበረ	Male	
ከበሩ	Male	
ከበርቴ	Other	
ከበበ	Male	
ከበበው	Male	
ከበቡሽ	Female	
ከበባ	Other	
ከበደ	Male	
ከበደች	Female	
ከበዱ	Female	
ከባድ	Male	
ከበዶም	Male	
ከብት	Other	
ከተማ	Male	
ከተማሽ	Female	
ከተማነሽ	Female	
ከተራ	Other	
ከነአን	Other	
ከንቲባ	Male	
ከውካዋ	Other	
ከዋክብት	Female	
ከዘራ	Other	
ከዚራ	Other	
ከይሲ	Other	
ከዳተኛ	Other	
ከድር	Male	
ከድጃ	Female	
ከፈለ	Male	
ከፈለኝ	Male	
ከፈለው	Other	
ከፈኔ	Male	
ከፈን	Other	
ከፈይ	Unknown	
ከፊል	Other	
ከፋ	Other	
ከፋት	Other	
ከፋይ	Female	
ከፍ አለ	Other	
ከፍ ያለው	Male	
ከፍአርጋቸው	Male	
ከፍተኛ	Other	
ከፍታ	Other	
ኩሀ	Other	
ኩለኔ	Other	
ኩሉ	Male	
ኩሉብርሃን	Male	
ኩሉኮንታ	Other	
ኩሊ	Other	
ኩላሊት	Other	
ኩልኩልት	Other	
ኩልፎ	Other	
ኩሎ ኮንታ	Unknown	
ኩመልቻ	Male	
ኩመላ	Male	
ኩመል	Male	
ኩሜ	Other	
ኩሜላ	Other	
ኩምሳ	Other	
ኩምቢ	Other	
ኩረት	Other	
ኩሪ	Female	
ኩሪባቸው	Female	
ኩራባቸው	Male	
ኩራተኛ	Other	
ኩራት	Other	
ኩራዝ	Other	
ኩሬ	Other	
ኩርማን	Other	
ኩርሲ	Other	
ኩርቢት	Other	
ኩርባ	Other	
ኩርባን	Other	
ኩርቱ	Other	
ኩርንችት	Other	
ኩርኩም	Other	
ኩርፊያ	Other	
ኩርፋድ	Other	
ኩርፍተኛ	Other	
ኩርፍታ	Other	
ኩስ	Other	
ኩስማል	Other	
ኩስታሪ	Other	
ኩስኩስት	Other	
ኩበት	Other	
ኩባንያ	Other	
ኩባያ	Other	
ኩብኩባ	Other	
ኩታ	Other	
ኩታራ	Other	
ኩናማ	Other	
ኩክ	Other	
ኩዊህ	Unknown	
ኩዩ	Other	
ኩይሳ	Other	
ኩፋሌ	Other	
ኩፍታ	Other	
ኩፍኝ	Male	
ኪሚያ	Male	
ኪሄሾን	Don't Know	
ኪሩቤል	Male	
ኪሮስ	Male	
ኪሳራ	Other	
ኪቦር	Don't Know	
ኪታ	Other	
ኪነ	Other	
ኪነት	Other	
ኪያ	Other	
ኪያር	Male	
ኪዳነ	Male	
ኪዳነማርያም	Male	
ኪዳነወልድ	Male	
ኪዳኑ	Male	
ኪዳኔ	Male	
ኪዳን	Male	
ካህሱ	Male	
ካህሳይ	Male	ካሕሣይ
ካህናት	Other	
ካህን	Other	
ካሊድ	Male	
ካሌብ	Male	
ካሕሣይ	Male	
ካሚል	Male	
ካሣ	Male	
ካሣዬ	Male	
ካራ	Other	
ካራ ሚሌ	Unknown	
ካራ ማራ	Place	
ካራ ቆሪ	Place	
ካራሚሌ	Other	
ካር ቆሬ	Place	
ካርል	Male	
ካሰች	Female	
ካሰኝ	Male	
ካሰው	Male	
ካሱ	Male	
ካሳ	Male	ካሣ
ካሳ ሁን	Male	
ካሳሁን	Male	ካሣሁን
ካሳው	Male	
ካሳዬ	Male	
ካሳዬነሽ	Female	
ካሴ	Male	
ካስማ	Don't Know	
ካሺሽያ	Unknown	
ካቢኔ	Other	
ካባ	Other	
ካብትህ	Male	
ካብትህይመር	Male	
ካቦ	Male	
ካቲካላ	Other	
ካቴና	Other	
ካቴድራል	Other	
ካቻ	Other	
ካናቴራ	Other	
ካእብ	Other	
ካኪሳ	Other	
ካካ	Other	
ካውያ	Other	
ካዝና	Other	
ካፊያ	Other	
ካፖርት	Other	
ኬላ	Other	
ኬሪያ	Male	
ኬርሻዋ	Other	
ኬርጋ	Unknown	
ኬሻ	Other	
ኬትሮንስ	Other	
ኬኔ	Other	
ኬንዳ	Other	
ኬኛ	Other	
ኬክሮስ	Other	
ክህነት	Other	
ክህደት	Other	
ክልል	Other	
ክልስ	Other	
ክምር	Other	
ክምችት	Other	
ክረምት	Other	
ክራር	Other	
ክር	Other	
ክርስቲያናት	Other	
ክርስቲያን	Both	
ክርስትና	Other	
ክርስትያናዊ	Other	
ክርስቶስ	Other	
ክርታስ	Other	
ክርክር	Other	
ክርፋት	Other	
ክስረት	Other	
ክስተት	Other	
ክስዲያም	Other	
ክበር	Other	
ክበበ	Male	
ክበበፀሐይ	Male	
ክበበው	Male	
ክበብ	Male	
ክበድ	Male	
ክቡር	Male	
ክባባው	Other	
ክቤ	Other	
ክብረ	Male	
ክብረአብ	Male	
ክብረታዬ	Other	
ክብረት	Male	
ክብሩ	Male	
ክብሪት	Other	
ክብራ	Other	
ክብራን	Both	
ክብርና	Other	
ክብርዬ	Both	
ክብሮም	Male	
ክብሯ	Female	
ክተት	Other	
ክትባት	Other	
ክትክታ	Other	
ክትፎ	Other	
ክነፈርግብ	Other	
ክንታሮት	Other	
ክንድ	Other	
ክንፈ	Male	
ክንፉ	Male	
ክንፌ	Male	
ክንፍ	Other	
ክክ	Other	
ክዳምየኖ	Other	
ክፈለኝ	Other	
ክፈለው	Unknown	
ክፈተው	Other	
ክፈፍ	Other	
ክፍለ	Male	
ክፍለሚካኤል	Male	
ክፍለማርያም	Male	
ክፍለስላሴ	Male	
ክፍለየሱስ	Male	
ክፍለዮሐንስ	Male	
ክፍለጽዮን	Male	
ክፍሉ	Male	
ክፍላተ	Other	
ክፍላይ	Male	
ክፍሌ	Male	
ክፍል	Other	
ክፍልፋይ	Other	
ክፍሎም	Male	
ክፍት	Other	
ክፍያ	Other	
ኮሌታ	Other	
ኮሌጆች	Other	
ኮልፌ	Place	
ኮመኮም	Other	
ኮመዲኖ	Other	
ኮምቦልቻ	Place	
ኮረም	Other	
ኮረሪማ	Other	
ኮረብታ	Other	
ኮረብታማ	Other	
ኮረብቴት	Unknown	
ኮረንቲ	Other	
ኮረኮንች	Other	
ኮረዳ	Other	
ኮራ	Other	
ኮራን	Other	
ኮራይ	Other	
ኮሬ	Other	
ኮሬብ	Other	
ኮርማ	Other	
ኮርሜ	Male	
ኮርቻ	Other	
ኮስታራ	Other	
ኮስትር	Other	
ኮሶ	Other	
ኮሸሽላ	Other	
ኮሽም	Other	
ኮባ	Other	
ኮቲ	Other	
ኮቴ	Other	
ኮትቻ	Other	
ኮንሶ	Other	
ኮከበ ጽባህ	Other	
ኮከቤ	Both	
ኮከብ	Both	
ኮክ	Other	
ኮዳ	Other	
ኮፈሌ	Other	
ኮፈጆ	Unknown	
ኮፍያ	Other	
ኳኳቴ	Other	
ወህኒ	Other	
ወለለት	Other	
ወለላ	Female	
ወለል	Other	
ወለምታ	Other	
ወለባ	Other	
ወለተ	Female	
ወለተሐና	Female	
ወለተሃይማኖት	Both	
ወለተሚካኤል	Female	
ወለተማርያም	Female	
ወለተስላሴ	Male	
ወለተሩፋኤል	Both	
ወለተብርሃን	Female	
ወለተንጉስ	Male	
ወለተኪዳን	Male	
ወለተየሱስ	Male	
ወለተየስ	Male	
ወለተዮሐንስ	Male	
ወለተገብርኤል	Male	
ወለተጊዮርጊስ	Male	
ወለቱ	Female	
ወለንጪቲ	Place	
ወለንጭቲ	Other	
ወለወልዳ	Other	
ወለድ አገድ	Other	
ወለጋ	Place	
ወለጌ	Other	
ወላሞ	Other	
ወላስማ	Other	
ወላንሳ	Female	
ወላዋይ	Other	
ወላዲት	Other	
ወላጅ	Other	
ወላፈን	Other	
ወሌ	Other	
ወልሻሻ	Other	
ወልቂጤ	Other	
ወልቃይት	Other	
ወልቆ	Other	
ወልወል	Other	
ወልደ	Male	
ወልደሐና	Male	
ወልደሐዋርያት	Male	
ወልደሐይማኖት	Male	
ወልደመስቀል	Male	
ወልደመድኀን	Male	
ወልደስላሴ	Male	ወልደሥላሴ
ወልደ የሱስ	Male	
ወልደ የስ	Male	
ወልደሚካኤል	Male	
ወልደማርያም	Male	
ወልደሩፋኤል	Male	
ወልደሰማያት	Male	
ወልደሰንበት	Male	
ወልደትንሳኤ	Male	
ወልደትንሳይ	Male	
ወልደአማኑኤል	Male	
ወልደአምላክ	Male	
ወልደአብ	Male	
ወልደአረጋይ	Male	
ወልደእዝጊ	Male	
ወልደኪዳን	Male	
ወልደዮሐንስ	Male	
ወልደገሪማ	Male	
ወልደገብርኤል	Male	
ወልደጊዮርጊስ	Male	
ወልደጻዲቅ	Male	
ወልደጨርቆስ	Male	
ወልደየስ	Male	
ወልደያ	Male	
ወልዱ	Male	
ወልዳይ	Male	
ወልዴ	Male	
ወልድ	Male	
ወልድያ	Place	
ወሎ	Other	
ወሎዬ	Other	
ወመዘክር	Other	
ወመዘክርና	Other	
ወምበር	Other	
ወረ ሂመኖ	Place	
ወረ ባቦ	Place	
ወረ ነሻ	Other	
ወረ ንጥሻ	Other	
ወረ ኢሉ	Place	
ወረ ገኑ	Unknown	
ወረሀ	Other	
ወረርሺኝ	Other	
ወረርሽኝ	Other	
ወረቀት	Other	
ወረተኛ	Other	
ወረታ	Other	
ወረት	Other	
ወረንጦ	Other	
ወረደ	Male	
ወረደወርቅ	Male	
ወረደች	Female	
ወረዳ	Other	
ወረጋ	Other	
ወረፋ	Male	
ወራሪ	Other	
ወራሽ	Other	
ወራቂ	Other	
ወራት	Other	
ወራጅ	Other	
ወሬሳ	Other	
ወሬኛ	Other	
ወሬዛ	Other	
ወር	Other	
ወር ነሽ	Female	
ወርሃዊ	Other	
ወርቀ ዘቦ	Other	
ወርቁ	Male	
ወርቂቱ	Female	
ወርቂት	Female	
ወርቃማ	Other	
ወርቄ	Both	
ወርቅ	Female	
ወርቅአማኑኤል	Both	
ወርቅአበባ	Female	
ወርቅአየሁ	Female	
ወርቅአገኘሁ	Both	
ወርቅአፈራሁ	Female	
ወርቅውሃ	Female	
ወርቅዓለማሁ	Female	
ወርቅዓለም	Both	
ወርቅያንጥፉ	Female	
ወርቅ ነህ	Male	
ወርቅ ነሽ	Female	
ወርቅቾ	Other	
ወርቅዬ	Both	
ወርቅነህ	Male	
ወርች	Other	
ወርካዬ	Other	
ወርድ	Other	
ወርዶፋ	Male	
ወርጅ	Other	
ወርጅብኝ	Other	
ወሮ በላ	Other	
ወሮታ	Other	
ወሰኑ	Other	
ወሰኔ	Both	
ወሰን	Both	
ወሰንሰገድ	Male	
ወሰንየለሽ	Female	
ወሰካ	Unknown	
ወሳኝ	Other	
ወሳፍቻ	Other	
ወስላታ	Other	
ወስከምባይ	Other	
ወስፈንጠር	Other	
ወስፈንጥር	Other	
ወስፋት	Other	
ወስፌ	Other	
ወሸላ	Other	
ወሽመጥ	Other	
ወቀሳ	Other	
ወቄት	Other	
ወቅታዊ	Other	
ወቅት	Other	
ወባ	Other	
ወቦ	Other	
ወተት	Other	
ወታደራዊ	Other	
ወታደር	Other	
ወትሮ	Other	
ወና	Other	
ወናሄ	Other	
ወናጉ	Unknown	
ወናግ	Other	
ወናጐ	Other	
ወናፍ	Other	
ወንበር	Other	
ወንበዴ	Other	
ወንዝ	Other	
ወንደ ላጤ	Other	
ወንዳ ወንድ	Other	
ወንዳ ገረድ	Other	
ወንዱ	Male	
ወንዳየሁ	Male	
ወንዳፈረው	Male	
ወንዳጥር	Male	
ወንዴ	Male	
ወንድ	Other	
ወንድ አፍራሽ	Male	ወንዳፍራሽ
ወንድ ይራድ	Male	
ወንድ ይፍራው	Male	
ወንድሙ	Male	
ወንድማማች	Other	
ወንድማማቾች	Other	
ወንድማገኝ	Male	
ወንድሜነህ	Male	
ወንድም	Male	
ወንድም ነህ	Unknown	
ወንድም አገኘሁ	Unknown	
ወንድም አገኝ	Unknown	ወንድማገኝ
ወንድምአገኘሁ	Male	ወንድማገኘሁ
ወንድምዬ	Male	
ወንድወሰን	Male	
ወንድአየሁ	Male	
ወንድይራድ	Male	
ወንድይፍራው	Male	
ወንዶ	Other	
ወንጀለኛ	Unknown	
ወንጀል	Other	
ወንጂ	Other	
ወንጅለኛ	Other	
ወንጋያ	Other	
ወንጌላዊ	Unknown	
ወንጌላዊት	Female	
ወንጌል	Both	
ወንጠፍት	Other	
ወንጭፍ	Other	
ወንፈል	Other	
ወንፊት	Other	
ወኪል	Other	
ወዘተርፈ	Other	
ወዘና	Other	
ወዝ	Other	
ወዝ አደር	Government	
ወዝ አደሮች	Government	
ወያ	Other	
ወያኔ	Other	
ወይነ ጠጅ	Unknown	
ወይኒቱ	Female	
ወይና ደጋ	Unknown	
ወይኔ	Other	
ወይን	Other	
ወይንሐረግ	Female	
ወይንሸት	Female	
ወይንአበባ	Female	
ወይዘሪት	Other	
ወይዘሮ	Other	
ወይጦ	Other	
ወይፈን	Other	
ወደ ኋላ	Other	
ወደ ፊት	Other	
ወደላ	Other	
ወደል	Other	
ወደሬ	Both	
ወደር	Female	
ወደር የለሽ	Female	
ወደር የለህ	Male	
ወደብ	Other	
ወዳድ	Other	
ወዳጄ	Male	
ወዳጄነህ	Male	
ወዳጅ	Male	
ወዳጆ	Male	
ወድ ይፍራው	Unknown	
ወድም አገኛሁ	Male	
ወድቅት	Unknown	
ወገል	Other	
ወገራ	Other	
ወገርት	Other	
ወገብ	Other	
ወገብጌ	Other	
ወገኔ	Male	
ወገን	Male	
ወገኛ	Don't Know	
ወገዲ	Unknown	
ወጉ	Male	
ወጋየሁ	Male	
ወጋገራ	Other	
ወጋግራ	Unknown	
ወጌላዊ	Other	
ወጌሻ	Other	
ወግ	Other	
ወግ አራቂ	Unknown	
ወግ አየሁ	Male	
ወግ አጥባቂ	Unknown	
ወግ ደረሰኝ	Male	
ወግ ደረስ	Male	
ወግ ዳር	Unknown	
ወግሊያ	Other	
ወግደረስ	Male	
ወግዴ	Other	
ወጠጤ	Other	
ወጣት	Other	
ወጣቶች	Other	
ወጥ	Other	
ወጥመድ	Other	
ወጨፎ	Other	
ወጭት	Other	
ወፈፌ	Other	
ወፈፍተኛ	Other	
ወፍ	Other	
ወፍ አንቁር	Unknown	
ወፍላ	Other	
ወፍራም	Other	
ወፍጮ	Other	
ውልታ	Female	
ዊልያም	Male	foreign name
ዋህድ	Male	
ዋለሉ	Other	
ዋለልኝ	Female	
ዋሉ	Male	
ዋልታ	Other	
ዋልተንጉስ	Male	
ዋልያ	Other	
ዋልድባ	Other	
ዋልጋ	Other	
ዋልጌ	Other	
ዋሚ	Male	
ዋምራ	Other	
ዋርሳ	Other	
ዋርካ	Other	
ዋርዳ	Other	
ዋርዴ	Other	
ዋሱ	Male	
ዋሴ	Male	
ዋስ	Male	
ዋስ ይሁን	Male	ዋሲሁን
ዋስትና	Other	
ዋሻ	Other	
ዋሽንት	Other	
ዋቃ	Other	
ዋቀዮ	Male	
ዋቃ	Male	
ዋቄ	Male	
ዋቅ ጂራ	Unknown	
ዋቅ ጅራ	Male	
ዋቅቶላ	Male	
ዋቆ	Male	
ዋቢ ሸበሌ	Place	
ዋቢላ	Male	
ዋቤላ	Other	
ዋቶ አደር	Unknown	
ዋና	Other	
ዋኔ	Other	
ዋንዛ	Other	
ዋንጫ	Other	
ዋኩማ	Male	
ዋኬኔ	Male	
ዋዜማ	Male	
ዋዠራ	Other	
ዋይታ	Other	
ዋድላ	Other	
ዋድያት	Other	
ዋጃ	Other	
ዋጅራት	Other	
ዋገምት	Other	
ዋጋው	Male	
ዋጋሽ	Female	
ዋጋዬ	Both	
ዋግ	Other	
ዋግነው	Male	
ዋግ ሹም	Unknown	
ዋጮ	Other	
ውሂብ	Male	
ውሂበስላሴ	Male	
ውሃ	Other	
ውሃ ገብ	Unknown	
ውህደት	Other	
ውለታ	Male	
ውለታው	Male	
ውላጅ	Other	
ውል	Other	
ውልብልቢት	Other	
ውራጅ	Other	
ውርማ	Other	
ውርርድ	Other	
ውርስ	Other	
ውርንጫ	Other	
ውርንጭላ	Other	
ውርዴ	Other	
ውርጅብኝ	Unknown	
ውርጋጥ	Other	
ውርጌሳ	Other	
ውሳኔ	Other	
ውሳጣዊ	Other	
ውስብስብ	Other	
ውስጣዊ	Unknown	
ውስጥ	Other	
ውሻ	Other	
ውሻል	Other	
ውሽማ	Other	
ውሽንፍር	Other	
ውቂያ	Other	
ውቃቢ	Other	
ውቃው	Other	
ውቅራት	Other	
ውቅሮ	Other	
ውቅያኖስ	Other	
ውበቴ	Female	
ውበት	Male	
ውቢቱ	Female	
ውቢት	Female	
ውባለ	Male	
ውባለሰው	Male	
ውባለች	Female	
ውባየሁ	Both	
ውብ	Male	
ውብ ሻው	Unknown	
ውብ ታዬ	Unknown	
ውብ ነህ	Male	
ውብ ነሽ	Female	
ውብ አለ	Unknown	
ውብ አለ ሰው	Unknown	
ውብ እሽት	Male	ውብሸት
ውብ ርስት	Male	
ውብ አንተ	Male	
ውብ አዲስ	Both	
ውብ አለም	Both	
ውብ እጅግ	Both	
ውብታዬ	Female	
ውቤ	Both	
ውትድርና	Other	
ውንደ ላጤ	Unknown	
ውዝፍ	Other	
ውዠንብር	Unknown	
ውይይት	Other	
ውዲቱ	Other	
ውዳሴ	Both	
ውዳቂ	Male	
ውዴ	Both	
ውዴታ	Other	
ውድ	Male	
ውድ ነህ	Male	
ውድ ነሽ	Female	
ውድማ	Male	
ውድቀት	Male	
ውድቅት	Other	
ውድነህ	Male	
ውድድር	Other	
ውጅራ	Male	
ውገያ	Other	
ውጉዘ	Unknown	
ውጉዝ	Other	
ውጊያ	Unknown	
ውጋት	Other	
ውጋጋን	Other	
ውጣ ውረድ	Other	
ውጤት	Other	
ውጥረት	Other	
ውጥንቅጥ	Other	
ውጫሌ	Other	
ውጭ	Other	
ዎለንኮሚ	Other	
ዎርዶፋ	Male	
ዎሮታ	Other	
ዎታንጐ	Other	
ዐምደ	Male	
ዐስራተ	Male	
ዐይነ	Other	
ዑስማን	Male	
ዑቅበአብ	Male	
ዑቅባይ	Male	
ዓለመስላሴ	Male	
ዓለሙ	Male	
ዓለሚቱ	Female	
ዓለማየሁ	Male	
ዓለሜ	Both	
ዓለም	Both	
ዓለምሰገድ	Male	
ዓለምሸዋ	Both	
ዓለምነህ	Male	
ዓለምነሽ	Female	
ዓለምእሸት	Both	
ዓለምዘውድ	Both	
ዓለምፀሐይ	Both	
ዓይናለም	Female	
ዓይንአዲስ	Female	
ዓይንአበባ	Female	
ዓሊ	Male	
ዓምደ	Male	
ዓንዶም	Male	
ዕቁባ	Other	
ዕቁበሚካኤል	Male	
ዕቁበማርያም	Male	
ዕቁበስላሴ	Male	
ዕቁበብርሃን	Male	
ዕቁበእዝጊ	Male	
ዕቁበጽዮን	Male	
ዕቁባይ	Male	
ዕንቁ	Male	
ዕንቁሐዋርያት	Male	
ዕንቁስላሴ	Male	
ዕንቁባሕሪ	Male	
ዕውራን	Other	
ዘሃራ	Female	
ዘለለ	Male	
ዘለለው	Male	
ዘለላ	Female	
ዘለሰኛ	Male	
ዘለስ	Other	
ዘለስኛ	Unknown	
ዘለቀ	Male	
ዘለቃ	Female	
ዘለቃሽ	Female	
ዘለቄታ	Other	
ዘለበት	Other	
ዘለኣለማዊ	Other	
ዘለኣለም	Both	
ዘለፋ	Other	
ዘላቂ	Other	
ዘላን	Other	
ዘሌዋውያን	Other	
ዘሔቦ	Other	
ዘመሚት	Other	
ዘመነ	Male	
ዘመናዊ	Other	
ዘመን	Other	
ዘመንፈስ	Male	
ዘመዱ	Other	
ዘመድ	Other	
ዘመድ ሁን	Other	
ዘመድ ኩን	Other	
ዘሙ	Unknown	
ዘሙይ	Male	
ዘሚካኤል	Male	
ዘማ	Other	
ዘማኑኤል	Unknown	
ዘማዊ	Other	
ዘሜ	Other	
ዘምባባ	Male	
ዘምዘም	Female	
ዘረ	Other	
ዘረእዝጊ	Male	
ዘረሰናይ	Male	
ዘረኛ	Other	
ዘረኛነት	Other	
ዘረፉ	Female	
ዘሩ	Male	
ዘሩባቤል	Other	
ዘሩፋኤል	Male	
ዘሪሁን	Male	ዘሪይሁን
ዘሪሁይን	Male	
ዘሪይሁን	Male	
ዘሪቱ	Female	
ዘራፌ	Other	
ዘር	Other	
ዘር ትሁን	Female	
ዘር አብሩክ	Male	
ዘር ይሁን	Male	
ዘርአ ብርክ	Unknown	
ዘርአ የእቆብ	Male	
ዘርአ ያእቆብ	Male	
ዘርአይ	Male	
ዘርኡ	Male	
ዘርኣም	Other	
ዘርእ ሰናይ	Male	
ዘርኦም	Male	
ዘርጊ	Unknown	
ዘርጋው	Male	
ዘርፈሸዋል	Female	
ዘርፉ	Male	
ዘርፌ	Female	
ዘርፍ	Male	
ዘርፍ ነሽ	Female	
ዘቃቅቤ	Other	
ዘበርጋ	Male	
ዘበት	Other	
ዘበናይ	Female	
ዘበኛ	Other	
ዘቢባ	Female	
ዘቢብ	Female	
ዘቢዳ	Female	
ዘብ	Other	
ዘብ ይደሩ	Female	
ዘብዴዎስ	Male	
ዘብጥ	Other	
ዘብጥያ	Other	
ዘነበ	Male	
ዘነበወርቅ	Both	
ዘነበች	Female	
ዘነብ	Female	
ዘንቢል	Other	
ዘንባባ	Both	
ዘንካታ	Other	
ዘንዘራ	Other	
ዘንድሮ	Other	
ዘንጋዳ	Other	
ዘንግ	Other	
ዘአማኒኤል	Female	
ዘአብ	Other	
ዘኢትዮጵያ	Other	
ዘኪሮስ	Male	
ዘካሪያስ	Male	
ዘካርያስ	Male	ዘካሪያስ
ዘኬ	Male	
ዘኬዎስ	Male	
ዘወልዴ	Male	
ዘወርዋራ	Both	
ዘወንጌል	Male	
ዘዋሪ	Other	
ዘውልዴ	Male	
ዘውደኛ	Other	
ዘውዱ	Male	
ዘውዲ	Female	
ዘውዲቱ	Female	
ዘውዳዊ	Other	
ዘውዴ	Both	
ዘውድ	Male	
ዘውድ ነህ	Male	
ዘውድ ነሽ	Female	
ዘውድነሽ	Female	
ዘውገ	Male	
ዘየደች	Other	
ዘዬ	Other	
ዘይላ	Other	
ዘይቤ	Other	
ዘይቱን	Female	
ዘይት	Other	
ዘይነባ	Female	
ዘይነብ	Female	
ዘይኑ	Female	
ዘይን	Other	
ዘይዳን	Other	
ዘዴኛ	Other	
ዘድንግል	Other	
ዘገብርኤል	Male	
ዘገየ	Male	
ዘገየሁ	Other	
ዘገዩ	Other	
ዘገዬ	Male	
ዘገዬሁ	Unknown	
ዘጊዮርጊስ	Male	
ዘጠና	Other	
ዘጠኘኛ	Unknown	
ዘጠኝ	Other	
ዘጠኝኛ	Other	
ዘፈሩ	Other	
ዘፈን	Other	
ዘፋኝ	Other	
ዙረት	Other	
ዙሪያሽ	Female	
ዙሪያሽወርቅ	Female	
ዙበር	Male	
ዙብይዳ	Female	
ዙቤዳ	Female	
ዙፋን	Female	
ዚቅ	Other	
ዚነቱ	Female	
ዛህራ	Female	
ዛላ	Other	
ዛሬ	Other	
ዛር	Other	
ዛቢር	Other	
ዛቢያ	Other	
ዛብሎን	Other	
ዛብሽ	Other	
ዛቻ	Other	
ዛኒጋባ	Other	
ዛንጀሮ	Other	
ዛኪር	Other	
ዛይኑ	Other	
ዛይድ	Male	
ዛይዳ	Female	
ዛፉ	Male	
ዛዲግ	Male	
ዛጐል	Other	
ዜና	Male	
ዜናማርቆስ	Male	
ዜናዊት	Female	
ዜናሽወርቅ	Female	
ዜናዊ	Male	
ዜናነህ	Male	
ዜጋ	Male	
ዜግነት	Government	
ዝሆኔ	Other	
ዝሆን	Other	
ዝልል	Other	
ዝልግልግ	Other	
ዝሙተኛ	Other	
ዝሙት	Other	
ዝሚሩ	Other	
ዝማሜ	Male	
ዝማም	Female	
ዝማምነሽ	Female	
ዝማሬ	Male	
ዝምብ	Male	
ዝምተኛ	Other	
ዝምታ	Both	
ዝምታወርቅ	Both	
ዝምድና	Other	
ዝርያ	Other	
ዝርግ	Other	
ዝርግፍ	Other	
ዝርፊያ	Other	
ዝርፍጥ	Other	
ዝቃጭ	Other	
ዝቅ አርጋቸው	Other	
ዝቅ አርጋችው	Other	
ዝቅተኛ	Other	
ዝቅዝቅ	Other	
ዝባዝንኬ	Other	
ዝባድ	Other	
ዝብርቅርቅ	Other	
ዝብድይ	Unknown	
ዝተት	Unknown	
ዝና	Male	
ዝናህ	Male	
ዝናር	Other	
ዝናሽ	Female	
ዝናሽወርቅ	Female	
ዝናሽብዙ	Female	
ዝናቡ	Male	
ዝናብ	Other	
ዝንባሌ	Other	
ዝንብ	Other	
ዝንብሌ	Other	
ዝንጀሮ	Other	
ዝንጅሮ	Unknown	
ዝንጉ	Other	
ዝንጉርጉር	Other	
ዝክሩፋ	Don't Know	
ዝክር	Other	
ዝዋይ	Place	
ዝውውር	Other	
ዝይ	Other	
ዝይን	Other	
ዝገት	Other	
ዝግባ	Other	
ዝግታ	Other	
ዝግን	Other	
ዝግጅት	Other	
ዞማ	Female	
ዞብል	Other	
ዞጲ	Other	
ዣን	Other	
ዥግራ	Other	
የሁለተኛው	Other	
የሁሉም	Other	
የሃንሱ	Don't Know	
የህዝብ	Other	የሕዝብ
የለሽ	Other	
የልፍኝ	Both	
የሎስ	Other	
የሐረርጌ	Other	
የሕዝብ	Other	
የሕፃናት	Other	
የመርሐ	Other	
የመስቀል ወፍ	Other	
የመተባበር	Other	
የመንበረ	Other	
የመንዝወርቅ	Female	
የመጽሐፍ	Other	
የማር እሸት	Both	
የማታ	Other	
የማታወርቅ	Both	
የማነ	Male	
የማነህ	Male	
የማነብርሃን	Male	
የሜዳ አህያ	Other	
የምሩ	Male	
የምስራቅ	Other	
የምስራች	Both	
የምሻው	Male	
የምወድሽ	Female	
የምድር	Other	
የሥራ	Other	
የሥጋት	Other	
የረር	Other	
የሩቅ	Female	
የራስወርቅ	Female	
የሮም	Female	
የሮም ነሽ	Female	
የሮም ንሽ	Unknown	
የሰራዊተ	Other	
የሰውልክ	Other	
የሱ	Other	
የሱሳዊት	Female	
የሱስ	Male	
የሱፍ	Other	
የስጋት	Other	የሥጋት
የስፖርት	Other	
የሸዋ ልኡል	Female	
የሸዋ መብራት	Female	
የሹሜ	Other	
የሹም ነሽ	Female	
የሺ	Female	
የሺመቤት	Female	
የሻረግ	Female	
የሻሸ ወርቅ	Female	
የሻነህ	Male	
የሻነው	Male	
የሻው	Male	
የሽዋሃረግ	Female	
የሽዋራስ	Female	
የሽዋብርሃን	Both	
የሽዋወርቅ	Female	
የሽዋዘርፍ	Female	
የሽዋዘውድ	Both	
የሽዋጌጥ	Female	
የሽዋፀሐይ	Both	
የሽዋ ልኡል	Female	
የሽዋ መብራት	Female	
የሺወርቅ	Both	
የሺጥላ	Male	
የሺጌታ	Male	
የቀኃይለ	Don't Know	
የቃለ	Other	
የቅዱስ	Other	
የበላይ	Other	
የበላይነት	Other	
የበታች	Other	
የበታችነት	Other	
የቡ	Other	
የባሕር	Other	
የቤተ	Other	
የብስ	Other	
የተመኝ	Female	
የተምሮ	Other	
የተሻ	Other	
የተሻ 	Unknown	
የተሻው	Other	
የተባበሩት	Other	
የትም	Female	
የትምወርቅ	Female	
የትናየት	Both	
የትምህርት	Other	
የኃላ	Other	
የኋላ	Male	
የኋላእሸት	Male	
የኔ	Other	
የኔ ሰው	Male	
የኔ ነህ	Male	
የኔ ነሽ	Female	
የኔወርቅ	Female	
የኔ ፋንታ	Male	
የንብረት	Other	
የንጉሠ	Other	
የአለም	Other	
የአምስት	Other	
የአረኪዎሎጂ	Other	
የአክሲዮን	Other	
የኢትዮጵያ	Other	
የኣለም	Other	የአለም
የኤርትራ	Other	
የእሑድ	Other	
የእስላም	Other	
የከሳቴ	Other	
የካ	Other	
የካቲት	Other	
የክብር	Other	
የወርቅ ውሃ	Female	
የወንድ ወሰን	Male	
የወንጌል	Both	
የወይን እሸት	Female	
የወይዘሮ	Other	
የወዲያ ነሽ	Female	
የወግ ነሽ	Female	
የወጣቶች	Other	
የዋህ	Other	
የውሃ ሽታ	Other	
የውል ሰው	Other	
የውብ ዳር	Both	
የውነቱ	Male	
የውነቴ	Other	
የዛሬይቱ	Other	
የደም ገንቦ	Other	
የደቴ	Unknown	
የዱር አራዊት	Other	
የዳግማዊ	Other	
የገዝ መደብ	Unknown	
የገዥ መዳብ	Government	
የገደል ማሚቶ	Other	
የገድል ማሚቶ	Unknown	
የጋራ	Other	
የጋርዮሽ	Other	
የግል	Other	
የግልነሽ	Female	
የግሎበ	Other	
የግርማዊ	Other	
የጡት ልጅ	Other	
የጥጥ	Other	
የጦር	Other	
የጭን ገረድ	Other	
የፈረስ	Other	
የፈረንሳይ	Other	
የፊጥኝ	Other	
የፍትሐ	Other	
የፕብሊክ	Don't Know	
ዩሱፍ	Male	
ዩኒቨርስቲ	Other	
ያህያ	Male	
ያለም	Both	
ያለምብርሃን	Both	
ያለምመብራት	Both	
ያለምእሸት	Both	
ያለምወርቅ	Both	
ያለው	Other	
ያልጋ ነሽ	Unknown	
ያመ ነሽ	Female	
ያመነሽ	Female	
ያምሮት	Female	
ያምሮቴ	Female	
ያረጋል	Male	
ያሬድ	Male	
ያሲን	Male	
ያስችለዋል	Other	
ያኑስ	Male	
ያኒ	Male	
ያኔ	Other	
ያንጥፉ	Female	
ያእቆብ	Male	ያዕቆብ
ያዕቆብ	Male	
ያዘው	Other	
ያየህ ይራድ	Male	
ያየሽ	Female	
ያዩ	Female	
ያይኔ አበባ	Female	
ያይን ኣለም	Female	
ያይንሸት	Female	
ያደታ	Male	
ያደግድጉ	Other	
ያጅቡሻል	Female	
ያገር	Other	
ያግብአ	Other	
ያፌት	Male	
ይሁን	Male	
ይሁኔ	Male	
ይሁዲ	Other	
ይሁዳ	Other	
ይሄይስ	Male	ይኄይስ
ይህ	Other	
ይህች	Other	
ይህደጋ	Other	
ይህደጐ	Male	
ይለፍ	Other	
ይሉኝታ	Other	
ይላላ	Other	
ይላቅ	Male	
ይላኩ	Other	
ይልማ	Male	
ይመር	Male	
ይመስገን	Male	
ይመችሻል	Other	
ይመኑ	Male	
ይመኔ	Male	
ይመኙሻል	Female	
ይማሙ	Male	
ይማም	Male	
ይማር	Other	
ይምርሃነ	Other	
ይምታቱ	Other	
ይምአታ	Other	
ይራድ	Male	
ይርሳው	Other	
ይርዳው	Male	
ይርገዱ	Male	
ይርጉ	Male	
ይርጋ	Male	
ይርጋ አለም	Male	
ይርጋ ኣለም	Place	
ይርጋ ጨፌ	Place	
ይስሀቅ	Male	ይስሐቅ
ይስሐቅ	Male	
ይስሙ	Other	
ይስሙላ	Other	
ይስማ	Male	
ይስማሸዋ	Male	
ይስማው	Other	
ይስገዱ	Other	
ይስፋ ወሰን	Unknown	
ይሻሙ	Other	
ይሻሙሽ	Other	
ይበርታ	Other	
ይበሳ	Other	
ይቤቶ	Other	
ይብርሁ	Other	
ይብሳ	Male	
ይብዛ	Other	
ይታክቱ	Other	
ይታየው	Male	
ይታገሱ	Male	
ይታይሽ	Female	
ይታጠቁ	Male	
ይትረፍ	Male	
ይትባረክ	Male	
ይኄይስ	Male	
ይነሱ	Other	
ይንሱ	Other	
ይንደጎ	Other	
ይኩኖ	Male	
ይኩኖአምላክ	Male	
ይኼይስ	Male	
ይዋብ	Male	
ይዘሽዋል	Female	
ይዘንጋው	Male	
ይዘት	Other	
ይዞታ	Other	
ይዞት	Other	
ይደነቁ	Male	
ይደነቅ	Male	
ይድነቃቸው	Male	
ይገምቱ	Other	
ይገባሀል	Other	
ይገባዋል	Male	
ይገባሻል	Female	
ይገባሃል	Other	
ይገብሩ	Male	
ይገዙ	Male	
ይጋርዱ	Male	
ይግለጡ	Male	
ይግባኝ	Other	
ይግዛው	Male	
ይጥና	Male	
ይፋ	Other	
ይፋቴ	Other	
ይፋት	Other	
ይፍሩ	Male	
ይፍራው	Male	
ይፍራሸዋ	Male	
ይፍቱ	Both	
ይፍቱሥራ	Both	
ይፍጋ	Other	
ይፍጠር	Male	
ዮሀንስ	Male	ዮሐንስ
ዮሐንስ	Male	
ዮርዳኖስ	Both	
ዮሲያስ	Male	
ዮሴፍ	Male	
ዮና	Don't Know	
ዮናስ	Male	
ዮናታን	Male	
ዮናኒ	Don't Know	
ዮአኪም	Male	foreign name
ዮዲት	Female	
ዮፍታሄ	Male	
ደሀራይ	Unknown	
ደሀብ	Female	
ደህራይ	Other	
ደህኔ	Don't Know	
ደህንነት	Other	
ደለለች	Other	
ደለለኝ	Male	
ደለሉ	Other	
ደለሎ	Other	
ደላላ	Other	
ደላንታ	Other	
ደላጐ	Other	
ደልዳላ	Other	
ደመረ	Male	
ደመረው	Male	
ደመሩ	Male	
ደመራ	Other	
ደመራው	Male	
ደመቀ	Male	
ደመቀች	Female	
ደመቁ	Female	
ደመቄ	Female	
ደመቅሳ	Male	
ደመና	Male	
ደመኛ	Other	
ደመወዜ	Male	
ደመወዝ	Male	
ደማ	Other	
ደማሚት	Other	
ደማኛ	Other	
ደሜ	Other	
ደም	Other	
ደም መላሽ	Male	
ደም ግባት	Other	
ደምለው	Male	
ደምላው	Other	
ደምሌ	Male	
ደምል	Other	
ደምሰው	Male	
ደምሳሽ	Male	
ደምሳቸው	Male	
ደምሴ	Male	
ደምስ	Male	
ደምበል	Other	
ደምቢ ዶሎ	Place	
ደምቦባ	Other	
ደሞዜ	Male	
ደሞዝ	Male	
ደረሰ	Male	
ደረሳ	Male	
ደረስ	Other	
ደረስጊ	Male	
ደረሶ	Other	
ደረባ	Other	
ደረት	Other	
ደረጀ	Male	
ደረጃ	Other	
ደረጃዎች	Other	
ደራ	Other	
ደራሞ ደራም	Unknown	
ደራሞ-ድራም	Other	
ደራሲ	Other	
ደራሲያን	Other	
ደሬሳ	Male	
ደርሂም	Don't Know	
ደርሞ	Other	
ደርሰህ	Other	
ደርሶማ	Other	
ደርባባው	Male	
ደርባቸው	Male	
ደርቤ	Male	
ደርጉ	Other	
ደርግ	Other	
ደሮማይ	Other	
ደሱ	Male	
ደሳለኝ	Male	
ደሳሳ	Other	
ደሳአለኝ	Male	
ደሳዮ	Unknown	
ደሴ	Male	
ደሴት	Other	
ደሴቶች	Other	
ደስሜ	Don't Know	
ደስታ	Male	
ደቀ መሀረ	Place	
ደቀ መዝሙር	Other	
ደቂቃ	Other	
ደቂቅ	Other	
ደቃ	Other	
ደቃቅ	Other	
ደበላ	Male	
ደበሌ	Male	
ደበሎ	Other	
ደበሳይ	Male	
ደበሽ	Male	
ደበበ	Male	
ደበበች	Female	
ደበኔ	Male	
ደበን አንሳ	Unknown	
ደቡባዊ	Other	
ደቡብ	Other	
ደባ	Other	
ደባል	Other	
ደባልቄ	Male	
ደባርቅ	Male	
ደባርዋ	Other	
ደባሱ	Male	
ደባስ	Male	
ደባይ	Other	
ደብረ	Other	
ደብረወርቅ	Female	
ደብረጽዮን	Male	
ደብረ ሲና	Place	
ደብረ ዳሞ	Place	
ደብሩ	Male	
ደብሪቱ	Female	
ደብሬ	Female	
ደብር	Other	
ደብተራ	Other	
ደብተር	Other	
ደብዛ	Other	
ደብዳቤ	Other	
ደብዳቤዎች	Other	
ደቦ	Other	
ደቦጭ	Male	
ደቻሳ	Male	
ደኑር	Male	
ደነቀ	Male	
ደነቀው	Male	
ደነባ	Other	
ደነዝ	Other	
ደናግል	Other	
ደን	Other	
ደንቀራ	Other	
ደንቀዝ	Other	
ደንበሌ	Other	
ደንበኛ	Other	
ደንበኞቻችን	Other	
ደንበኞች	Other	
ደንባሪ	Other	
ደንብ	Other	
ደንቦባ	Other	
ደንቦች	Other	
ደንከል	Other	
ደንከልያ	Other	
ደንከሎች	Other	
ደንካልያ	Other	
ደንደሮ	Other	
ደንድር	Male	
ደንደስ	Other	
ደንገላሳ	Don't Know	
ደንገጡር	Other	
ደንጐሎ	Other	
ደከሮ	Other	
ደካማ	Other	
ደወል	Other	
ደዌ	Other	
ደዎ	Other	
ደያሱ	Other	
ደያስ	Male	
ደያሶ	Other	
ደይን	Other	
ደደሆ	Other	
ደደር	Other	
ደደብ	Other	
ደጀ ሰላም	Other	
ደጀኑ	Male	
ደጀኔ	Male	
ደጀን	Male	
ደጁ	Male	
ደጃዝማች	Other	
ደጃፍ	Other	
ደጅ	Other	
ደጅ ይትኑ	Unknown	
ደጅ ይጥኑ	Other	
ደገፉ	Male	
ደገፋ	Male	
ደጉ	Male	
ደጊቱ	Female	
ደጋ	Other	
ደጋን	Other	
ደጋጋ	Other	
ደጌ	Male	
ደግነህ	Male	
ደግነሽ	Female	
ደግለሃን	Don't Know	
ደግነት	Male	
ደግዳጋ	Other	
ደግፌ	Male	
ደፈረሱ	Male	
ደፈጣ	Other	
ደፈጫ	Other	
ደፋረሳ	Other	
ደፋር	Male	
ዱለት	Other	
ዱለቻ	Other	
ዱለኛ	Other	
ዱላ	Male	
ዱልዱም	Other	
ዱሎ	Other	
ዱሜሳ	Other	
ዱረቲ	Other	
ዱሪ	Male	
ዱራሜ	Other	
ዱር	Other	
ዱርዬ	Other	
ዱሮ	Other	
ዱሽ	Other	
ዱቄት	Other	
ዱበርቲ	Other	
ዱባ	Other	
ዱባለ	Male	
ዱቤ	Male	
ዱብ አለ	Male	
ዱብ እዳ	Other	
ዱኪ	Unknown	
ዱካ	Other	
ዱኬ	Other	
ዱዳ	Other	
ዱፍቲ	Other	
ዱግማ	Male	
ዲላ	Other	
ዲማ	Other	
ዲሞፍተር	Other	
ዲሬክሲዮን	Other	
ዲሪባ	Male	
ዲባባ	Male	
ዲሮ	Other	
ዲሳሳ	Male	
ዲቃላ	Other	
ዲበ	Male	
ዲብ	Other	
ዲታ	Male	
ዲንሳ	Male	
ዲንሾ	Other	
ዲያቆን	Other	
ዲያብሎስ	Other	
ዲዮስቆሮስ	Don't Know	
ዲዮቅልጥያኖስ	Don't Know	
ዲዲሞ	Don't Know	
ዲድስቅልያ	Don't Know	
ዳሌ	Other	
ዳልቻ	Male	
ዳልጋ	Other	
ዳመነ	Male	
ዳመኑ	Male	
ዳመና	Male	
ዳማ	Male	
ዳምጠው	Male	
ዳምጣቸው	Male	
ዳምጤ	Male	
ዳሞት	Other	
ዳሞትራ	Other	
ዳረጐት	Other	
ዳሪሙ	Other	
ዳሪቱ	Female	
ዳር	Other	
ዳርም የለሽ	Female	
ዳርቻ	Other	
ዳርጌ	Male	
ዳስ	Other	
ዳሸን	Place	
ዳሹ	Other	
ዳበሳ	Male	
ዳቢት	Other	
ዳባ	Male	
ዳባሽ	Other	
ዳባት	Other	
ዳቤ	Other	
ዳቦ	Other	
ዳተኛ	Other	
ዳንኤል	Male	ዳንዔል
ዳንኪራ	Other	
ዳንዬል	Male	
ዳንዴ	Other	
ዳንግላ	Other	
ዳንግሌ	Other	
ዳኘ	Male	
ዳኘው	Male	
ዳኛ	Male	
ዳኛቸው	Male	
ዳኛችው	Unknown	
ዳኜ	Male	
ዳካ	Other	
ዳክዬ	Other	
ዳዉድ	Male	
ዳዊት	Male	
ዳዋ	Other	
ዳውላ	Other	
ዳውንት	Other	
ዳውድ	Male	
ዳውዶ	Other	
ዳውጃ	Other	
ዳዲ	Male	
ዳገት	Other	
ዳጉሳ	Other	
ዳግመኛ	Other	
ዳግማዊ	Male	
ዳግማዊት	Female	
ዳግም	Male	
ዳግምዊ	Male	
ዳጨው	Other	
ዳፍንታም	Other	
ዳፍንት	Other	
ዴልቻ	Other	
ዴሬሳ	Male	
ዴጋሳ	Other	
ድሀነት	Unknown	
ድሁር	Other	
ድሃ	Other	
ድህረ ምረቃ	Other	
ድህረ ቃል	Other	
ድህራ ምረቃ	Unknown	
ድህነት	Other	
ድል	Other	
ድል ነሳሁ	Male	
ድል ነሳው	Male	
ድልህ	Other	
ድልባን	Other	
ድልብ	Other	
ድልዝ	Other	
ድልድል	Other	
ድልድይ	Other	
ድሎት	Other	
ድመት	Other	
ድማሙ	Male	
ድሜጥሮስ	Other	
ድም ግባት	Unknown	
ድምበል	Other	
ድምቡሼ	Other	
ድምቢጥ	Other	
ድምብላል	Other	
ድምኳን	Other	
ድምጸ	Other	
ድምጻዊ	Other	
ድምጻውያን	Other	
ድምጼ	Other	
ድምጽ	Other	
ድምፅ	Other	
ድረሴ	Other	
ድረስ	Male	
ድሪ	Other	
ድሪባ	Male	
ድራር	Other	
ድሬ ዳዋ	Place	
ድርሞ	Unknown	
ድርሻ	Other	
ድርሻዬ	Male	
ድርቆሽ	Other	
ድርብ	Other	
ድርብርብ	Other	
ድርቧ	Other	
ድርጃ	Other	
ድርጅት	Other	
ድርጐ	Other	
ድርጭት	Other	
ድስት	Other	
ድቀት	Other	
ድቁስ	Other	
ድቁና	Other	
ድበላ	Other	
ድቡልቡል	Other	
ድቢ	Other	
ድባብ	Both	
ድባቤ	Both	
ድቤ	Other	
ድብ	Other	
ድብ እዳ	Unknown	
ድብልቅ	Other	
ድብልቅልቅ	Other	
ድብሪቱ	Female	
ድብሬ	Other	
ድብቁ	Other	
ድብኝት	Other	
ድብደባ	Other	
ድብዳብ	Other	
ድንቀራ	Other	
ድንቁ	Male	
ድንቁት	Other	
ድንቄ	Both	
ድንቅ	Other	
ድንቂቱ	Female	
ድንቅ ነሽ	Female	
ድንቅነሽ	Female	
ድንቋ	Female	
ድንበሩ	Male	
ድንበር	Male	
ድንቡሎ	Other	
ድንች	Other	
ድንክ	Other	
ድንክዬ	Other	
ድንኳን	Other	
ድንገተኛ	Other	
ድንጉላ	Other	
ድንጉዜ	Other	
ድንጉጥ	Other	
ድንጋያማ	Other	
ድንጋይ	Other	
ድንግል	Other	
ድንፋታ	Other	
ድኝ	Other	
ድኩላ	Other	
ድኩማን	Other	
ድኩም	Other	
ድውያን	Other	
ድውይ	Other	
ድድ	Other	
ድጅኖ	Other	
ድጉማ	Other	
ድጉስ	Other	
ድጋፌ	Male	
ድጋፍ	Male	
ድግ	Other	
ድግምት	Other	
ድግስ	Other	
ድግጣ	Other	
ድጐማ	Other	
ድጓ	Other	
ድፋባቸው	Male	
ድፋት	Other	
ድፋዬ	Other	
ድፎ	Other	
ዶለዝ	Other	
ዶማ	Other	
ዶርዜ	Other	
ዶርዜ ሀይዞ	Other	
ዶሮ	Other	
ዶሴ	Other	
ዶሴኛ	Other	
ዶቃ	Don't Know	
ዶባ	Other	
ዶቲ	Unknown	
ዶቴ	Other	
ዶኬ	Other	
ዶዮ	Other	
ዶዶላ	Other	
ዶግ	Other	
ዶጮ	Other	
ዶፈር	Other	
ዶፍ	Other	
ዶፎ	Don't Know	
ጀሀር	Other	
ጀሊል	Other	
ጀላል	Other	
ጀሌ	Other	
ጀልባ	Other	
ጀልዱ	Other	
ጀማ ነህ	Male	
ጀሚላ	Female	
ጀማነሽ	Female	
ጀማል	Male	
ጀሚል	Male	
ጀምስ	Male	foreign name
ጀምበሩ	Male	
ጀምበሬ	Male	
ጀምበር	Male	
ጀምበርነሽ	Female	
ጀርባ	Other	
ጀበና	Other	
ጀቢሳ	Other	
ጀባር	Other	
ጀቤሳ	Unknown	
ጀብደኝነት	Other	
ጀብዱ	Male	
ጀንበሬ	Male	
ጀንብ	Don't Know	
ጀግና	Other	
ጀግንነት	Other	
ጀግኖች	Other	
ጁሀር	Male	
ጂል	Other	
ጂማ	Male	
ጂማወርቅ	Female	
ጂራሞ	Other	
ጂሬ	Other	
ጂብሪል	Male	
ጂን	Other	
ጂግሳ	Other	
ጃለታ	Male	
ጃቢር	Male	
ጃምቦ	Other	
ጃምዮ	Other	
ጃርት	Other	
ጃቢር	Other	
ጃን	Other	
ጃን ሜዳ	Place	
ጃን ጥራር	Unknown	
ጃንደረባ	Other	
ጃኖ	Other	
ጃፈር	Other	
ጃፈሮ	Other	
ጃፋር	Male	
ጄሶ	Other	
ጅሁር	Male	
ጅማ	Other	
ጅማታም	Other	
ጅማት	Other	
ጅምላ	Other	
ጅረት	Other	
ጅሩ	Other	
ጅራት	Other	
ጅራፍ	Other	
ጅባት	Other	
ጅብ	Other	
ጅብሩክ	Other	
ጅንፎ	Other	
ጅው ጅው	Other	
ጅውጅው	Other	
ጅጅጋ	Other	
ጅጌ	Other	
ጅግራ	Other	
ጅፋር	Other	
ጆቢራ	Other	
ጆቴ	Other	
ጆንያ	Other	
ጆፌ	Other	
ጆፍጆፌ	Other	
ገሀ	Other	
ገሃነም	Other	
ገሃድ	Other	
ገለልተኛ	Other	
ገለምሶ	Other	
ገለባ	Other	
ገለብ	Other	
ገለቱ	Male	
ገለታ	Male	
ገለታው	Male	
ገለልቻ	Male	
ገለፈት	Other	
ገሊላ	Both	
ገሊላዊ	Other	
ገላ	Male	
ገላ ሁን	Male	
ገላ ነህ	Male	
ገላ ነሽ	Female	
ገላሁን	Male	
ገላሲ	Other	
ገላትያ	Other	
ገላና	Male	
ገላን	Male	
ገላው	Male	
ገላውዴዎስ	Male	
ገላዬ	Male	
ገላጋይ	Other	
ገላግሌ	Male	
ገል	Other	
ገልቱ	Other	
ገልጃጃ	Other	
ገመምተኛ	Other	
ገመሬ	Other	
ገመቹ	Male	
ገመች	Male	
ገመና	Other	
ገመዳ	Male	
ገመድ	Other	
ገመገም	Other	
ገማ	Other	
ገማልኤል	Other	
ገሜሳ	Other	
ገምቢ	Other	
ገምባሌ	Other	
ገምታ	Other	
ገምጋሚ	Other	
ገምጦ ወጥ	Unknown	
ገሞራ	Other	
ገሞራው	Male	
ገሠሠ	Male	
ገሠሠች	Female	
ገረመው	Male	
ገረሱ	Male	
ገረድ	Other	
ገሪማ	Male	
ገራም	Other	
ገራገር	Other	
ገራፊ	Other	
ገርማሜ	Male	
ገርቢ	Other	
ገሰሰ	Male	ገሠሠ
ገሰሰች	Other	
ገሰሰው	Male	
ገሳ	Other	
ገበሎ	Other	
ገበሬ	Other	
ገበታ	Other	
ገበቴ	Other	
ገበዝ	Other	
ገበየሁ	Male	
ገበያ ነሽ	Female	
ገበያው	Male	
ገበጣ	Other	
ገቢ	Other	
ገቢር	Other	
ገቢሳ	Male	
ገባር	Other	
ገቤሳ	Male	
ገብ	Other	
ገብረ	Male	
ገብረ ጉራቻ	Place	
ገብረ ጉንዳን	Unknown	
ገብረሐና	Male	
ገብረሐዋርያት	Male	
ገብረሕይወት	Male	
ገብረመስቀል	Male	
ገብረመድኅን	Male	
ገብረሚካኤል	Male	
ገብረማርያም	Male	
ገብረስላሴ	Male	ገብረሥላሴ
ገብረብርሃን	Male	
ገብረተንሳይ	Male	ገብረተንሣይ
ገብረአምላክ	Male	
ገብረአብ	Male	
ገብረእዝጊ	Male	
ገብረእግዚአብሄር	Male	
ገብረኪዳን	Male	
ገብረክርሰቶስ	Male	
ገብረወልድ	Male	
ገብረየሱስ	Male	
ገብረየስ	Male	
ገብረዮሐንስ	Male	
ገብረጊዮርጊስ	Male	
ገብረጻዲቅ	Male	
ገብሩ	Male	
ገብራት	Male	
ገብራይ	Male	
ገብሬ	Male	
ገብር ኤሏ	Unknown	
ገብርኤል	Male	
ገብርኤሏ	Female	
ገብርዬ	Male	
ገብነት	Other	
ገብጋባ	Other	
ገትየ	Other	
ገቺ	Other	
ገቻ	Unknown	
ገች	Unknown	
ገነሞ	Male	
ገነቲ	Unknown	
ገነቴ	Both	
ገነት	Both	
ገነነ	Male	
ገና	Male	
ገናሌ	Male	
ገንዘብ	Male	
ገንዲ	Other	
ገንዳ	Other	
ገንፎ	Other	
ገዙ	Other	
ገዛኸኝ	Male	
ገዛኽኝ	Unknown	
ገዝሙ	Other	
ገዥ	Other	
ገዥነት	Other	
ገደል	Other	
ገደቡ	Male	
ገደብ	Other	
ገዳ	Other	
ገዳሙ	Male	
ገዳሜ	Other	
ገዳም	Other	
ገዳምነሽ	Female	
ገዳሪፍ	Other	
ገዳዳ	Other	
ገዴ	Other	
ገድ	Other	
ገድሉ	Male	
ገድሌ	Male	
ገጀሞ	Unknown	
ገጀረት	Unknown	
ገጅሞ	Other	
ገጅረት	Other	
ገጠሬ	Other	
ገጠር	Other	
ገጣሚ	Other	
ገጦ ለጣይ	Other	
ገጽ	Other	
ገፈታ	Other	
ገፈፋ	Other	
ገፋፊ	Other	
ጉሀር	Other	
ጉለሌ	Other	
ጉለንታ	Other	
ጉሉይ	Other	
ጉሌልሞ	Other	
ጉልህ	Other	
ጉልላት	Male	
ጉልማ	Male	
ጉልበት	Other	
ጉልባን	Other	
ጉልተኛ	Other	
ጉልታዊ	Other	
ጉልታዊነት	Other	
ጉልቴ	Male	
ጉልት	Other	
ጉልቻ	Other	
ጉሎ	Other	
ጉማ	Other	
ጉማሬ	Other	
ጉሜ	Other	
ጉም	Other	
ጉምሩክ	Other	
ጉምኛ	Other	
ጉረኖ	Other	
ጉረኛ	Other	
ጉራ	Male	
ጉራ ምድር	Place	
ጉራማይሌ	Other	
ጉራራ	Male	
ጉራቻ	Male	
ጉራንጉር	Other	
ጉራጌ	Other	
ጉሬዛ	Other	
ጉርሙ	Male	
ጉርሜሳ	Male	
ጉርሱም	Male	
ጉርስ	Other	
ጉርሸጥ	Other	
ጉርሻ	Other	
ጉርሽጥ	Other	
ጉርቢያ	Other	
ጉርብትና	Other	
ጉርአ	Other	
ጉርአጌ	Other	
ጉርኣ	Other	
ጉርጥ	Other	
ጉሮሮ	Other	
ጉስምት	Other	
ጉስቁልና	Other	
ጉስታብ	Other	
ጉስጉሻ	Other	
ጉሽ	Other	
ጉሽም	Other	
ጉሽርጥ	Other	
ጉበት	Other	
ጉበን	Other	
ጉበኝነት	Other	
ጉባ	Other	
ጉባኤ	Male	
ጉባይ	Other	
ጉብላው	Other	
ጉብል	Male	
ጉብልዬ	Other	
ጉብኝት	Other	
ጉቦ	Other	
ጉተማ	Male	
ጉቱ	Male	
ጉታ	Male	
ጉትቻ	Other	
ጉትያ	Male	
ጉቶ	Other	
ጉቻለወርቅ	Other	
ጉናጉና	Other	
ጉንዳን	Other	
ጉንድሽ	Other	
ጉንዶ	Other	
ጉንጉን	Other	
ጉንፋን	Other	
ጉዝጉዝ	Other	
ጉዝጓዝ	Other	
ጉዞ	Other	
ጉያ	Male	
ጉደር	Other	
ጉደታ	Male	
ጉዱ	Male	
ጉዲት	Other	
ጉዲና	Male	
ጉዲፈቻ	Other	
ጉዳ	Other	
ጉዳዩ	Male	
ጉዳዬ	Male	
ጉዳይ	Both	
ጉዳዮች	Other	
ጉዴላ	Other	
ጉድሩ	Other	
ጉድሮ	Other	
ጉድባ	Other	
ጉድኝ	Other	
ጉድዩ	Unknown	
ጉድፍ	Other	
ጉዶ	Female	
ጉጉት	Other	
ጉግሣ	Male	
ጉግሳ	Male	ጉግሣ
ጉግስ	Other	
ጉጠት	Other	
ጉጭማ	Other	
ጉፋያ	Other	
ጉፍታ	Other	
ጊላ	Other	
ጊላይ	Other	
ጊምቢ	Other	
ጊርቦ	Other	
ጊርጊሮ	Male	
ጊቺሌ	Other	
ጊንዳእ	Other	
ጊንዶ	Other	
ጊንጥ	Other	
ጊንጪ	Other	
ጊዎርጊስ	Male	
ጊዜ	Both	
ጊዜያዊ	Other	
ጊዮርጊስ	Male	
ጊደር	Other	
ጊዶሌ	Other	
ጊጤ	Other	
ጋለሞታ	Other	
ጋሌብ	Other	
ጋማ	Other	
ጋሜ	Other	
ጋምቤላ	Other	
ጋረደው	Other	
ጋሪ	Other	
ጋራተኛ	Unknown	
ጋራታኛ	Other	
ጋሬ	Other	
ጋሬጣ	Other	
ጋርዛ	Other	
ጋርዮሽ	Other	
ጋርዴ	Other	
ጋስፖሪኒ	Don't Know	
ጋሻ	Male	
ጋሻ ጃግሬ	Other	
ጋሻው	Male	
ጋሻውበዛ	Male	
ጋቢ	Female	
ጋብር	Other	
ጋተው	Other	
ጋት	Other	
ጋኔን	Other	
ጋን	Other	
ጋንዛ	Other	
ጋንድያ	Other	
ጋንፉር	Other	
ጋዜጠኛ	Other	
ጋዜጣ	Other	
ጋያ	Other	
ጋይም	Other	
ጋይንት	Other	
ጋዲ	Other	
ጋድ	Other	
ጋጋሪ	Other	
ጋጋኖ	Other	
ጋጠ ወጥ	Other	
ጋጥ	Other	
ጋፋት	Other	
ጌራ	Male	
ጌራሚካኤል	Male	
ጌራወርቅ	Male	
ጌሾ	Other	
ጌታ	Male	
ጌታ ሁን	Male	
ጌታ ነህ	Male	
ጌታ/	Male	
ጌታሁን	Male	
ጌታቸው	Male	
ጌታነህ	Male	
ጌታአቸው	Unknown	
ጌታው	Male	
ጌቴሴማኒ	Other	
ጌትነት	Male	
ጌትዬ	Male	
ጌቺሌ	Unknown	
ጌንዶ	Other	
ጌዴዎን	Male	
ጌዴዮን	Male	ጌዲዮን
ጌዶ	Don't Know	
ጌጃ	Other	
ጌጡ	Both	
ጌጣ ጌጥ	Other	
ጌጤ	Both	
ጌጤ ነሽ	Female	
ጌጥ	Other	
ግለ ሂስ	Other	
ግለኛ	Other	
ግሉዝ	Other	
ግላ ነህ	Unknown	
ግላ ነሽ	Unknown	
ግላስ	Other	
ግላዊ	Other	
ግል	Other	
ግል ሰብ	Unknown	
ግልበጣ	Other	
ግልቢያ	Other	
ግልባጭ	Other	
ግልብ	Other	
ግልድም	Other	
ግልገል	Other	
ግልጽ	Other	
ግሎ	Other	
ግመል	Other	
ግመሬ	Unknown	
ግማሽ	Other	
ግማደ	Other	
ግሜ	Other	
ግምል	Other	
ግምበኛ	Other	
ግምባር	Other	
ግምት	Other	
ግምጃ	Other	
ግምገማ	Other	
ግረት	Other	
ግሩም	Male	
ግራ	Other	
ግራር	Other	
ግራኝ	Other	
ግራዋ	Other	
ግራዝማች	Other	
ግራጫ	Other	
ግርማ	Male	
ግርማ ሁን	Other	
ግርማቸው	Male	
ግርማዊ	Male	
ግርማዊት	Other	
ግርማነሽ	Female	
ግርማው	Male	
ግርማዬ	Male	
ግርማይ	Male	
ግርምቢጥ	Other	
ግርድፍ	Other	
ግርዶሽ	Other	
ግርጌ	Other	
ግርግም	Other	
ግርግር	Other	
ግርግዳ	Other	
ግርፊያ	Other	
ግርፋት	Other	
ግሰሰው	Other	
ግስ	Other	
ግስላ	Other	
ግስንግስ	Other	
ግስጋሴ	Other	
ግሼ	Other	
ግሼን	Other	
ግሽጣ	Other	
ግቢ	Other	
ግባተ መሬት	Other	
ግብ	Other	
ግብረ	Other	
ግብረ ሰዶም	Other	
ግብረ ስዶም	Other	
ግብረ ስጋ	Other	
ግብረ በላ	Other	
ግብረ አበር	Other	
ግብረ አበሮች	Other	
ግብረ ጉንዳን	Other	
ግብረቱ	Other	
ግብር	Other	
ግብር 	Other	
ግብርና	Other	
ግብታዊ	Other	
ግብታዊነት	Other	
ግብአተ መሬት	Other	
ግብዘና	Unknown	
ግብዝ	Other	
ግብዝነት	Other	
ግብዝና	Other	
ግብዣ	Other	
ግብጦ	Other	
ግተት	Other	
ግትልትል	Other	
ግትር	Other	
ግትቻ	Other	
ግቻ	Other	
ግች	Other	
ግንባር	Other	
ግንብ	Other	
ግንቦት	Other	
ግንኙነት	Other	
ግንዘት	Other	
ግንደ በላ	Other	
ግንደ በል	Other	
ግንደ በረት	Place	
ግንድ	Other	
ግንጭል	Other	
ግኡዝ	Other	
ግእዝ	Other	
ግዛት	Other	
ግዛቸው	Male	
ግዛዉ	Male	
ግዛው	Male	
ግዝረት	Other	
ግዜሽወርቅ	Female	
ግዝት	Other	
ግዞተኛ	Other	
ግዞት	Other	
ግዥ	Other	
ግዮን	Male	
ግደይ	Both	
ግዳይ	Other	
ግዳጅ	Other	
ግዴ	Other	
ግዴለሽ	Other	
ግዴሳ	Other	
ግዴታ	Other	
ግድንግድ	Other	
ግድያ	Other	
ግድግዳ	Other	
ግድፈት	Other	
ግገን	Other	
ግግ	Other	
ግጥሚያ	Other	
ግጦሽ	Other	
ግጫ	Don't Know	
ግጭት	Other	
ግጻዌ	Other	
ግፈኛ	Other	
ግፊት	Other	
ግፍልፍል	Other	
ጎይቶም	Male	
ጐህ	Other	
ጐለሻ	Unknown	
ጐላ	Other	
ጐላሽ	Other	
ጐልማሳ	Other	
ጐልማሶች	Other	
ጐልያድ	Other	
ጐልጐታ	Other	
ጐመን	Other	
ጐመድ	Other	
ጐማ	Other	
ጐማዳ	Other	
ጐረምሳ	Other	
ጐረቤት	Other	
ጐረዶማን	Other	
ጐረጐማ	Other	
ጐራ	Other	
ጐራው	Other	
ጐሬ	Other	
ጐርምጥ	Other	
ጐርባጣ	Other	
ጐርናና	Other	
ጐርጐራ	Other	
ጐርጐርዮስ	Male	
ጐርፉ	Male	
ጐርፍ	Other	
ጐርፍ ነህ	Male	
ጐርፍነህ	Male	
ጐሮ	Other	
ጐሮዶማን	Other	
ጐሳ	Male	
ጐሳዬ	Male	
ጐስሜ	Other	
ጐስቋላ	Other	
ጐሹ	Male	
ጐሽ	Other	
ጐሽሜ	Male	
ጐሽዬ	Other	
ጐበና	Male	
ጐበኛ	Male	
ጐበዜ	Male	
ጐበዝ	Other	
ጐቡ	Male	
ጐባ	Other	
ጐባን	Other	
ጐባጣ	Other	
ጐቤ	Other	
ጐብዬ	Other	
ጐተራ	Other	
ጐሳዬ	Male	
ጐቸራ	Other	
ጐናፍር	Other	
ጐንቾ	Other	
ጐንደሬ	Other	
ጐንደር	Other	
ጐንፋ	Male	
ጐኜ	Other	
ጐይትኦም	Male	ጎይቶም
ጐይቶም	Male	
ጐደሎ	Other	
ጐዳና	Male	
ጐዳዳ	Other	
ጐጃሜ	Other	
ጐጃም	Other	
ጐጆ	Other	
ጐጣጉጥ	Other	
ጐጣጐጥ	Other	
ጐፈሬ	Other	
ጐአል	Male	
ጐዝጉዝ	Male	
ጐፈር	Other	
ጓል	Other	
ጓሮ	Other	
ጓሳ	Other	
ጓአለ	Male	
ጓዳዬ	Both	
ጓደኛ	Other	
ጓዱ	Other	
ጓዴ	Male	
ጓድ	Other	
ጓዶች	Other	
ጓጆላ	Don't Know	
ጓጉንቸር	Other	
ጠ/ግ	Don't Know	
ጠለለ	Both	
ጠለለወርቅ	Both	
ጠለለች	Other	
ጠለላ	Female	
ጠላ	Other	
ጠላት	Other	
ጠላፊ	Other	
ጠልሰም	Don't Know	
ጠመኔ	Other	
ጠመንጃ	Other	
ጠመዝማዛ	Other	
ጠመዥ	Other	
ጠማማ	Other	
ጠረን	Other	
ጠረጴዛ	Other	
ጠረፍ	Other	
ጠራራ	Other	
ጠርሙስ	Other	
ጠርዝ	Other	
ጠቅላላ	Other	
ጠቅላይ	Other	
ጠቋሚ	Other	
ጠቋር	Unknown	
ጠበል	Other	
ጠበቃ	Other	
ጠበቆች	Other	
ጠበብት	Other	
ጠቢቡ	Male	
ጠቢባን	Other	
ጠቢብ	Male	
ጠባባት	Don't Know	
ጠባብ	Other	
ጠባይ	Other	
ጠብቃቸው	Other	
ጠብቄ	Other	
ጠብቆች	Other	
ጠብታ	Other	
ጠብደል	Other	
ጠቦት	Other	
ጠና	Male	
ጠናጋሻው	Male	
ጠኔ	Other	
ጠንቀኛ	Other	
ጠንቃቃ	Other	
ጠንቅ	Other	
ጠንቋይ	Other	
ጠንበለል	Female	
ጠንካራ	Other	
ጠንክራ	Unknown	
ጠንክር	Male	
ጠንፌ	Female	
ጠንፍየለሽ	Female	
ጠንፍ ያለሽ	Unknown	
ጠውላጋ	Other	
ጠይቅ	Other	
ጠይብ	Male	
ጠዲቅ	Other	
ጠጂቱ	Female	
ጠጄ	Female	
ጠጅ	Other	
ጠጅነሽ	Female	
ጠገራ	Other	
ጠገናው	Other	
ጠገኔ	Other	
ጠገግ	Other	
ጠጋኝ	Other	
ጠጭ	Other	
ጠፈር	Other	
ጠፍ	Other	
ጠፍጣፋ	Other	
ጡሃር	Other	
ጡሉ	Unknown	
ጡሌ	Other	
ጡረታ	Other	
ጡብ	Other	
ጡት	Other	
ጡንቻ	Other	
ጡዝ	Other	
ጡጫ	Other	
ጡፋ	Other	
ጢም	Other	
ጢሞቴዎስ	Male	
ጢሮስ	Don't Know	
ጢሰኛ	Other	
ጢስ	Other	
ጢቆ	Other	
ጢብኛ	Other	
ጢቾ	Other	
ጢነኛ	Other	
ጢኖ	Other	
ጣሂም	Other	
ጣሂር	Other	
ጣሃ	Male	
ጣሃር	Other	
ጣሂር	Male	
ጣልቃ	Other	
ጣምራ	Other	
ጣረ ሞት	Other	
ጣራ	Other	
ጣሰው	Male	
ጣቃ	Other	
ጣቢታ	Other	
ጣቢያ	Other	
ጣባ	Other	
ጣት	Other	
ጣና	Other	
ጣአመ	Male	
ጣአሙ	Male	
ጣእመ	Other	
ጣእሙ	Other	
ጣኦት	Other	
ጣውንት	Other	
ጣዝማ	Other	
ጣይቱ	Female	
ጣጣቴ	Other	
ጣፈጠ	Other	
ጣፊያ	Other	
ጣፋጭ	Other	
ጣፍያ	Other	
ጤነኛ	Other	
ጤና	Both	
ጤናው	Male	
ጤናሁን	Male	
ጤና አዳም	Other	
ጤናዬ	Both	
ጤናዳም	Other	
ጤዛ	Other	
ጤፍ	Other	
ጥህሎ	Other	
ጥላሁን	Male	
ጥላ ሸት	Other	
ጥላሁን	Male	
ጥላቻ	Other	
ጥላዬ	Male	
ጥልቀት	Other	
ጥልቆ	Other	
ጥልጣል	Other	
ጥልፍ	Other	
ጥሎሽ	Other	
ጥሙጋ	Other	
ጥምቀት	Other	
ጥሞና	Other	
ጥረሾ	Don't Know	
ጥሩ	Both	
ጥሩሰው	Male	
ጥሩወርቅ	Both	
ጥሩወይን	Both	
ጥሩአይነት	Both	
ጥሩዬ	Female	
ጥሩ ነህ	Male	
ጥሩ ነሽ	Female	
ጥሩ ንህ	Unknown	
ጥሩ ንሽ	Unknown	
ጥሩምባ	Other	
ጥሩነሽ	Female	
ጥሪ	Other	
ጥሪት	Other	
ጥራ ጥሬ	Unknown	
ጥራት	Other	
ጥራዝ	Other	
ጥራዞች	Other	
ጥሬ	Other	
ጥር	Other	
ጥርኝ	Other	
ጥርጊያ	Other	
ጥርጣሬ	Other	
ጥሻ	Other	
ጥቀ ሄር	Unknown	
ጥቀሄር	Other	
ጥቀርሻ	Other	
ጥቁር	Other	
ጥቃቅን	Other	
ጥቅል	Other	
ጥቅምት	Other	
ጥቅስ	Other	
ጥቅሻ	Other	
ጥቋር	Other	
ጥበቃ	Other	
ጥበበ	Both	
ጥበበኛ	Other	
ጥበቡ	Male	
ጥበብ	Both	
ጥበብሽወርቅ	Female	
ጥበቧ	Female	
ጥባባኛ	Unknown	
ጥብቆ	Other	
ጥብኛ	Other	
ጥብጣብ	Other	
ጥናት	Other	
ጥንስስ	Other	
ጥንቁቅ	Other	
ጥንቅሽ	Other	
ጥንታዊ	Other	
ጥንት	Other	
ጥንቸል	Other	
ጥንዚዛ	Other	
ጥንድ	Other	
ጥንጁት	Other	
ጥንግ	Other	
ጥኡመ	Other	
ጥዑመ	Other	
ጥያቄ	Other	
ጥይት	Other	
ጥጃ	Other	
ጥገት	Other	
ጥገና	Other	
ጥገናዊ	Other	
ጥገኛ	Other	
ጥጉ	Both	
ጥጋቡ	Male	
ጥጋብ	Both	
ጥጋቤ	Both	
ጥግ ነህ	Male	
ጥግ ነሽ	Female	
ጥጥ	Other	
ጥፊ	Other	
ጥፍር	Other	
ጥፍጥሬ	Other	
ጦቢያ	Both	
ጦሊት	Other	
ጦማር	Other	
ጦረኛ	Other	
ጦር	Other	
ጦርነት	Other	
ጦሳ	Other	
ጦስ	Other	
ጦስኝ	Other	
ጦቢያው	Male	
ጦይብ	Other	
ጦጢት	Other	
ጦጣ	Other	
ጧት	Other	
ጧፌ	Other	
ጧፍ	Other	
ጨለለቅቱ	Other	
ጨለማ	Other	
ጨለንቆ	Other	
ጨሌ	Other	
ጨመረ	Male	
ጨመዳ	Male	
ጨረቃ	Both	
ጨረታ	Other	
ጨርቃ	Other	
ጨርቃ ጨርቅ	Other	
ጨርቅ	Other	
ጨርቆስ	Male	
ጨቄ	Other	
ጨቅላ	Other	
ጨቋኝ	Other	
ጨበጣ	Other	
ጨቡዴ	Male	
ጨቡድ	Other	
ጨብሲ	Male	
ጨብጥ	Other	
ጨንቻ	Other	
ጨንገር	Other	
ጨካኝ	Other	
ጨዋ	Other	
ጨዋነሻ	Female	
ጨዋቃ	Male	
ጨዌ	Unknown	
ጨው	Other	
ጨጐጐት	Other	
ጨጓራ	Other	
ጨጨሆ	Other	
ጨጨብሳ	Other	
ጨፋ	Other	
ጨፌ	Other	
ጨፍቄ	Other	
ጩቅ	Other	
ጩቤ	Other	
ጩፋ	Other	
ጫላ	Male	
ጫልቱ	Female	
ጫልፊት	Other	
ጫማ	Other	
ጫሜ	Other	
ጫሞ	Other	
ጫት	Other	
ጫኔ	Male	
ጫን	Other	
ጫን ያለው	Both	
ጫንቃ	Other	
ጫንጮ	Other	
ጫካ	Other	
ጫጉ	Other	
ጫጉላ	Other	
ጫጩት	Other	
ጫጫ	Other	
ጫፍ	Other	
ጭላሎ	Other	
ጭላት	Other	
ጭላንጭል	Other	
ጭሌ	Other	
ጭልጋ	Other	
ጭልፊት	Other	
ጭማቂ	Other	
ጭምብስብስ	Other	
ጭምት	Other	
ጭምጭምታ	Other	
ጭረት	Other	
ጭራ	Other	
ጭራሮ	Other	
ጭራቅ	Other	
ጭሬ	Other	
ጭርት	Other	
ጭሮ አዳሪ	Other	
ጭሰኛ	Other	
ጭስ	Other	
ጭቁን	Other	
ጭቁኖች	Other	
ጭቁኝ	Other	
ጭቃ	Other	
ጭቅቅት	Other	
ጭቅና	Other	
ጭቆና	Other	
ጭቡድ	Other	
ጭብሳ	Male	
ጭብኛ	Other	
ጭብጥ	Other	
ጭብጦ	Other	
ጭቦኛ	Other	
ጭነት	Other	
ጭን	Other	
ጭንቀት	Other	
ጭንቅላት	Other	
ጭንቅሎ	Other	
ጭንጋፍ	Other	
ጭንጫ	Other	
ጭኮ	Other	
ጭዳ	Don't Know	
ጭድ	Other	
ጭገር	Other	
ጭጉጉት	Other	
ጭጋግ	Other	
ጭጐጐት	Other	
ጭፍጨፋ	Other	
ጮሌ	Other	
ጮማ	Other	
ጮራ	Other	
ጮርቃ	Other	
ጮርናቄ	Other	
ጮቄ	Other	
ጮቤ	Other	
ጮጮ	Other	
ጰራቅሊጦስ	Other	
ጰንጠሌዎን	Other	
ጰንጠቆስጤ	Other	
ጲላጦስ	Other	
ጳኩሚስ	Don't Know	
ጳውሎስ	Male	
ጳጉሜ	Other	
ጳጳሳት	Other	
ጳጳስ	Other	
ጴጥሮስ	Male	
ጵጉሜ	Unknown	
ጸሀዩ	Other	ፀሐዩ
ጸሀዬ	Both	ፀሐዬ
ጸሀይ	Both	ፀሐይ
ጸሀይ ነሽ	Female	
ጸሀይቱ	Female	
ጸሀይነሽ	Female	
ጸሀፊ	Other	
ጸህዩ	Other	
ጸሎተ	Both	
ጸሎተማርያም	Female	
ጸሎት	Other	
ጸረ	Other	
ጸበል	Other	
ጸናጽል	Other	
ጸዋሬ	Other	
ጸደቀ	Male	
ጸደቁ	Female	
ጸደይ	Female	
ጸደቁ	Female	
ጸዱ	Female	
ጸዳለ	Female	
ጸዳል	Female	
ጸድዋ	Other	
ጸገዴ	Don't Know	
ጸጉራም	Other	
ጸጉ	Male	
ጸጉር	Other	
ጸጋ	Both	
ጸጋይ	Male	
ጸጋዬ	Male	
ጸጸት	Other	
ጻህል	Don't Know	
ጻድቁ	Other	
ጻድቃን	Both	
ጻድቅ	Other	
ጽ/ቤት	Company	
ጽሁፍ	Other	
ጽህፈት	Other	
ጽላተ	Female	
ጽላት	Female	
ጽልመት	Other	
ጽሑፍ	Other	
ጽርሀ አርያም	Unknown	
ጽርእ	Other	
ጽብረቃ	Other	
ጽንሰ	Other	
ጽንስ	Other	
ጽንፈ አርእድ	Unknown	
ጽንፍ	Other	
ጽዋ	Other	
ጽዮናዊነት	Other	
ጽዮን	Both	
ጽድቅ	Other	
ጽጋዬ	Male	
ጽጌ	Both	
ጽጌወይን	Both	
ጽጌ ረዳ	Female	
ጾመ	Other	
ጾም	Other	
ጾር	Don't Know	
ጾታ	Other	
ፀሐይ	Both	
ፀሐይነሽ	Female	
ፀባዖት	Other	
ፀጋ	Both	
ፀጋዬ	Male	
ፈለቀ	Male	
ፈለቀች	Female	
ፈለገ	Both	
ፈለገሕይወት	Both	
ፈለግ	Other	
ፈሊጥ	Other	
ፈላ ምላጭ	Unknown	
ፈላስመን	Don't Know	
ፈላስፋ	Other	
ፈላሻ	Other	
ፈላቀ	Don't Know	
ፈላጭ	Other	
ፈልዳሶ	Don't Know	
ፈረሱላ	Other	
ፈረጃ	Male	
ፈረቃ	Other	
ፈረንጅ	Other	
ፈረደ	Male	
ፈሪሳዊ	Other	
ፈሪሳውያን	Other	
ፈር	Other	
ፈርስ	Other	
ፈርኦን	Other	
ፈርካሳ	Other	
ፈርጅ	Other	
ፈርጣጭ	Other	
ፈርጥ	Other	
ፈሰሰ	Other	
ፈሰሴ	Other	
ፈሰስ	Other	
ፈሳሽ	Other	
ፈስ	Other	
ፈቃደ	Both	
ፈቃደአምላክ	Both	
ፈቃዱ	Male	
ፈቃዷ	Female	
ፈቄ	Other	
ፈቅ ይበሉ	Unknown	
ፈተና	Other	
ፈቲሂ	Male	
ፈቲያ	Female	
ፈታይ	Other	
ፈትለ	Female	
ፈትለወርቅ	Female	
ፈትል	Other	
ፈንታሌ	Other	
ፈንቴ	Male	
ፈንቴሳ	Other	
ፈንዜ	Other	
ፈንደለሌ	Other	
ፈንጋይ	Other	
ፈንጠዝያ	Other	
ፈንጣጣ	Other	
ፈዋሽ	Other	
ፈይሳ	Male	
ፈዲስ	Don't Know	
ፈድሉ	Male	
ፈጀቦ	Don't Know	
ፈጋራ	Other	
ፈጠነ	Other	
ፈጠጋር	Other	
ፈጣሪ	Other	
ፈጣን	Other	
ፈጫይ	Other	
ፈፋ	Other	
ፉርካሳ	Unknown	
ፉቅራ	Other	
ፉትቦል	Other	
ፉኝት	Other	
ፉካ	Other	
ፉጋ	Other	
ፉጨት	Other	
ፊሊጶስ	Male	
ፊሊፖ	Don't Know	
ፊልጶስ	Male	
ፊልጾስ	Male	
ፊሽካ	Other	
ፊቅ	Other	
ፊቅጦር	Don't Know	
ፊታውራሪ	Other	
ፊቼ	Other	
ፊች	Unknown	
ፊና	Other	
ፊንጨአ	Don't Know	
ፊኛ	Other	
ፊደሉ	Other	
ፊደል	Other	
ፊዳ	Male	
ፋሪስ	Male	
ፋሮ	Other	
ፋሲለደስ	Place	
ፋሲል	Male	
ፋሲካ	Both	
ፋስ	Other	
ፋሶሊያ	Other	
ፋሻ	Other	
ፋሽሽታዊ	Other	
ፋሽሽት	Other	
ፋቂ	Other	
ፋብሪካ	Company	
ፋብሪካዎች	Company	
ፋታ	Other	
ፋኑስ	Don't Know	
ፋኑኤል	Male	
ፋና	Female	
ፋናነሽ	Female	
ፋናዬ	Female	
ፋንቱ	Both	
ፋንታ	Male	
ፋንታነሽ	Female	
ፋንታ ሁን	Male	
ፋንታዬ	Both	
ፋንታይ	Male	
ፋንድያ	Other	
ፋኖ	Other	
ፋኖሴ	Female	
ፋኖስ	Female	
ፋይዳ	Other	
ፋጉሎ	Other	
ፋጡማ	Female	
ፋጢማ	Female	
ፋጤ	Female	
ፋፋ	Other	
ፌሮ	Other	
ፌሽታ	Other	
ፌቆ	Don't Know	
ፌንጣ	Other	
ፌጦ	Other	
ፍላቴ	Other	
ፍላጐት	Both	
ፍላጻ	Other	
ፍላጽ	Other	
ፍል	Other	
ፍልሚያ	Other	
ፍልሰታ	Other	
ፍልስጥኤም	Other	
ፍልስፍና	Other	
ፍልቅልቅ	Other	
ፍልፈል	Other	
ፍልፍሉ	Other	
ፍልፍሏ	Female	
ፍሎራን	Male	foreign name
ፍሩሽካ	Other	
ፍሪዳ	Other	
ፍራሽ	Other	
ፍራቻ	Other	
ፍራፍሬ	Other	
ፍሬ	Other	
ፍሬሕይወት	Both	
ፍሬዘውድ	Both	
ፍሬሰናይ	Male	
ፍሬሰንበት	Male	
ፍሬእዝጊ	Male	
ፍሬወይኒ	Female	
ፍሬምናጦስ	Don't Know	
ፍሬር	Don't Know	
ፍሬአማ	Other	
ፍሬው	Male	
ፍርሃት	Other	
ፍርምባ	Other	
ፍርንትት	Don't Know	
ፍርንዱስ	Other	
ፍርኩታ	Don't Know	
ፍርክርክ	Other	
ፍርዱ	Male	
ፍርድ	Other	
ፍርጃ	Other	
ፍርፋሪ	Other	
ፍስሀ	Male	ፍስሐ
ፍስሀዬ	Male	
ፍስሐ	Male	
ፍስሐዬ	Male	
ፍስክ	Other	
ፍቃደ	Male	
ፍቃዱ	Male	
ፍቅረ	Male	
ፍቅረማርያም	Male	
ፍቅረስላሴ	Male	
ፍቅሩ	Male	
ፍቅሬ	Male	
ፍቅር	Both	
ፍቅርተ	Female	
ፍቱን	Other	
ፍታዬ	Don't Know	
ፍትሀ	Other	
ፍትሀት	Other	
ፍትህ	Other	
ፍትወት	Other	
ፍትዊ	Male	
ፍትፍት	Other	
ፍቼ	Place	
ፍች	Other	
ፍናጅ	Other	
ፍናፍንት	Other	
ፍንዳታ	Other	
ፍንጃል	Other	
ፍንጢጣ	Other	
ፍንጣሪ	Other	
ፍንጥር	Other	
ፍንጭት	Other	
ፍንፍኔ	Other	
ፍኖተ ሰላም	Place	
ፍየል	Other	
ፍዳ	Other	
ፍጅት	Other	
ፍጆታ	Other	
ፍግ	Other	
ፍጡር	Other	
ፍጥምጥም	Other	
ፍጥረታት	Other	
ፍጥረት	Other	
ፍጥነት	Other	
ፍጹም	Both	ፍፁም
ፍጻሜ	Other	
ፍጽም	Male	
ፍጽምብርሃን	Male	
ፎሌ	Other	
ፎቃቃ	Other	
ፎቅ	Other	
ፎናና	Other	
ፎከታም	Other	
ፎኩ	Don't Know	
ፎዬ	Don't Know	
ፎገራ	Place	
ፎጣ	Other	
ፏፏቴ	Other	
ፏፏቴ 	Other	
ፓርላሜንት	Government	
ፓስተኛ	Other	
ፕላን	Other	
ፖሊስ	Other	
ፖስታ	Other	
