#Amharic Name	Latin Transcription	ASCII Transcription
ሀብተማርያም ወርቅነህ /ሊቀ ሥልጣናት/	Habtämaryam Wärqenäh	Habtemariam Workineh
ሀብተ ወልድ ወልደ ሥላሴ	Habtä-Wäld Wäldä-sellassé	Habte Wold Wolde Sellassie
ሃይማኖት ታደሰ	Haymanot Taddäsä	Haimanot Taddese
ህላዌ ተክለ ማርያም	Hellawé Täklämaryam	Hellawe Tekelemariamm
ህላዌ ገብረ እግዚአብሔር	Hellawé Gäbrä-Egziabhér	Hellawe Gebre Egziabher
ሆይናስኪ ስታንስሎው	Chojnacki, Stanislaw	Chojnacki, Stanislaw	Non-Ethiopian
ለማ በላይነህ	Lämma Bälaynäh	Lemma Belaineh
ለማ ወርቄ	Lämma Wärqé	Lemma Worke
ለማ ፈይሳ	Lämma Fäyysa	Lemma Feissa 
ለገሠ አበበ	Läggäsä Abbäbä	Leggese Abebe
ሉሌ መልአኩ	Lulé Mälaku	Lule Melaku
ሉልሰገድ ዓለማየሁ	Lulsäggäd Alämayyähu	Luelseged Alemayehu
ሉቃስ ጐበዜ	Luqas Gwäbäzé	Lukas Gobeze
ሉንዳል ጴጥሮስ	Lundahl, B P	Lundahl, B P	Non-Ethiopian
ሉንድግሬን ፤ ማንፍሬድ /ቄስ/	Lundgren Manfréd Pastuer	Lundgren Manfréd, Pasteur	Non-Ethiopian
ላቀው ትእዛዙ	Laqäw Tezazu	Lakew Tiezazu
ላቀው ደስታ	Laqäw Dästa	Lakew Desta
ልሳነ ክርስቶስ ተስፋዬ	Lessanä-Kerestos Täsfayé	Lissane Kirstos Tesfaye
ልሻን ደስታ	Leŝan Dästa	Lishan Desta
ልዕልት ጽጌ	Leelt Şegé	Leelt Tsige
ልጃም ይስሐቅ	Lejam Yeshaq	Lijam Yishak
ሐረገ ወይን በየነ	Harägä-Wäyn Bäyyänä	Harege Weyn Beyene
ሐማሴን ብሔራዊ ስፖርት ፋና	Hamasén Behérawi Sport Fana	Hamasen Beheraw Sport Fana
ሐዋዝ ሙላት	Hawaz Mulat	Hawaz Mulat
ሐዋዝ ወልደ ሚካኤል	Hawaz Wäldä-Mikaél	Hawaz Weled-Mikael
ሐይሎም አድሐነ	Haylom Adhanä	Hailom Adhane
ሐዲስ ወልደ ጻድቅ	Haddis Wäldä Sadeq	Haddis Wolde Tsadik
ሐዲስ ዓለማየሁ	Haddis Alämayyähu	Haddis Alemayehu
ሐፍዝ ዳዉድ	Hafez Dawd	Hafez Dawd	Non-Ethiopian
መለሰልኝ አንለይ	Mälläsäleň Annelläy	Meleselign Aniley
መልአከ ኃይል መንገሻ	Mälakä-Hayl Mängäša	Melake Hail Mengesha
መላኩ ኃይሉ	Mälaku Haylu	Melaku Hailu
መላኩ ደስታ	Malaku Dästa	Melaku Desta
መልአኩ ፈለቀ	Mälaku Fälläqä	Melaku Feleke
መሐመድ እድሪስ	Mähammäd Edris	Mohammed Edris
መሐመድ ዑስማን	Mähammäd Usman	Mohammed Usman 
መሐሪ ትርፌ /ሊቀ ሊቃውንት/	Mähari Terfé	Mehari Tirfe
መሐሪ ካሣ	Mähari Kasa	Mehari Kasa
መሠረት መንገሻ	Mäsärat Mängäša	Meseret Mengesha
መሠረት ስብሐት ለአብ	Mäsärät Sebhat-Läab	Meseret Sebahat-Leab
መርሐ ጽድቅ ኮከብ ልኮንክ	Märha-SedQ Kokäb Lekonk	Merha Tsidk Kokeb Likonk
መርስዔ ኃዘን አበበ	Marsé-Hazän Abbäbä	Merse-Hazen Abebe
መርስዔ ኃዘን ወልደ ቂርቆስ፣ ብላታ	Marsé-Hazän Waldä-Qirqos	Merse-Hazen wolde Kirkos
መርሻ ወዳጆ	Maršša Wodağğo	Mersha Wodajo
መሰለ እጅጉ	Mässälä Ejjegu	Mesele Ejigu
መስቀሉ ባልቻ	Mäsqälu Balča	Meskelu Balcha
መስፍን ሀብተ ማርያም	Mäsfen Habtä-Maryam	Mesfin Habte-Mariam
መስፍን ልሳኑ	Mäsfen Lessanu	Mesfin Lissanu
መስፍን ተፈራ	Mäsfen Täfärra	Mesfin Teferra
መስፍን ወልደማርያም	Mäsfen Wäldämaryam	Mesfin Woldemariam
መስፍን ዓለማየሁ	Mäsfen Alämayyähu	Mesfin Alemayehu
መሸሻ ግዛው	Mäšäša Gezaw	Meshesha Gizaw 
መቅደስ ወርቅ ዘለቀ /ወይዘሮ/	Mäqdäsä-Wärq Zälläqä	Mekdes Work Zeleke
መብራቱ አሥረስ	Mäbratu Asräs	Mebratu Asres
መብራቱ ወልደ ጻድቅ	Mäbratu Wäldä-Sadeq	Mebratu Wolde Tsadik
መንበረ ወልዴ	Mänbärä Wäldé	Menbere Wolde
መንበረ ደርሰህ	Mänbära Därsäh	Menbere Derseh
መንግሥተአብ ጎይቶም	Mängestab Goytom	Mengesteab Gitom
መንግሥቱ ለማ	Mängestu Lämma	Mengistu Lemma
መንግሥቱ መኰንን	Mängestu Mäkwannen	Mengistu Mekonen
መንግሥቱ ወልደማርያም	Mängestu Wäldämaryam	Mengistu Woldemariam
መንግሥቱ ዘውዴ	Mängestu Zäwde	Mengestu Zewde
መንግሥቱ ገዳሙ	Mängestu Gädamu	Mengistu Gedamu
መኩሪያ ወልደ ሥላሴ /አግሮኖም ጂኦሚትር/	Mäkuriya Wäldä-Sellasé	Mekuria Wolde Selassie
መክብብ ዓለሙ	Mäkbeb Alämu	Mekbib Alemu
መክብብ ደስታ	Makbeb Dästa	Mekbib Desta
መክብብ ገበየሁ	Mäkbeb Gäbäyähu	Mekbib Gebeyehu
መኰንን በቀለ	Mäkwännen Bäqqälä	Mekonin Bekele
መኮንን ተክለ ኃይማኖት	Mäkwännen Täklä-Haymanot	Mekonen Tekle Haimanot
መኰንን ተክለአረጋዊ	Mäkwännen Täklärägawi	Mekonin Teklearegawi
መኰንን ነጋሽ	Mäkwännen Nägaš	Mekonin Negash
መኰንን አበበ	Mäkwännen Abbäbä	Mekonin Abebe
መኰንን እንዳልካቸው /ራስ ቢትወደድ/	Mäkwännen Endalkaččäw	Mekonin Endalkachew
መኰንን ወርቅ አገኘሁ	Mäkwännen Wärq-Agäňähu	Mekonin Work Agegnehu
መኰንን ዘውዴ	Mäkwännen Zäwdé	Mekonen Zewde
መዓዛ ለማ	Mäaza Lämma	Meaza Lemma
መዘምር ኃይሉ	Mäzämer Haylu	Mezemur Hailu
መዝገቡ አባተ	Mäzgäbu Abatä	Mezegebu Abate
መጽሐፍ ቅዱስ	Mäshaf Qeddus	Metsehaf Kidus
ሙሉ ሰው ምትኩ አዛዥ	Mulu-Säw Meteku	Azzaz Mulusew Mitiku Azzaz
ሙሉጌታ መልከ ጻድቅ	Mulugéta Mälkä-Sadéq	Mulugeta Melke Tsedek
ሙሉጌታ ሠምሩ	Mulugéta Sämru	Mulugeta Semru
ሙሉጌታ ቀጸላ	Mulugéta Qäsäla	Mulugeta Kessela
ሙሉጌታ ኃይሌ	Mulugéta Haylé	Mulugeta Haile
ሙሉጌታ ገብረ ወልድ	Mulugéta Gäbrä-Wäld	Mulugeta Gebre Wold
ሙላቱ ድጉማ	Mulatu Deguma	Mulatu Diguma 
ሙላቱ ገብሩ	Mulatu Gäbru	Mulatu Gebru
ሙሐሙድ ሣኒ ሐቢብ	Muhammäd Sani Habib	Mohammed Sani Habib
ሙራድ ካሜል /ዶክተር/	Murad Kamil, Dr	Murad Kamil, Dr	Non-Ethiopian
ሙሳ/ሣ/ አሮን	Musa Aron	Musa Aron
ሚሊዮን ነቅንቅ	Miliyon Naqneq	Milion Neknk
ማህሌት ጓጃላ	Mahlét Gwäjala	Mahlet Gojela
ማሞ ሥዩም /ፊታውራሪ/	Mammo Seyyum	Mammo Seyoum
ማሞ ወልደ ሰንበት	Mammo Wäldä-Sänbät	Mammo Wolde Senbet
ማሞ ወልዴ	Mammo Wälde	Mammo Wolde
ማሞ ውድነህ	Mammo Weddenäh	Mammo Wudineh
ማሞ ጨርቃ	Mammo Čorqa	Mammo Chorka
ማርታ ንዋይ	Marta Neway	Marta Niway
ማርቆስ ዳውድ /ቄስ/	Marcos Daoud,	Marcos Daoud, Prêtre	Non-Ethiopian
ማቴዎስ ሐጐስ	Matéwos Hagos	Matewos Hagos
ማቴዎስ በቀለ	Matéwos Bäqqälä	Matewos Bekele
ማኅተመ ሥላሴ ወልደ መስቀል /ባላምበራስ/ብላቴን ጌታ/	Mahtama-Sellasé Woldä-Mäsqäl	Mahteme-Sellassie Wolde Meskel
ማን እኩልህ ሞረሽ	Manekuleh Morräš	Manikuleh Moresh
ማእሙን መሕዲ	Maemun Mähdi	Maamun Mehidi
ማዕረጉ በዛብህ	Maérägu Bäzzabbeh	Maeregu Bezabih
ሜሪ ታደሰ	Méry Taddäsä	Merry Taddese
ሜናዥ፣ቪ ኤል	Menage, Victor L	Menage, Victor L	Non-Ethiopian
ምሕረተ አብ አባይ	Mehrätab Abbay	Mehretab Abay
ምስግና ተከስተ	Mesgenna Täkästä	Misgina Tekeste
ምናሴ የሥጋት	Menasé Yäsegat	Minasse Yesigat
ሞገስ ክፍሌ	Mogäs Keflé	Moges Kifle
ሞገስ ዕቁባ ጊዮርጊስ	Mogäs Equba Giyorgis	Moges Ekube Giorgis
ሠረቀ ብርሃን ገብረ እግዚእ	Säräqä-Berhan Gäbrä-Egzi	Sereke Birhan Gebre Egzi
ሣህለ ሚካኤል ወልደ ሥላሴ	Sahlä Mikaél Wäldä-Sellasé	Sahle Mikael Wolde Selassie
ሣህለ ሥላሴ ብርሃነ ማርያም	Sahlä-Sellasé Berhanä-Maryam	Sahle Sellassie Berhane Mariam
ሣህለ ዓምደ ሚካኤል	Sahlä Amdä-Mikaél	Sahle Amde Michael
ሣህሉ ድፋዬ /ፊታውራሪ/	Sahelu Defayé	Sahlu Defaye
ሥዩም ሠርፀ መድኅን	Seyyum Särsä-Mädhen	Seyoum Tserse Medhin
ሥርግው ሐብለ ሥላሴ	Sergew Hablä-Sellasé	Sirgew Hable Selassie
ሥዩም ስመኝ	Seyyum Semmäň	Seyoum Semegn
ሥዩም ተክለ ኃይማኖት	Seyyum Täklä Haymanot	Seyoum Tekle Haimanot
ሥዩም ወልዴ	Seyyum Wäldé	Seyoum Wolde
ሥዩም ገብረ እግዚአብሔር	Seyyum Gäbrä Egziabhér	Seyoum Gebre Egziabher
ረስቲን ሲሞን	Rostin, Simon	Rostin,Simon	Non-Ethiopian
ረይት፣ስቲቬን፣ኤምኤ	Wright, Stephen, MA	Wright, Stephen, MA	Non-Ethiopian
ሮማነ ወርቅ ካሳሁን /ወ/ሮ/	Romanä-Wärq Kasahun	Romane Work Kasahun
ሰሎሞን ተሰማ	Sälomon Täsämma	Solomon Tesema
ሰሎሞን ተስፋ ማርያም	Sälomon Täsfa-Maryam	Solomon Tesfa Mariam
ሰሎሞን ታፈሰ	Sälomon Tafässä	Solomon Tafesse
ሰሎሞን ዓሊ	Sälomon Ali	Solomon Ali
ሰሎሞን ይርጋ	Sälomon Yerga	Solomon Yirga
ሰሎሞን ደሬሳ	Sälomon Därésa	Solomon Deressa
ሰይድ ሙሐመድ ሰይድ	Säyd Muhammäd Säyd	Seid Mohammed Seid
ሰይድ አበጋዝ	Säyd Abägaz	Seid Abgaz
ሰይድ ኢብራሂም	Säyd Ibrahim	Seid Ibrahim
ሰይፈ ሚካኤል የተሽ ወርቅ	Säyfä Mikaél Yätäša-Wärq	Seife-Michael Yetesha Work
ሰይፈ ሥላሴ ወልደ ወሎ	Säyfä-Sellasé Wäldä-Wällo	Seife Selassie Wolde Wollo
ሰይፉ ሩጋ	Säyfu Ruga	Seifu Ruga
ሰይፉ ኃይለ ሥላሴ	Säyfu Haile Sellasie	Seifu Haile Selassie 
ሰይፉ ወልደ ኪዳን	Säyfu Wäldä Kidan	Seifu Wolde Kidan
ሰይፉ ይነሱ	Säyfu Yennäsu	Seifu Yenesu
ሰይፉ ይገዙ	Säyfu Yeggäzu	Seifu Yigezu
ሲራክ ኅሩይ	Sirak Heruy	Sirak Hiruy
ሲሳይ ከበደ	Sisay Käbbädä	Sisay Kebede
ሲቤንስን /ቄስ/	Svensson, Pasteur	Svensson, Pasteur	Non-Ethiopian
ሳሙኤል ለገሰ	Samuél Läggäsä	Samuel Legesse
ሳሙኤል መኰንን	Samuél Mäkwännen	Samuel Mekonen
ሳሙኤል በቀለ	Samuél Bäqqälä	Samuel Bekele
ሳሙኤል ተረፈ	Samuél Tärräfä	Samuel Terefe
ሳሙኤል ፈረንጅ	Samuél Färänj	Samuel Ferenge
ስብሐት ለአብ	Sebhat Läab	Sebhat Leab
ስንዱ ገብሩ /ወ/ሮ	Sendu Gäbru	Senedu Gebru
ሸዋንግዛው በላይ	Šäwangezaw Bälay	Shewangezaw Belay
ሸዋንግዛው በላይነህ	Šäwangezaw Bälaynäh	Shewangezaw Belayneh
ሺመልስ በቀለ	Šimälles Bäqqälä	Shimelles Bekele
ሺፈራው መንገሻ	Šifärraw Mängäsä	Shiferaw Mengesha
ሽፈራው ደምሴ	Šefärraw Dämissé	Shiferaw Demisse
ሻውል ባምነው	Šawl Bamnäw	Shawel Bamnew
ሽብሩ ወልደ ማርያም	Šiberu Wäldä-Maryam	Shiberu Wolde Mariam
ሽቶ መዝገቡ	Šetto Mäzgäbu	Shitto Mezgebu
ሽፈራው ምሕረቴ	Šefärraw Mehräté	Shiferaw Mehrete
ሽፈራው ከበደ	Šefärraw Käbbädä	Shiferaw Kebede
ቀለመወርቅ እምሩ /አባ/	Qälämä-Wärq Emmeru	Keleme Werke Emeru
ቀለታ ኪዳኔ	Qäläta Kidané	Keletta Kidane
ቀና ማይጨው	Qänna Mayčäw	Kenna Maichew
ቀጂላ ዋጮ	Qäjéla Wačo	Kejela Wako
ቀጸላ ወልደ መድኅን	Qäşäla Wäldä-Mädhen	Kessela Wolde-Medhin
ቅጣው ይታጠቁ	Qetaw Yettatäqu	Kitaw Yitateku
ቆስጠንጢኖስ ባስልዮስ	Qostäntinos Baslyos	Kostentinos Baslios
በለጠ ምሕረቱ ተስፋዬ	Bällatä Mehrätu Täsfayé	Belete Mehiretu Tesfaye
በለጠ ገብሬ	Bällätä Gäbré	Belete Gebre
በለጠ ጉልማ	Bällätä Gulemma	Belete Gulma
በላይ ግደይ	Balay Gedäy	Belay Gidey
በረከተአብ ሀብተ ሥላሴ	Bäräkätab Habtä-Sellasé	Bereketeab Habte Selassie
በርሄ አርአያ	Bärhé Araya	Berhe Araya
በርሄ ወልደማርያም	Bärhé Wäldämaryam	Berhane Woldemariam 
በቀለ ሀብተ ሚካኤል /ብላታ/	Bäqqälä Habtä-Mikaél	Bekele Habtemichael
በቀለ ተገኝ	Bäqqälä Tägäň	Bekele Tegegn
በቀለ ታደሰ	Bäqqälä Taddäsä	Bekele Taddese
በቀለ አለሙ	Bäqqälä Alämu	Bekele Alemu
በትእዛዙ ወልደ ዮሐንስ	Bätezazu Wäldä-Yohannes	Betezazu Wolde Yohanis
በአሉ ግርማ	Bäalu Germa	Bealu Girma 
በእምነት ገብረ አምላክ	Bäemnät Gäbramlak	Beimnet Gebre Amlak
በኩረ ጽዮን ተስፋዬ	Bäkurä-Seyon Täsfayé	Bekure Tsion Tesfaye
በዛብህ ሠይፉ	Bäzzabbeh Säyfu	Bezabih Seifu
በየነ ማንያህልሃል	Bäyyänä Manyahlehal	Beyene Manyahlihal
በፈቃደ ሥላሴ ፋንታዬ	Bäfäqadä-Sellasé Fantayé	Befekade Selassie Fantaye
በፈቃዱ ኪዳኔ	Bäfäqadu Kidané	Befekdu Kidane
በፈቃዱ ዘገየ	Bäfäqadu Zägäyyä	Befekadu Zegaye
በፈቃዱ የተመኝ	Bäfäkadu Yätämäñ	Befekadu Yetemegn
በፈቃዱ ደረጀ	Bäfäkadu Däräjjä	Befekadu Dereje 
በፈቃዱ ደስታ	Bäfaqädu Dästa	Befekadu Desta 
ቢያዝን መኰንን	Biyazen Mäkwännen	Biazin Mekonin
ቢያድጉ ሽፈራው	Biyadgu Šefäraw	Biadgu Shiferaw
ባስሊኒ ፊሊፖ	Baslini, Filippo	Baslini, Filippo	Non-Ethiopian
ባስልዮስ	Baslyos	Baslyos
ቤተማርያም አሸኔ /አባ/	Bétämaryam Aššené	Betemariam Ashine
ቤካ ኔሞ	Béka Némo	Beka Nemmo
ብሬ የሻነህ	Berré Yäšanäh	Bire Yeshaneh
ብርሃነ መስቀል ባዕላይ	Berhanä-Mäsqäl Baelay	Berhane-Meskel Baelay
ብርሃነ መስቀል ዓንዶም	Berhanä-Mäsqäl Andom	Berhane-Meskel Andom
ብርሃነ መስቀል ደስታ /ደጃዝማች/	Berhanä-Mäsqäl Dästä	Berhane Meskel Desta 
ብርሀነ መስፍን	Berhanä Mäsfen	Berhanć Mesfin
ብርሃኑ ከበደ	Berhanu Käbbädä	Berhanu Kebede
ብርሃኑ ዘርይሁን	Berhanu Zäryhun	Berhanu Zerihun
ብርሃኑ ድንቄ	Berhanu Denqé	Berhanu Dinke
ብርሃኔ ወልደማርያም	Berhané Wäldämaryam	Berhane Woldemariam
ብርሃኔ ጉቻለወርቅ	Berhané Guččäläwarq	Berhane Guchalework
ብዙ ወርቅ መርሻ	Bezu-Wärq Märša	Bezu-Work Mersha
ቦጋለ ዋለሉ	Boggalä Walälu	Bogale Walelu
ተረፈ አስረስ	Tärräfä Asräs	Terefe Asres
ተሰማ ሀብተ ሚካኤል	Täsämma Habtä-Mikaél	Tesema Habte Michael
ተስፋ ደስታ	Täsfa Dästa	Tesfa Desta
ተስፋ ሥላሴ /አባ/	Täsfa-Sellasé	Tesfa Silassie
ተስፋ እግዚእ ገብረ እግዚአብሔር	Täsfa-Egzi Gäbrä-Egziabhér	Tesfa Egzi Gebre Egziabher
ተስፋ ወልደ ሥላሴ	Täsfa Waldä-Sellasé	Tesfa Wolde Selassie
ተስፋዬ ለማ	Täsfayé Lämma	Tesfaye Lemma
ተስፋዬ ረታ	Täsfayé Rätta	Tesfaye Reta
ተስፋዬ ስቋር	Täsfayé Seqwar	Tesfaye Sekwar
ተስፋዬ ብርሀኑ	Täsfayé Berhanu	Tesfaye Birhanu
ተስፍዬ ኃብተ ማርያም	Täsfayé Habtä-Maryam	Tesfaye Habte Mariam
ተስፋዬ ነጋሽ	Täsfayé Nägaš	Tesfaye Negash
ተስፋዬ አበበ	Tasfayé Abbäbä	Tesfaye Abebe
ተስፋዬ አፈወርቅ	Täsfayé Afäwärq	Tesfaye Afework
ተስፋዬ እሸቴ	Tasfayé Ešäté	Tesfaye Eshete
ተስፋዬ ወርቁ	Täsfayé Wärqu	Tesfaye Worku
ተስፋዬ የውነቴ	Täsfayé Yäwnäté	Tesfaye Yewnete
ተስፋዬ ገሠሠ	Täsfayé Gässäsä	Tesfaye Gessesse
ተስፋ ገብረ ሥላሴ	Täsfa Gäbrä-Sellasé	Tesfa Gebre Silassie
ተስፋ ጊዮርጊስ	Täsfa-Giyorgis	Tesfa Giorgis
ተሻገር ውቤ	Täšagär Webé	Teshager Wube
ተሾመ ተክሌ	Täšomä Täklé	Teshome Tekle
ተሾመ ወልደ ጻድቅ	Täšomä Wäldä-Sadeq	Teshome Walde Tsadik
ተሾመ ገብረ ሥላሴ	Täšomä Gäbrä-Sellasé	Teshome Gebre Silassie
ተሾመ ጋርዴ	Täšomä Garredé	Teshome Garide
ተቋመ ወልደ ጻድቅ	Taqwamä Waldä-Sadeq	Tekome Wolde Tsadik
ተአምራት ይገዙ /ኰሎኔል/	Tammerat Yeggazu	Tamerat Yegezu
ተከስተ ብርሃን ወልደ ኢየሱስ	Täkästä-Berhan Wäldä-Iyäsus	Tekeste Birhan Wolde Eyesus
ተከስተ አብርሃም	Täkästä Abrham	Tekeste Abrham
ተካ ዛሬ	Täkka Zaré	Teka Zare
ተክለሐዋርያት /በጅሮንድ/	Täklä-Hawaryat	Tekle Hawariat
ተክለማርያም /አባ/	Täklämaryam	Teklemariam
ተክለማርያም ኃይሌ	Täklämaryam Haylé	Teklemariam Haile
ተክለማርያም ጽዮን	Täklä-Maryam Seyon	Tekle-Mariam Tsion
ተክለማርያም ገዛኸኝ	Täklä-Maryam Gäzzahäň	Teklemariam Gezaghn
ተክለማርያም ፋንታዬ	Täkämaryam Fantayé	Teklemariam Fantaye
ተክለብርሃን ዜና	Täklä-Berhan Zéna	Tekleberhan Zena
ተክለ ኃይማኖት መንግሥተ አብ	Täklä-Haymanot Mängestä-Ab	Tekle Haimanot Mengeste-Ab
ተክለ ጻድቅ መኩሪያ	Täklä-Sadeq Mäkuriya	Tekle-Tsadik Mekuria
ተኽላይ ዘወልዴ	Tählay Zäwäldé	Teklaye Zewolde
ተወልደ መድኅን ዮሴፍ /አባ/	Täwäldä-Mädhen Yoséf	Tewolde Medhin Yoseph
ተወልደ መድኅን ገብሩ	Täwäldä-Mädhen Gäbru	Tewolde Medhin Gebru 
ተወልደ ብርሃን /መምህር/	Täwäldä-Berhan	Tewoldeberhan
ተውህቦ ምሕረት	Täwhebo Mehrät	Tewhbo Mehret
ተገኝ ተአምሩ	Tägäň Tameru	Tegne Teamru
ተጫነ አበበ	Täčanä Abbäbä	Techane Abebe
ተፈሪ ደፈረሱ	Täfäri Däfärräsu	Teferi Deferesu
ተፈራ በዬነ	Täfärra Bäyyänä	Teferra Beyene
ተፈራ ወልደ አማኑኤል	Täfärra-wäldä-Amanuél	Teferi Wolde Amanuel
ተፈራ ወርቅ አምባዬ	Täfara-Wärq Ambayé	Teferra-Worke Ambaye
ተፈራ ወንድምአገኘሁ	Täfärra Wändmmagäňähu	Teferra Wendemeagnehu
ተፈራ ይኼይስ	Täfärra Yehéyyes	Teferra Yeheyes
ተፈራ ደመና	Täfärra Dämmäna	Teferra Demene
ታምሩ መኰንን	Tameru Mäkwännen	Tameru Mekonnen
ታምራት መንገሻ	Tamrat Mängäša	Tamerat Mengesha
ታምራት አማኑኤል /ፕሮፌሰር/	Tamrat Amanuél	Tamerat Amanuel
ታምራት ያኔ	Tamrat Yanné	Tamerat Yani
ታምራት ዳሹ	Tamrat Dašu	Tamerat Dashu
ታረቀ ንጉሴ	Tärräqä Negusé	Tareke Negussie
ታረቀኝ ዓለሙ	Tarräqäń Alämu	Tarekgne Alemu
ታሲሳ ኤባ	Tasisa Eba	Tasissa Ebba
ታዬ ገብረማርያም	Tayé Gäbrä-Maryam	Taye Gebremariam
ታደለ አለነ	Taddälä Allänä	Taddele Alene 
ታደለ ደሴ	Taddälä Däsé	Taddele Dessie
ታደሰ ሊበን	Taddäsä Libän	Taddese Liben
ታደሰ ሜጫ	Taddäsä Méčča	Taddese Mecha
ታደሰ ብዙነህ	Taddäsä Bezunäh	Taddese Bezuneh
ታደሰ አብዲ	Taddäsä Abdi	Taddese Abdi
ታደሰ እማኙ	Taddäsä Emmaňu	Taddese Emagnu
ታደሰ ወልደ ዮሐንስ	Taddäsä Waldä-Yohannes	Taddese Wolde Yohannes
ታደሰ ወርቁ	Taddäsä Wärqu	Taddese Worku
ታደሰ ዘወልዴ	Taddäsä Zäwälde	Taddese Zewoldie
ታጀበ በየነ	Tajjäbä Bäyyänä	Tajebe Beyene
ቴዎድሮስ መለሰ	Tewodros Mälläsä	Tewodros Melless
ትምህርት ወዳጅ	Temehert Wädaj	Temhret Wedage
ትዛዙ ሙሉጌታ	Tezazu Mulugeta	Tezazu Mulugetta
ትእዛዙ ኃይሉ	Tezazu Haylu	Tezazu Hailu
ቸርነት ቢሰውር	Čärnnät Bisäwwer	Cherinet Bisewere
ኃይለ መለኮት ክዳ.ም.የኖ	Hayle-Mäläkot	Haile Melekot
ኃይለ መስቀል ገብረመድኅን	Haile Mäsqäl Gabrä-mädhen	Haile Meskel Gabremedhin
ኃይለ ሥላሴ ቀዳማዊ፣ ንጉሠ ነገሥት ዘኢትዮጵያ	Haile Sellassie I (Qädamawy)	Haile Selassie (Kedamawe)
ኃይለ ሥላሴ ደስታ	Hayle-Sellasé Dästa	Haile Selassie Desta
ኃይለ ኢየሱስ ፈቃዱ	Hayla-Iyasus Fäqadu	Haile Yesus Fecadu
ኃይለ ገብርኤል ነገሮ	Haylä-Gabrél Nägäro	Haile Gabriel Negero
ኃይሉ ለውጤ	Haylu Läweté	Hailu Leweté
ኃይሉ ልመንህ	Haylu Lemäneh	Haylu Lemeneh
ኃይሉ በላይነህ /ግራዝማች/	Haylu Bälaynäh	Hailu Belayneh
ኃይሉ ብርሃነ	Haylu Berhan	Hailu Berhan
ኃይሉ ቸርነት	Haylu Čarennät	Hailu Chernete 
ኃይሉ ወልደ አማኑኤል	Haylu Wäldä Amanuel	Hailu Wolde Amanuel
ኃይሌ ቀለታ	Haylé Qäläta	Haile Keletta
ኅሩይ ወልደ ሥላሴ /ብላቴን ጌታ/	Heruy Wäldä-Sellasé	Herui Woldie Selassie
ነመራ ጫላ	Nämära Čala	Nemera Challa
ነብየ ልዑል ዮሐንስ	Näbeyya-Leul Yohannes	Nebeye Leul Yohanese
ነብያት ተፈሪ	Näbyat Täfäri	Nebeyate Tefferi
ነገደ ገብረአብ	Nágädä Gäbrab	Negede Gebreab
ነጋሽ መሸሻ	Nägaš Mäšaša	Negash Meshesha
ነጋሽ ገብረ ማርያም	Nägaš Gabrä-Maryam	Negash Gebre Mariam
ነጋሽ ተገኝ	Näggaš Tägäň	Negash Tegne
ኒኮላስ /ግሪክ ኦርቶዶክስ የአክሱም/	Nicolas, Archbishop (of Aksum)	Nicolas, Archbishop of Aksum	Non-Ethiopian
ንጉሤ ተፈራ	Negusé Täfärra	Negussie Teferra
ንጉሤ ኃብተ ሚካኤል	Negusé Habtä-Mikael	Negussie Habte Michael
ንጉሤ ወልደ ሚካኤል	Negusé Wäldä-Mikael	Negussie Wolde Michael
አ.አ. ምስካየ ኅዙናን መድኃኒዓለም ቤተ ክርስቲያን	Addis Ababa Meskayä Hezunan Madhanéalem Bétä Krestiyan	Addis Ababa Meskaye Hezunane Medhanealem Bete Krestiyan
አ.አ. ቅዱስ ጳውሎስ ስዋሰው ብርሃን ት/ቤት	Addis Ababa Qeddus Pawlos Säwasewä Berhan Temehert Bét	Addis Ababa Kedus Pawelos Sewasew Berhane Temhert Bet
አ.አ. ብርሃንና ሰላም ማተሚያ ቤት	Addis Ababa Berhanénna Sälam Mattämiya Bét	Addis Ababa Berhanena Selam Matemiya Bet
አ.አ. ተፈሪ መኰንን ት/ቤት	Addis Ababa Täfäri Makwannen Temehert Bét	Addis Ababa Teferi Mekonnen Temhret Bet
አ.አ. አስፋው ወሰን ት/ቤት	Addis Ababa Asfaw-Wäsän Temehert Bét	Addis Ababa Asfaw Wossen Temehret Bet
አ.አ. የትግራይ ልማት ድርጅት	Addis Ababa Yätegray Lemat Derejjet	Addis Ababa Yetigraye Lemat Derijet
አ.አ. ደጃዝማች ወንድይራድ ት/ቤት	Addis Ababa Däjjazmačh Wand-Yerad Temehert Bét	Addis Ababa Dejazemach Wendyerad Temehret Bet
አለባቸው ወንድ ይራድ	Alläbbačäw Wand-Yerad	Alebachew Wond-Yerad
አሉላ ሰይፉ	Alula Säyfu	Alula Seifu
አሉላ ዋሴ	Alula Wasé	Alula Wassie
አላዮ ጉርሙ	Alayyu Gurmu	Alayu Guremu
አልማዝ እሸቴ	Almaz Ešate	Almaz Eshete
አልጋነሽ ወልደ ቂርቆስ	Alganäš Wäldä-Qirqos	Algganesh Wolde Kirkos
አሐዱ ሳብሬ	Ahadu Saburé	Ahadu Sabure 
አማረ ማሞ	Amarä Mammo	Amare Mamo
አማረ ወርቁ	Amarä Wärqu	Amare Worku
አማረ ጌታሁን	Amarä Getahun	Amare Getahun
አማኑኤል አብርሃም	Amanuel Abrham	Amanuel Abrham
አምሳለ ወርቅ ኃይለማርያም	Amsalé-Wärq Haylä Maryam	Amsale Work Hailemariam
አምባዬ ሀብተ እግዚእ	Ambayé Habtä-Egzi	Ambaye Habte-Egzi
አምደሚካኤል ደሳለኝ	Amdämikael Dässaläň	Amdemichael Dessalegn
አሥራተ ማርያም የምሩ	Asratä-Maryam Yämerru	Asrate Mariam Yemiru
አሥራት ታደለ	Asrat Taddälä	Asrat Tadele
አሥራት ወልዴ	Asrat Wäldé	Asrat wolde 
አሥራት ወንድምአገኘሁ	Asrat Wändemmagänähu	Asrat Wondmagegnehu
አሥራት ገብረ ጻድቅ	Asrat Gäbrä-Sadeq	Asrat Gebretsadik
አረጋሽ ወልደ ሥላሴ	Arägaš Wäldä-Sellase	Aregash Wolde selassie 
አረጋሽ ገዳሙ	Arägäs Gädamu	Aregash Gedamu
አረጋኸኝ ወንድምአገኘሁ	Aräggahäň Wändemmagäňähu	Aregahegn Wondimagegnehu
አርአያ በላይ	Araya Bälay	Araya Belay 
አርጋው ወንድሜነህ	Argaw Wändemmenäh	Argaw Wondmeneh
አሰፋ መልኬ	Asäffa Mälké	Asefa Melke
አሰፋ ሰብስቤ	Asäffa Säbsebé	Asefa Sebsibe
አሰፋ በላይ	Asäffa Bälay	Asefa Belay 
አሰፋ ተክለኃይማኖት	Asäffa Täklä Haimanotéé	Asefa Tekle Haymanot
አሰፋ ተፈሪ	Asäffa Täfäri	Asefa Teferi 
አሰፋ ኃይለ መሥቀል	Asäffa Haylä-Mäsqäl	Asefa Haile Meskel
አሰፋ አየለ	Asäffa Ayyälä	Asefa Ayele
አሰፋ ወልደ ሚካኤል	Asäffa Wäldä-Mikael	Asefa Wolde Michael
አሰፋ ወንድምአገኘሁ	Asäffa Wondemmagäňahu	Asefa Wondmagengnehu
አሰፋ አለማየሁ	Asäffa Alämayyähu	Asfa Alemayehu
አሰፋ ይርጉ	Asäffa Yergu	Asefa Yirgu
አሰፋ ገብረማርያም	Asäffa Gäbrä-Maryam	Asefa Gebre Mariam
አሳዝነው ባይሳ	Asazzänäw Baysa	Asazinew Baisa
አስረስ ተሰማ	Asräs Täsämma	Asres Tesemma
አስረስ አስፋወሰን	Asräs Asfawasän	Asres Asfawosen
አስረስ የኔ ሰው	Asräs Yäné-Säw	Asres Yenesew
አስናቀ ጌታቸው	Asnaqä Getaččäw	Asnake Getachew 
አስገዶም ረዳ /ግራዝማች/	Asgädom Rädda	Asgedom Redda
አስፋው ሺበሺ	Asfaw Šibäsi	Asfaw Shibeshi
አስፋው ተፈራ	Asfaw Täfarra	Asfaw Tefera
አስፋው ቸርነት	Asfaw Čärennät	Asfaw Cherinnet
አስፋው ወሰን መካሻ	Asfaw Wäsän Makaŝa	Asfaw Wossen Mekasha
አሸብር ገብረሕይወት /ባላምባራስ/	Aśšäbber Gäbrä Heywät	Ashebir Gebrehewot
አሸናፊ ከበደ	Ašännafi Käbbädä	Ashenafi Kebede
አሸናፊ ጌታሁን	Asännafi Getahun	Ashenafi Getahun
አሻግሬ ታደሰ	Aŝŝagre Taddäsä	Ashagre Tadesse
አበራ ሞልቶት	Abärra Moltot	Abera Moltot
አበራ ጀምበሬ	Abärra Jämbäré	Abera Jembere
አበራ ገብረ መድኅን	Abärra Gäbrä-Mädhen	Abera Gebre Medhin
አበራ ገብረሚካኤል	Abärra Gäbrä-Mikaél	Abera Gebre Michael
አበበ ብዙነህ	Abbäbä Bezunäh	Abebe Bizuneh
አበባ ንጉሤ	Abbäbä Negusé	Abeba Negussie
አበባ አይቸህ	Abbäbä Ayččäh	Abeba Aycheh
አበበ ወልደሚካኤል	Abbäbä Wäldä-Mikaél	Abebe Wolde Michael
አበባ ወልደ ሩፋኤል	Abbäbä Wäldä-Rufaél	Abeba Wolde Rufael
አበባ ተስፋ ጊዮርጊስ	Abäba Täsfa Giyorgis	Abeba Tesfa Giorgis
አበባው ይግዛው	Abäbaw Yegzaw	Abebaw Yigzaw 
አቢይ ደምሴ	Abiy Dämessé	Abiy Demesse
አባቡ አደጉ	Abbabbu Addägu	Ababu Adegu
አቤ ጉበኛ	Abbé Gubaňa	Abbe Gubegna
አብርሃም አስገዶም	Abrham Asgädom	Abrham Asgedom
አብርሃም ዘርፉ	Abrham Zärfu	Abrham Zerfu
አብርሃም ፀጋዬ	Abrham Şäggayé	Abrham Tsegaye
አብርሃ ረዳ ጻድቅ	Abrha Rädda-Şadeq	Abrha Reda Tsidk
አብርሃ ገብረ ሕይወት	Abrha Gäbrä-Heywät	Abrha Gebre Hiwot 
አብርሃ ገብራይ	Abrha Gäbray	Abrha Gebray
አብዱል ባሪእ መሐመድ	Abdul Bari Mähamäd	Abdul Bari Mohammed
አብዲሳ አጋ	Abdissa Aga	Abdissa Aga
አንተነህ ዓለሙ	Antänäh Alämu	Anteneh Alemu
አእምሮ ንጉሤ	Aemero Negusé	Aymro Negusse
አእምሮ ወንድምአገኘሁ	Aemero Wändemmagäňähu	Aymro wondimagegnehu
አክበር ፈረደ	Akbbär Färrädä	Akber Ferede
አክሊለ ብርሃነ ወልደ ቂርቆስ /ሊቀ ጠበብት/	Aklilä Berhan Wäldä-Qirqos	Aklila Berhan Welde Kiros 
አዛናው ዓለሜ	Aznaw Alämé	Azanaw Aleme 
አየለ ተክለኃይማኖት /ዶክተር/	Ayyälä Taklä-Haymanot	Ayele Tekle Haimanot
አየለ ኪዳኔ	Ayyälä Kidané	Ayele Kidane
አየለ ዘለለው	Ayyälä Zälläläw	Ayele Zelelew
አየለ ገብሩ	Ayyälä Gäbru	Ayele Gebru 
አያሌው በለው	Ayyaléw Bäläw	Ayalew Belew 
አያሌው ተሰማ	Ayyaléw Täsämma	Ayalew Tesemma
አያሌው ታምሩ	Ayyaléw Tammeru	Ayalew Tamiru
አያሌው አርአያ	Ayyaléw Araya	Ayalew Araya
አያሌው ገብረ ሥላሴ	Ayyaléw Gäbrä-Sellasé	Ayalew Gabre Selassie 
አዲስ አበባ መድኃኒዓለም ት/ቤት	Addis Ababa Mädhané Aläme Temehert Bét	Addis Ababa Medhane Alem Temhert Bet
አዲስ አበባ ሽመልስ ሀብቴ ት/ቤት	Addis Ababa Šimälles Habté Temehert Bét	Addis Ababa Shimelis Habte Temhert Bet 
አዲስ አበባ ቀዳማዊ ኃይለ ሥላሴ ቲያትር	Addis Ababa Qädamawi Haile Sellassie Tiyatér	Addis Ababa Kedamawi Haile Sellassie Tiater
አዲስ አበባ ቤተ መንግሥት	Addis Ababa Bétä Mängest	Addis Ababa Bet Mengist
አዲስ አበባ የሕዝብ ቆጠራ ሪፖርት	Addis Ababa Yahezb Qotära Riport	Addis Ababa Yehizb Kotera Riport
አዲስ አበባ ዩኒቨርስቲ	Addis Ababa Yunivärsiti	Addis Ababa Yuniversiti
አዲስ አበባ ያገር ፍቅር ማኅበር	Addis Ababa Yagär Feqer Mahbär	Addis Ababa Yager Feker Mahber
አዳነ ጐላ	Adanä Gwalla	Adane Golla
አድማሱ ጀንበሬ	Admasu Janbäré	Admassu Jenbere 
አድማሱ ጀምበሬ /መልአከ ብርሃን/	Admasu Jambré	Admassu Jembere 
አድኃኖም ሥእሎ	Adhannom Séllo	Adhanom Sélo 
አድነው ዘውዴ	Adenäw Zäwde	Adenew Zewde 
አድነው ገብረ መስቀል /ሻንበል/	Adenäw Gäbrä-Mäsqäl	Adenew Gebre Meskel
አጉስጢኖስ ዘሔቦ /አባ/	Agustinos Zähebo	Agustinos Zehebo
አፈወርቅ ዘውዴ	Afäwarq Zäwdé	Afeworke Zewde
አፈወርቅ ዮሐንስ	Afäwärq Yohannes	Afeworke Yohanes
አፈወርቅ ገብረ ኢየሱስ /ነጋድራስ/	Afäwärq Gabrä-Yessus	Afeworke Gebre Yesus
አፈወርቅ ፈለቀ	Afäwärq Fälläqä	Afework Feleke
ኢላላ ኢብሳ	Ilala Ibsa	Ilala Ebsa
ኢሳይያስ ዓለሚ	Isayyas Alämé	Isayeyas Alemé
ኢሳይያስ ገብረ ሥላሴ /ኰሎኔል/	Isayyas Gäbräsellasé	Isayas Gebre Selassie
ኢትዮጵያ፣ ሕዝባዊ ኑሮ እድገት ሚኒስቴር።	Ethiopia, Hezbawi Nuro Edgät Ministér	Ethiopia, Hezibawi Nuro Idigate Ministér
ኢትዮጵያ፣ መከላከያ ሚኒስቴር	Ethiopia, Mäkkälakäya Ministér	Ethiopia, Makelakeya Minister
ኢትዮጵያ፣ ማስታወቂያ ሚኒስቴር	Ethiopia, Mastawaqiya Ministér	Ethiopia, Mastawekia Minister
ኢትዮጵያ፣ ትምህርት ሚኒስቴር	Ethiopia, Temehert Ministér	Ethiopia, Temhert Minister
ኢትዮጵያ፣ ንግድ ባንክ	Ethiopia, Negd Bank	Ethiopia, Negid Bank
ኢትዮጵያ፣ ኤሌክትሪክ ማብራት ኃይል ባለስልጣን	Ethiopia, Electrik Mebrat Hayl Balä-Seltan	Ethiopia, Electric Mebrat Hayl Bale Seltan
ኢትዮጵያ፣ እርሻ ሚኒስቴር	Ethiopia, Erša Minister	Ethiopia, Ersha Ministér
ኢትዮጵያ፣ ኦርቶዶክስ ቤተ ክርስቲያን	Ethiopia, Ortodox Betä Kerstiyan	Ethiopia, Ortodox Bete Kristian
ኢትዮጵያ፣ ወንጌላዊት ቤተ ክርስቲያን	Ethiopia, Wangelawit Béta Kerstiyan	Ethiopia, Wengelawit Bete Kristian
ኢትዮጵያ፣ የሁለተኛው የአምስት አመት ፕላን	Ethiopia, Yähulätäňňaw Yammest Amät Plan	Ethiopia Yehuletegnawe Yeameste Amet Plan
ኢትዮጵያ፣ የሕዝብ ጤና ጥበቃ	Ethiopia Yähezb Tena Tebbäqa	Ethiopia, Yehezb Tenat Tebeka
ኢትዮጵያ፣ የክብር ዘበኛ ሠራዊት	Ethiopia, Yakebr Zäbäňa Sarawit	Ethiopia, Yekber Zebegna Serawit
ኢትዮጵያ፣ የግርማዊ ንጉሠ ነገሥት ካቢኔ	Ethiopia, Yagermawi Negusä Nägäst Kabiné	Ethiopia, Yegermawi Neguse Nagest Kabine
ኢትዮጵያ፣ የፍትሐ ብሔር ሕግ	Ethiopia, Yäfethabehér Heg	Ethiopia Yefethabiher Hege
ኢትዮጵያ፣ የፍትሕ ብሔር ሥነ ሥርአት ሕግ	Ethiopia, Yafethabehér Senä Serat Heg	Ethiopia Yefethabher Sene Serate Hege
ኢትዮጵያ፣ የፕብሊክ አድሚኒስትሬሽን ኢንስቲትዪት	Ethiopia, Yapublic Administration Institute	Ethiopia, Yepeblik Adminstration Institute
ኢትዮጵያ፣ ያገር ግዛት ሚኒስቴር	Ethiopia, Yagär Gizat Ministér	Ethiopia Yeager Gizat Minister
ኢትዮጵያ፣ ገንዘብ ሚኒስቴር	Ethiopia, Gänzäb Ministér	Ethiopia Genzeb Minister
ኢትዮጵያ፣ ገቢ ሚኒስቴር	Ethiopia, Gebbi Ministér	Ethiopia, Gibbi Minister
ኢትዮጵያ፣ ጤና ጥበቃ ሚኒስቴር	Ethiopia, Tena Tabbaq Ministér	Ethiopia, Tena Tebeka Minister
ኢትዮጵያ፣ ፓርላሜንት	Ethiopia, Parliamént	Ethiopia, Parliament
ኢትዮጵያ፣ ፖሊስ ሠራዊት	Ethiopia, Polic Särawit	Ethiopia, Police Serawit
ኢትዮጵያ፣ ፖስታ ሚኒስቴር	Ethiopia, Postal Ministér	Ethiopia, Posta Ministér
ኢያሱ አስፍሐ	Eyyasu Asfeha	Eyasu Asfeha 
ኤልያስ በሻህ	Elyas Bäŝah	Elias Beshahe
ኤሬክስን፣ ኡል	Erisksson, Olle	Erikesson,Olle	Non-Ethiopian
ኤርትራ ማዘጋጃ ቤት	Eretra Mazzägaja Bét	Eritria Mazegaga Bet
ኤርትራ የንጉሠ ነገሥት እንደራሴ ጽ/ቤት	Eretra Yänegusä Nägäst Endärasé Sehfät Bét	Eritrea, Yeneguse Negeste Enderassie Tsehfet Bet
ኢዘንበርግ ቻርልስ፣ ዊልያም	Isenberg, Charles William	Isenberg, Charles William	Non-Ethiopian
ኤፍሬም ፀሐይ	Efrém Şahay	Efrem Sehay
እምሩ ኃይለ ሥላሴ /ልዑል ራስ/	Emmeru Haile Sellassie	Imeru Haile Selassie
እምሩ ዘለቀ	Emmeru Zälläqä	Imeru Zelleke
እስጢፋኖስ ጋይም	Estifanos Gaym	Estiphanos Gaim
እሸቴ ባዩ	Ešäté Bayyu	Eshete Bayu 
እሸቴ ደምሴ	Ešaté Damessé	Eshete Demisse
እናኑ አጐናፍር	Ennannu Agwänafer	Enanu Agonafer
እንደሻው ተክለ ሥላሴ	Endaššaw Taklä-Sellasé	Endeshaw Tekle Selassie
እንድርያስ /አቡነ/	Endreyas Abunä	Endrias, Abune
እንግዳ ጽጌ ሐና	Engeda Şegé Hanna	Engeda Tsige Hanna
እጓለ ገብረ ዮሐንስ	Egwalä Gäbrä-Yohannes	Eguale Gebre Yohannes 
ከማል ሐጂ	Kämal Haĝi	Kemal Haji
ከበደ ሀብተ ማርያም	Käbbädä Habtä-Maryam	Kebede Habte Mariam
ከበደ መንገሻ	Käbbädä Mängäša	Kebede Mengesha
ከበደ ሚካኤል	Käbbädä Mikaél	Kebede Michael
ከበደ ተድላ	Käbädä Tädla	Kebede Tedla
ከበደ እንግዳሰው	Käbbädä Engedasäw	Kebede Engedasew
ከበደ ወልደ ሚካኤል	Käbbädä Wäldä-Mikaél	Kebede Wolde Michael
ከበደ ወልደ ጻድቅ	Käbbädä Wäldä-Şadeq	Kebede Wolde Tsadik
ከበደ አለሙ	Käbbädä Alämu	Kebede Alemu
ከበደ ደስታ	Kabbädä Dästa	Kebede Desta
ከበደ ገብረ ጊዮርጊስ	Käbbädä Gäbra Giorgis	Kebede Gebre Giorgis
ከበደ ገብሬ	Käbädä Gäbré	Kebede Gabre
ከተማ ደስታ	Kätäm Dästa	Ketema Desta
ኩማ ኢደኤ	Kumma Eddaé	Kumma Edaé
ኪዳነ ማርያም	Kidanä-Maryam	Kidan Mariam
ኪዳነ ማርያም ወልደ ሚካኤል /አባ/	Kidanä-Maryam Walda-Mikaél	Kidane-Mariam Wolde-Mikael
ኪዳነ ማርያም ገብረ ሕይወት /መምህር/	Kidanä-Maryam Gäbrä-Heywat	Kidane-Mariam Gebre Hiywot
ኪዳነ ማርያም ጌታሁን	Kidanä Maryam Getahun	Kidane-Mariam Getahun
ኪዳነ ወልድ ክፍሌ /አለቃ/	Kidanä Wold Kiflé	Kidane Wold Kifle
ካሳ ኃይሉ	Kasa Haylu	Kassa Hailu
ካሳዬ ስብሐት ለአብ	Kasayé Sebhat-Lab	Kassaye Sebhate-Laab
ካሳው ወርቅነህ	Kasaw Warqenäh	Kassaw Workneh
ካሳ ፈድሉ	Kasa Fädlu	Kassa Fedlu
ካርል ጉስታብ ሩጐን	Carl Gustav R	Karl Gustav Rugon	Non-Ethiopian
ክበበው ደቃ	Kebäbäw Däqa	Kibebew Daka
ክንፈ ተስፋ ጋብር	Kenfä Täsfa-Gaber	Kinfe Tesfa Gabre
ክንፉ ኪዳኔ	Kenfu Kidané	Kinfe Kidane
ክፍለ እግዚህ ይሕደጎ /ብላታ/	Kifla Igzi Yihidägo	Kifle Egzi Yihidago
ክፍሌ ወርቁ	Keflé Wärqu	Kifle Worku
ክፍሌ ወርካዬ	Keflé Wärkayé	Kifle Workaye
ወልደ ክርስቶስ በቀለ	Waldä-Kerstos Bäqqälä	Wolde Kirstos Bekele
ወልደ ትንሣኤ አባይ	Wäldä-Tensaé Abay	Wolde Tensaye Abai
ወልደ አማኑኤል ቸሩ	Wäldä-Amanuel Čäru	Wolde-Amanuel Cheru
ወልደ አብርሃም /አባ/	Wäldä Abrham	Wolde Abrham
ወልደ ገብርኤል አሠጌ	Wäldä-Gabrél Assäggé	Wolde Gabriel Assagge
ወልደ ጊዮርጊስ ወልደ ዮሐንስ /ብላታ/	Wäldä-Giyorgis Wäldä-Yohannes	Wolde Giorgis Wolde Yohannes
ወርቄ ዘውዴ	Wärqé Zäwdé	Werkie Zewde
ወርቅነህ /ሐኪም/	Wärqenäh Hakim	Workeneh (Hakim)
ወሰኔ ይፍሩ	Wäsäné Yefru	Wessene Yiferu
ወንድሙ ገብረሚካኤል	Wändemmu Gäbrämikaél	Wondimu Gebremikael
ወንድማገኝ ኃይሉ	Wändemmagäň Haylu	Wondemagn Hailu
ወንድአየሁ ሀብተ ገብርኤል	Wandayyähu Habtä-Gabrél	Wondayehu Habte Gebriel
ወንድ ይራድ ይመር	Wändyerad Yemär	Wondyerad Yemer
ወንጂ ስኳር	Wonji Sekwar	Wonji Sekewar
ወደር የለሽ ማይክል	Wädär-Yälläš Maykel	Weder Yellesh Maykel
ወደር የለሽ ከበደ	Wädär Yälläš Käbbädä	Wederyellesh Kebede
ወዳጄነህ ወልደ ሥላሴ	Wädajenäh Wäldä-Sellasé	Wedajeneh Wolde Selassie
ውበት /ግራዝማች/ ውበቴ	Webät Webäté	Webet Webete
ዐምደ ሚካኤል ደስአለኝ	Amdä-Mikaél Dässaläň	Amdemichael Dessalegn
ዐሥራተ ማርያም /አባ/	Asratä-Maryam	Asrat-Mariam (Abba)
ዐይነ ዓለም ገብረማርያም	Aynä-Aläm Gäbrä Maryam	Aynalem Gabre Mariam
ዓለመወርቅ ደፈረስ /የከብት ሐኪም/	Alämä-Wärq Däfärräsä	Alemework Deferese Beyene
ዓለሙ ደስታ	Alämu Dästa	Alemu Desta
ዓለማየሁ ሞገስ	Alämayyähu Mogäs	Alemayehyu Moges
ዓለማየሁ ብሩ	Alämayyähu Beru	Alemayehu Biru 
ዓለማየሁ አሰፋ	Alämayyähu Asffaw	Alemayehu Asefa
ዓለማየሁ ኪዳኔ	Alämayyähu Kidané	Alemayehu Kidanie 
ዓለማየሁ ገብሩ	Alämayyähu Gäbru	Alemayehu Gebru 
ዓለማየሁ ጥላሁን	Alämayyähu Telahun	Alemayehu Telahun 
ዓለማየሁ ፈጠነ	Alämayyähu Fättänä	Alemayehu Fetene
ዓሊ ከበደ	Ali Käbbädä	Ali Kebede
ዕቁባ ቴዎድሮስ ገብረ አምላክ	Equbä Tewodros Gäbrä-Amlak	Ekube-Tewodros Gebre Amlak
ዓምደ ሚካኤል ማሎ	Amdä-Mikaél Malo	Amde-Michael Malo
ዓምደ ሥላሴ ጀምበሬ	Amdä-Sellasé Ğämbäré	Amdeselassie Jembere
ዓምደ ጽዮን ተሰማ	Amdä-Şeyon Täsämma	Amdesion Tesema
ዕቁባ እግዚእ ገብረ ሚካኤል	Equba-Egzi Gäbrä-Mikaél	Ekubaegzi Gebremichael
ዑቅባይ ወልደ ገብርኤል	Uqbay Wäldä-Gäbrél	Ekubay Woldegebriel
ዘለቀ ታፈሰ	Zälläqä Taffäsä	Zeleke Tafese
ዘለቀ እውነቱ	Zälläqä Ewnätu	Zeleke Ewnetu
ዘመነ ካሠኝ	Zämänä Kasäň	Zemene kasegn
ዘመንፈስ ቅዱስ አብረሃ	Zämänfäs Qeddus Abrha	Zemenfeskedus Abraha
ዘርኦም ክፍሌ	Zärom Keflé	Zerom Kiflie
ዘነበ ኢትዮጵያዊ	Zännäbä Ityopyawi	Zenebe Ethiopiawi
ዘካሪያስ ገብረ ሥላሴ	Zäkkaryas Gäbrä-Sellasé	Zekarias Gebreselasie
ዘገብርኤል ወዳጆ	Zägäbrél Wädajo	Zegebriel Wodajo
ዘውዲቱ አሸብር	Zäwditu Aššäber	Zewditu Asheber
ዘውዱ ወርቁ	Zäwdu Wärqu	Zewdu Worku
ዘውዴ ታደሰ	Zäwde Taddäsä	Zewdie Tadese
ዘውዴ ካሕሣይ	Zäwde Kahsay	Zewdie Kahsay
ዘውዴ ወልደ ቂርቆስ	Zawdé Wäldä-Qirqos	Zewdie Woldekirkos
ዘውድነሽ ዓለሙ	Zäwdenäš Alämu	Zewdnesh Alemu
ዘውገ ተገኘ ወርቅ	Zäwgä Tägäňä Wärq	Zewge Tegegnework
ዜና መዋዕል	Zena Mäwael	Zena Mewael
ዜና ማርቆስ እንዳለው	Zena Marqos Endaläw	Zenamarkos Endalew
የሁሉም ይማር ድርጅት	Yahullum Yemmar Derejjet	Yehulum-Yemar Derjet
የሐረርጌ ጠ/ግ የሥራ ዲሬክሲዮን	Yeharärgé Täqlay Gezat Yäsera Direksiyon	Yeharegie Teklay Gezat Yesera Direksion
የሕፃናት ምግብ ጥናት ክፍል	Yahesanat Megeb Tinat Kefl	Yehetsanat Megeb Tenate Kefel
የመርሐ ዕውራን ትምህርት ቤት	Yämärha Ewweran Temehert Bét	Yemerha-Eweran Temhert Biet
የመተባበር ማኅበር	Yämättäbabär Mahbär	Yemetebaber Mahber
የመንበረ ፀባዖት ቅድስት ሥላሴ ካቴድራል ጽ/ቤት	Yämänbärä Şabaot Qeddest Sellase Katédral Sehefät Bét	Yemenberetsebaot Kedest Selassie Cath
የመጽሐፍ ቅዱስ ማኅበር	Yämäshaf Qeddus Mahbär	Yemetshaf Kedus Mahber
የማነ ብርሃን እጅጉ	Yämanä-Berhan Ejjegu	Yemaneberhan Ejigu
የማነ ብርሃን ጌታነህ	Yamanä-Berhan Gétanäh	Yemaneberhan Getaneh
የማነ ክርስቶስ ይርጉ	Yämanäkerstos Yergu	Yemanekerstos Yirgu
የማነ ገብረ ማርያም	Yamanä Gäbrä-Maryam	Yemane Gebremariam
የምስራቅ ኦርቶዶክስ አብያተ ክርስቲያናት መሪዎች ጉባኤ	Yamesraq Ortodox Abyatä Kerstiyanat Mariwoč Gubaé	Yemesrak Ortodox Abiate-Kerestianat Gubae
የምስራች ድምፅ ሥነ ጽሑፍ ድርጅት	Yamessrač Demş Senä Sehuf Derejjet	Yemeserachdemts Senessehuf Derejit
የሠራዊተ ክርስቶስ ማህበር	Yäsärawitä Kristos Mahbär	Yeserawite Kristos Mahber
የሰውልክ አያሌው	Yäsäwlek Ayyaléw	Yesewlik Ayalew
የሱፍ አብድረህማን ፤ ሐጂ	Yäsuf Abderahman /Haji/	Yesuf Abdurahman Haji
የሺመቤት ተፈሪ	Yaši Emmäbet Täfäri	Yeshimebet Teferi
የቀኃይለ ሥላሴ ሽልማት ድርጅት	Yäqädamawi Haile SŠellemat Derejjet	Yekedamawi Haileselasie Shilimat Derjet
የቀኃይለ ሥላሴ በጎ አድራጐት ድርጅት	Yäqädamawi Haile S Bägo Adragot Derejjet	Yekedamawi Haile Selassie Bego Adragot Derejjet
የቀኃይለ ሥላሴ ጦር አካዳሚ	Yäqädamawi Haile S Ţor Akadami	Yekadamawi Haile Sellassie Tor Akadami
የቃለ ሕይወት ሥነ ጽሑፍ ድርጅት	Yäqalä Heywät Senä Sehuf Derejjet	Kale Hiwot Sene Sehuf Derjjet
የቅዱስ መጽሕፍት አንባቢዎች ማኅበር	Yäqeddusan Mäsaheft Anbabiwoč Mahbär	Yekdusat Mesaheft Anbabiwoch Mahber
የቅዱስ ዮሐንስ የወጣቶች አንድነት ማኅበር	Yäqeddus Yohannes Yäwaţţatoč Andennät Mahbär	Yekdus Yohannes Yawattatoch Andennet Mahber
የቤተ መጻሕፍት ወመዘክርና የአረኪዎሎጂ ዋና መሥሪያ ቤት	Yäbetä Mäsaheft Wämäzä-kerenna Yarkiwoloji Wanna Mäsriya Bét	Yebete Mesaheft Wemezekere Yarkiwoloji Wanna Meseria Bét
የባሕር ዳር የጥጥ ፋብሪካ አክሲዮን ማሕበር	Yäbaher Dar Yatet Fabrika Aksiyon Mahbär	Yebaher Dar Yetet Fabrika Aksion Mahber
የተምሮ ማስተማር ማኅበር	Yätämero Mastamar Mahber	Yetmero Mastemar Mahber
ታደመ ዘለቀ	Taddämä Zälläqä	Taddeme Zelleke
የኋላ ወርቅ ወልደየስ	Yähwala-Wärq Wäldäyyäs	Yehwala Werke Woldeyes
የኢትዮጵያ አስታሚዎች አክሲዮን ማኅበር	Yäityopya Asattamiwoč Aksiyon Mahbär	Yeityopya Astemamiwoch Aksion Mahbar
የኢትዮጵያ ኮሌጆች ተማሪዎች	Yaityopa Kollijoč Tämäriwoč	Yeityopya Kollejoch Temariwoch
የኢትዮጵያ የትምህርት ቤቶች የስፖርት ማኅበር	Yaityopya Yätemehert Betoč Yäsport Mahbär	Yeityopya Yetemheret Betoch Yesport Mahber
የኢትዮጵያ የንብረት ማልሚያ የአክሲዮን ማኅበር	Yaityopya Yänebrät Malmiya Yaksiyon Mahbär	Yeityopya Yenebret Malmia Yeaksion Mahber
የኢትዮጵያ የፈረስ እሽቅድምድም ማኅበር	Yaityopya Yäfaräs Ešqededem Mahbär	Yeityopya Yeferes Eshkedemdem Mahber
የኢትዮጵያ የፈረንሳይ የምድር ባቡር ኩባንያ	Yaityopya Yäfäränsay Yämder Babur Kubbaneyya	Yeityopya Yeferensay Yemeder Babour Kubania
የኤርትራ ፉትቦል መምሪያ	Yäertra Futbol Mämriya	Yeértra Futbol Memriya
የእስላም መሠረታዊ ትምህርት	Yäeslam Mäsärätawi Temahert	Yeéslalm Meseretawi Temhert
የከሳቴ ብርሃን ማኅበር	Yakäsaté Berhan Mahbär	Yekesaté Berhan Mahber
የወንጌል መልእክተኞችና የእሑድ ት/ቤት ማኅበር	Yäwängel Mälektaňočenna Yaehud Temehert Bét Mahbär	Yewengel Melktenochnna Yehud Temhret Bet Mahber
የወይዘሮ ሙሉነሽ ገብረ መስቀል መታሰቢያ	Yäwäyzäro Mulunäs Gäbrä-Mäsqäl Mättasäbiya	Yewyzero Mulunesh Gabre Meskel Metaseba
የዓለም የሥራ ድርጅት መሥሪያ ቤት	Yaläm Yäsera Derejjet Mäsriyabét	Yealem Yesera Derjet Mesria Bet
የዳግማዊ ምኒልክ መታሰቢያ ድርጅት	Yadagmawi Menilek Mättasäbiya Derejjet	Yedagmawi Menilk Metasebia Derejet
የግሎብ ሥነ ጽሁፍ ድርጅት	Yaglob Sena Sehuf Derejjet	Yeglob Sene Tshuf Derejet
የጦር ካሣ ጉዳይ አስፈጻሚ ጽ/ቤት	Yätorkasa Gudday Ašfässami Sehefät Bét	Yetore Kassa Gudday Asfessami Tsehfet Bet
ያለው መንግሥቱ	Yaläw Mängestu	Yalew Mengistu
ያሬድ /ቅዱስ/	Yaréd	Yaréd
ያሬድ ገብረ ሚካኤል	Yaréd Gäbrä-Mikaél	Yared Gabre Michael
ያዕቆብ ገብረ ኢየሱስ /አባ/	Yaeqob Gäbrä-Iyäsus	Yaekob Gabre Yesus
ያዕቆብ ገብረ እግዚአብሔር	Yaeqob Gäbrä Egziabher	Yaekob Gabre Egziabher
ያይንሸት ሰንደቅ	Yaynešät Sändäq	Yayeneshet Sendek
ይላቅ ኃይለማርያም	Yelaq Haylä Maryam	Yelak Haile Mariam
ይልማ ሀብተየስ	Yelma Habtäyyäs	Yelma Habteyes 
ይልማ ሙላቱ	Yelma Mulatu	Yelma Mulatu
ይልማ ማናዬ	Yelma Mannayyé	Yelma Manaye 
ይልማ ኃይለ ማርያም	Yelma Haylä-Maryam	Yelma Haile Mariam
ይልማ ደሬሳ	Yelma Därésa	Yelma Deressa
ይርዳው ልባርጋቸው	Yerdaw Lebargaččäw	Yerdaw Lebargachew
ይርጋ መንግሥቱ እስጢፋኖስ	Yerga Mängestu Estifanos	Yerga Mengistu Estifanos
ይስሐቅ ተክለ ሃይማኖት	Yeshaq Täklä-Haymanot	Yeseheq Tekle Haimanot
ይስሐቅ አብርሐም	Yeshaq Abrham	Yesehaq Abrham
ይስሐቅ ዮሴፍ	Yeshaq Yoséf	Yesehaq Yoseph
ይትባረክ ወልደ ሚካኤል	Yetbaräk Wäldä-Mikaél	Yitbarek Wolde Michael
ይትባረክ ገብረ ትንሣኤ	Yetbaräk Gäbrä-Tensaé	Yitbarek Gabre Tensae
ይኄይስ ወርቄ	Yeheyyes Wärqé	Yeheyse Werke
ይኩኖ አምላክ ገብረ ሥላሴ	Yekunno-Amlak Gäbrä-Sellasé	Yekuno-Amlak Gabre Selassie
ይድነቃቸው ተሰማ	Yednaqaččaw Täsämma	Yedneqachew Tessema
ይገዙ ብሥራት	Yeggäzu Besrat	Yegezu Bisrat
ዮሐንስ መንክር	Yohannnes Mänker	Yohannes Menker
ዮሐንስ ረምሐ	Yohannes Rämha	Yohannes Remha
ዮሐንስ ረዳ ጻድቅ	Yohannes Rädda-Şadeq	Yohannes Reda Tsadik
ዮሐንስ ሳንድቬድ	Yohannes Sandved	Yohannes Sandved	Non-Ethiopian
ዮሐንስ ብንያም	Yohannes Benyam	Yohannes Benyam
ዮሐንስ ነጋሽ	Yohannes Nägaš	Yohannes Negash
ዮሐንስ አፈወርቅ	Yohannes Afäwärq	Yohannes Afework
ዮሐንስ ወንድማገኝሁ	Yohannes Wändemma-gaňähu	Yohannnes Wondimagegnehu
ዮሐንስ የሻነው	Yohannes Yäšanäw	Yohanis Yeshanwe
ዮሐንስ ገብረ እግዚአብሔር /አባ/	Yohannes Gäbrä Egziabhér	Yohanis Gabre Egziabher
ዮሴፍ ሀብተ ሚካኤል	Yoséf Habtä-Mikaél	Yoseph Habte Michael
ዮና ቦጋለ	Yona Boggalä	Yona Bogale
ዮአኪም ማርያ፣ አባ	Ioachim Maria RP	Yoakim Maryame	Non-Ethiopian
ደማ ዘንግ እግዜር	Dama Zang-Egzér	Dama Zeng Egzer
ደምሴ ማን አህሎት	Dämessé Mannahlot	Demisse Manahlot
ደምሴ ቶላ	Dämessé Tola	Demisse Tola
ደምሴ ወልደ አማኑኤል /ደጃዝማች/	Dämess Wäldä Amanuél (Dägazmač)	Damisse Wolde Amanuel (Dejazmach)
ደምሴ ወርቅ አገኘሁ	Dämessé Wärq-Agäňähu	Demisse Work Agegnehu
ደረጀ ውቤ ዳኜ	Daräjjä Webe Daňé	Derejet Wobe Dagne
ደ/ራራ/ ባዩ	Dä(rara) Bayu	Derar Bayu
ደሳለኝ ሐራ ሚካኤል	Dässaläň Hara-Mikaél	Dessalegn Hara-Michael
ደሳለኝ አብተው	Dässaläň Abtäw	Dessalegn Abtew
ደሳለኝ አጋዤ	Dässaläň Agazé	Dessalegn Agazé
ደሴ ወይዘሮ ስኂን ት/ቤት	Däsé Yäwäyzro Sehin Temehert Bét	Desse Yewossero Sehin Temhert Bet
ደስታ ተክለ ወልድ	Dästa Täklä-Wäld	Desta Tekle-Wold
ደበበ ሰይፉ	Däbbäbä Säyfu	Debebe Seifu
ደበበ አድምቄ	Däbbäbä Admeqé	Debebe Admke
ደጀኔ ተክሌ	Däjäné Täklé	Dejene Tekle
ዱባለ አይተንፍሱ	Dubbalä Aytänfesu	Dubale Aitenfisu
ዲበ ኩሉ ዘውዴ	Dibä-Kulu Zäwdé	Dibe-Kulu Zewde
ዳምጣቸው ወርቁ	Damtaččäw Wärqu	Damtachew Worku
ዳምጤ አሰማኸኝ	Damté Assämmahň	Damte Assemmahegn
ዳንኤል ኤም	Daniel, M	Daniel, M	Non-Ethiopian
ዳንዬል ዳፎ	Daniél Daffo	Daniel Daffo
ዳኘው ወልደ ሥላሴ	Dańäw Wäldä-Sellasé	Dagnew Wolde Sellassie
ዳኛቸው ወርቁ	Daňaččäw Wärqu	Dagnacew Worku
ዳኛቸው ይርጉ	Daňaččäw Yergu	Dagnacew Yirgu
ዳኜ እምቢ አለ	Daňé Embi-Alä	Dagne Embi-Ale
ዳዊት ደገፋ	Dawit Dägäfu	Dawit Degefu
ጃለታ ጃፈሮ	Jäläta Jafäro	Jaleta Jafero
ገላና ቀጄላ	Gäläna Qäjela	Gelana Kejela
ገረመው ወልደ ሰማያት	Gärrämäw Wäldä-Sämayat	Geremew Wolde Semaiat
ገሪማ ታፈረ	Gärima Täffärä	Gerima Tafere
ገብረ ሕይወት ባይከዳኝ /ነጋድራስ/	Gabrä-Haywat Baykädaň	Gebre Hiwot Bikedagn
ገብረ ሚካኤል ልሳነ ወርቅ /አባ/	Gäbrä-Mikaél Lessanä-Wärq	Gebre Michael Lisane Work
ገብረ ሚካኤል መኰንን	Gäbrä-Mikaél Mäkwännen	Gebre Michael Mekonnen
ገብረ አብ መንግሥቱ	Gäbrä-Ab Mängestu	Gebre Ab Mengistu
ገብረ አብ ተገኝ	Gäbrä-Ab Tägäň	Gebreab Tegegn
ገብረ ኢየሱስ ኃይለ ማርያም	Gäbrä-Iyäsus Haylä-Maryam	Gebre Eyesus Haile Mariam
ገብረ ኢየሱስ ኃይሉ /አባ/	Gäbrä Iyäsusu Haylu	Gebre Eyesus Hailu
ገብረ ኢየሱስ /አባ/	Gäbrä-Iyäsus	Gebre Eyesus
ገብረ ኢየሱስ ክፍሌ	Gäbrä Iyäsus Keflé	Gebre Eyesus Kifle
ገብረ እግዚአብሔር /አባ/	Gäbrä-Egziabhér	Gebre Egziabher
ገብረ እግዚእ ሰሎሞን	Gäbrä-Egzi Sälomon	Gebre Egzi Solomon
ገብረ ኪዳን በዛብህ /አባ/	Gäbrä-Kidan Bäzzabbeh	Gebre Kidan Bezabih
ገብረ ኪዳን ወልደ መድኅን	Gäbrä-Kidan Wäldä Mädhen	Gebre Kidan Wolde Medhin
ገብረ ወልድ እንግዳ ወርቅ	Gäbrä-Wäld Engeda-Wärq	Gebrewold Ingidawork
ገብረ ጊዮርጊስ ትርፌ	Gabär-Giyorgis Terfé	Gebre Giorgis Tirfe
ገብረ ጻድቅ መንግሥቱ	Gäbrä-Şadeq Mangestu	Gebre Tsadik Mengistu
ገብሬ ወዳጆ	Gäbré Wadajo	Gebre Wodajo
ገነት አጥናፌ	Gännät Atnafé	Genet Atnafe
ገነት ዘሪሁይን	Gännät Zäryhun	Genet Zerihun
ገዳሙ ገዛኸኝ	Gädamu Gäzzahäň	Gedamu Gezahegn
ጉግሣ ግደይ /አባ/	Gugsa Gedäy	Gugsa Gidey
ጊዮርጊስ /አባ/	Giyorgis	Giorgis
ጋስፖሪኒ ገማ /አባ/	Gasparini G M	Gesparini GM	Non-Ethiopian
ጋሻው ማፈኛ	Gaššaw Mafäňa	Gashaw Mafegna
ጋሻው ይመር	Gaššaw Yemär	Gashaw Yimer
ጌራወርቅ አጐናፍር	Gerwärq Agwänafer	Gerawork Agonafir
ጌታሁን ሌንጮ	Getahun Lenčo	Getahun Lencho
ጌታሁን በላይነህ	Getahun Bälaynäh	Getahun Belaineh
ጌታቸው መንግሥቱ	Getaččäw Mengestu	Getachew Mengistu
ጌታቸው ማሞ	Getaččäw Mammo	Getachew Mamoé
ጌታቸው ምንልክ አለሙ	Getaččäw Ménlik Alläw	Getachew Menlik Allew
ጌታቸው በቀለ	Getaččäw Bäqqälä	Getachew Bekele
ጌታቸው ኃይሌ	Getaččäw Hayle	Getachew Haile
ጌታቸው አስፋው	Getaččäw Asfaw	Getachew Asfaw
ጌታቸው አወቀ	Getaččäw Awwäqä	Getachew Awoke
ጌታቸው ደባልቄ	Getaččäw Däbalqé	Getachew Debalqe
ጌታቸው ዳዊት	Getaččäw Dawit	Getachew Dawit 
ጌታቸው ገብረ መድህን	Getaččäw Gäbrä-Mädhen	Getachew Gabre Medhin
ግሎ ጀምስ፣ ኤ	Gloe, James A	Gloe, James A	Non-Ethiopian
ግርማ ተክለ ኢየሱስ	Germa Täklä Iyäsus	Girma Tekle Yesus
ግርማ ቸሩ	Germa Čäru	Girma Cheru
ግርማቸው ተክለ ሐዋርያት	Germaččäw Täklä-Hawaryat	Girmachew Tekle Hawariat
ግርማ ወልደ ትንሣኤ	Germa Wäldä-Tensaé	Girma Wolde Tensaie
ግርማ ወልደ አረጋይ	Germa-Wäldä-Arägay	Girma Wolde Aregay
ግርማ ወልደ ጊዮርጊስ	Germa Wäldä-Giyorgis	Girma Wolde Giorgis
ግርማ ዘውዴ	Germa Zäwdé	Girma Zewde
ግርማይ ተሰማ	Germay Täsämma	Girmaye Tessema
ግርማ ደመኑ	Germa Dämmänu	Girma Damenu
ግርማ ገብረ ኪዳን	Germa Gäbrä-Kidan	Girma Gabre Kidan
ግርማ ጽዮን መብራህቱ	Germa Seyon Mäbrahitu	Girma Tsion Mebrahtu
ግርማ ፀሐይ	Germa Sähay	Girma Tsehaye
ግብረ አብ ተፈሪ	Gebrä-Ab Täfäri	Gebre Ab Tefferi
ግዛው ኃይለ ማርያም	Gazaw Hayla-Maryam	Gizaw Haile Mariam
ጐርፉ ገብረ መድህን	Gwärfu Gäbrä-Mädhen	Gorfu Gabre Medhin
ጐሽሜ ረታ	Gwäšemé Rätta	Goshimé Retta
ጐበዜ ጣፈጠ	Gwäbäzé Täffäta	Gobezie Taffete
ጥላሁን ሀብተ ገብርኤል	Telahun Habtä-Gäbrél	Tilahun Habte Gabriel
ጥሩነሽ ይመር	Terunäš Yemär	Tirunesh Yemer
ጥበቡ ታየ	Tebäbu Tayyé	Tibebu Taye
ጥበቡ ወርቅ አገኘሁ	Tebäbu Wärqagäňähu	Tibebu Worke Agnehu
ጥዑመ ልሳን /ነጋድራስ/	Teumä-Lessan Nägadras	Tehume Lessan Negadras
ጥዑመ ልሳን ያሬድ	Teumä-Lessan Yaréd	Tehume Lessan Yared
ጳውሎስ ኞኞ	Pawlos Ňňoňňo	Paulos Gnogno
ጳውሎስ መንአመኖ	Pawlos Man Amänp	Pawlos Man Amno
ጳውሎስ ዑቅበአብ	Pawlos Uqebab	Pawlos Ukubab
ጳውሎስ ዘፈሩ	Pawlos Zäfäru	Paulos Zeferu
ጳውሎስ ገብረ ሚካኤል	Pawlos Gäbrä-Mikaél	Paulos Gabre-Michael
ጸጋ ዘአብ ዘረ እግዚእ	Şägga Zäab Zära-Egzi	Tsega Zeab Zera Egzi
ጽጌ መንገሻ	Şeggé Mängäša	Tsige Mengesha
ጽጌ ማርያም አንዳርጌ /አባ/	Şeggé Maryam Andargé	Tsige Mariam Andarge
ጽጌ አዳፍሬ	Şeggé Addafré	Tsige Adafre
ጽጌ ገብረ ኪዳን	Şeggé Gäbrä-Kidan	Tsige Gebre Kidan
ፀጋዬ ገብረ መድኅን	Şagäyé Gäbrä-Mädhen	Tsegaye Gabre-Medhin
ፀሐይ ኃይለ ሥላሴ	Şahay Haile Sellassie	Tsehai Haile Selassie
ፀጋ ተወልደ ብርሃን	Şägga Täwaldä Berhan	Tsega Tewolde Birhan
ፀጋ ታፈሰ	Şägga Taffäsä	Tsega Tafese
ፀጋዬ ተስፋ እግዚእ	Şäggyé Täsfa-Egzi	Tsegaye Tesfaegzi
ፈለቀ ዳኜ	Fälläqä Danňé	Feleke Dagne
ፊሊጶስ /አባ/	Philpos	Filipos	Non-Ethiopian
ፋሲል ማህተመ ወርቅ	Fasil Mahtämä-Wärq	Fasil Mahteme Worke
ፍላድ ማርቲን /መምህር/	Flad, Martin, Rev	Flad, Martin, Rev	Non-Ethiopian
ፍሎራን ፍሬር	Florent, Frére	Florent, Frére
ፍስሐ ኃይለ መስቀል	Fesseha Haylä-Mäsqäl	Fesseha Haile Meskel
ፍስሐ ወልደ ጻድቅ	Fesseha Wäldä-Sadeq	Fisseha Wolde Tsadik
ፍስሐዬ ሐጐስ	Fessehayé Hagos	Fesseha Hagos
ፍስሐ ጽዮን ካሣዬ	Fesseha-Şeyon Kasayé	Fisseha Tsion Kasaye
ፍሬው አዳሙ	Feréw Addamu	Ferew Adamu
ፍቃዱ ዓለሙ	Feqadu Alämu	Fekadu Alemu
ፍቃዱ ገብረ ሥላሴ	Feqadu Gabrä-Sellasé	Fekadu Gabre Seleassie
ፍቅረ ሥላሴ ወልደ ሃና	Feqrä-Sellasé Wäldä-Hanna	Fekre Selassie Wolde Hanna
ፍቅረ ድንግል በዬነ	Feqrä-Dengel Bäyyänä	Fekre Dingle Beyene
ፍቅሩ ኪዳኔ	Feqru Kedané	Fekru Kidane
ፍጡር አብርሃም	Fitur Abrham	Fetur Abrham
