ሀብተ	Habtä	Habte
ሀብተ ሚካኤል	Habtä-Mikaél	Habtemichael
ሀብተማርያም	Habtämaryam	Habtemariam
ሀብተየስ	Habtäyyäs	Habteyes
ሀብቴ	Habté	Habte
ሃና	Hanna	Hanna
ሃይማኖት	Haymanot	Haimanot
ህላዌ	Hellawé	Hellawe
ለማ	Lämma	Lemma
ለአብ	Läab	Leab
ለውጤ	Läweté	Leweté
ለገሠ	Läggäsä	Leggese
ለገሰ	Läggäsä	Legesse
ሉሌ	Lulé	Lule
ሉልሰገድ	Lulsäggäd	Luelseged
ሉቃስ	Luqas	Lukas
ሊበን	Libän	Liben
ላቀው	Laqäw	Lakew
ሌንጮ	Lenčo	Lencho
ልመንህ	Lemäneh	Lemeneh
ልማት	Lemat	Lemat
ልሳነ	Lessanä	Lissane
ልሳኑ	Lessanu	Lissanu
ልሳን	Lessan	Lessan
ልሻን	Leŝan	Lishan
ልባርጋቸው	Lebargaččäw	Lebargachew
ልኮንክ	Lekonk	Likonk
ልዑል	Leul	Leul
ልዕልት	Leelt	Leelt
ልጃም	Lejam	Lijam
ሐማሴን	Hamasén	Hamasen
ሐረገ	Harägä	Harege
ሐራ	Hara	Hara
ሐቢብ	Habib	Habib
ሐብለ	Hablä	Hable
ሐና	Hanna	Hanna
ሐኪም	Hakim	Hakim
ሐዋርያት	Hawaryat	Hawariat
ሐዋዝ	Hawaz	Hawaz
ሐይሎም	Haylom	Hailom
ሐዲስ	Haddis	Haddis
ሐጂ	Haĝi	Haji
ሐጐስ	Hagos	Hagos
ሕዝባዊ	Hezbawi	Hezibawi
ሕይወት	Heywät	Gebrehewot
ሕግ	Heg	Hege	
መለሰ	Mälläsä	Melless
መለሰልኝ	Mälläsäleň	Meleselign
መለኮት	Mäläkot	Melekot
መላኩ	Mälaku	Melaku
መልአከ	Mälakä	Melake
መልአኩ	Mälaku	Melaku
መልእክተኞችና	Mälektaňočenna	Melktenochnna
መልከ	Mälkä	Melke
መልኬ	Mälké	Melke
መሐመድ	Mähammäd	Mohammed
መሐሪ	Mähari	Mehari
መሕዲ	Mähdi	Mehidi
መምሪያ	Mämriya	Memriya
መሠረታዊ	Mäsärätawi	Meseretawi
መሠረት	Mäsärat	Meseret
መሥሪያ	Mäsriya	Meseria
መሥሪያ ቤት	Mäsriyabét	Mesria Bet
መሥቀል	Mäsqäl	Meskel
መሪዎች	Mariwoč	Gubae
መርሐ	Märha	Merha
መርስዔ	Marsé	Merse
መርሻ	Maršša	Mersha
መሰለ	Mässälä	Mesele
መስቀሉ	Mäsqälu	Meskelu
መስቀል	Mäsqäl	Meskel
መስፍን	Mäsfen	Mesfin
መሸሻ	Mäšäša	Meshesha
መቅደስ	Mäqdäsä	Mekdes
መብራህቱ	Mäbrahitu	Mebrahtu
መብራቱ	Mäbratu	Mebratu
መታሰቢያ	Mättasäbiya	Metaseba
መንበረ	Mänbärä	Menbere
መንአመኖ	Man	Man
መንክር	Mänker	Menker
መንገሻ	Mängäša	Mengesha
መንግሥተ	Mängestä	Mengeste
መንግሥተአብ	Mängestab	Mengesteab
መንግሥቱ	Mängestu	Mengistu
መንግሥት	Mängest	Mengist
መከላከያ	Mäkkälakäya	Makelakeya
መኩሪያ	Mäkuriya	Mekuria
መካሻ	Makaŝa	Mekasha
መክብብ	Mäkbeb	Mekbib
መኮንን	Mäkwännen	Mekonen
መኰንን	Mäkwannen	Mekonen
መዋዕል	Mäwael	Mewael
መዓዛ	Mäaza	Meaza
መዘምር	Mäzämer	Mezemur
መዝገቡ	Mäzgäbu	Mezegebu
መድህን	Mädhen	Medhin
መድኃኒዓለም	Madhanéalem	Medhanealem
መድኅን	Mädhen	Medhin
መጻሕፍት	Mäsaheft	Mesaheft
መጽሐፍ	Mäshaf	Metsehaf
መጽሕፍት	Mäsaheft	Mesaheft
ሙሉ	Mulu	Mulu
ሙሉ ሰው	Mulu-Säw	Mulusew
ሙሉነሽ	Mulunäs	Mulunesh
ሙሉጌታ	Mulugéta	Mulugeta
ሙላቱ	Mulatu	Mulatu
ሙላት	Mulat	Mulat
ሙሐመድ	Muhammäd	Mohammed
ሙሐሙድ	Muhammäd	Mohammed
ሙሳ	Musa	Musa
ሚሊዮን	Miliyon	Milion
ሚኒስቴር	Ministér	Minister
ሚካኤል	Mikaél	Michael
ማህሌት	Mahlét	Mahlet
ማህበር	Mahbär	Mahber
ማህተመ	Mahtämä	Mahteme
ማልሚያ	Malmiya	Malmia
ማሎ	Malo	Malo
ማሕበር	Mahbär	Mahber
ማሞ	Mammo	Mammo
ማርቆስ	Marqos	Markos
ማርቲን	Martin,	Martin,
ማርታ	Marta	Marta
ማርያም	Maaryam	Mariamm
ማስተማር	Mastamar	Mastemar
ማስታወቂያ	Mastawaqiya	Mastawekia
ማብራት	Mebrat	Mebrat
ማተሚያ	Mattämiya	Matemiya
ማቴዎስ	Matéwos	Matewos
ማኅበር	Mahbär	Mahber
ማኅተመ	Mahtama	Mahteme
ማኅተመ ሥላሴ	Mahtama-Sellasé	Mahteme-Sellassie
ማናዬ	Mannayyé	Manaye
ማን	Man	Man
ማን አህሎት	Mannahlot	Manahlot
ማን እኩልህ	Manekuleh	Manikuleh
ማንያህልሃል	Manyahlehal	Manyahlihal
ማእሙን	Maemun	Maamun
ማዕረጉ	Maérägu	Maeregu
ማዘጋጃ	Mazzägaja	Mazegaga
ማይክል	Maykel	Maykel
ማይጨው	Mayčäw	Maichew
ማፈኛ	Mafäňa	Mafegna
ሜሪ	Méry	Merry
ሜጫ	Méčča	Mecha
ምሕረተ	Mehrät	Mehret
ምሕረተ አብ	Mehrätab	Mehretab
ምሕረቱ	Mehrätu	Mehiretu
ምሕረቴ	Mehräté	Mehrete
ምሕረት	Mehrät	Mehret
ምስካየ	Meskayä	Meskaye
ምስግና	Mesgenna	Misgina
ምትኩ	Meteku	Mitiku
ምኒልክ	Menilek	Menilk
ምናሴ	Menasé	Minasse
ምንልክ	Ménlik	Menlik
ምግብ	Megeb	Megeb
ሞልቶት	Moltot	Moltot
ሞረሽ	Morräš	Moresh		
ሞገስ	Mogäs	Moges
ሠምሩ	Sämru	Semru
ሠረቀ	Säräqä	Sereke
ሠራዊት	Sarawit	Serawit
ሠርፀ	Särsä	Tserse
ሠይፉ	Säyfu	Seifu
ሣህለ	Sahlä	Sahle
ሣህሉ	Sahelu	Sahlu
ሣኒ	Sani	Sani
ሥላሴ	sellassé	Sellassie
ሥርአት	Serat	Serate
ሥርግው	Sergew	Sirgew
ሥነ	Senä	Sene
ሥነ ጽሑፍ	Senä Sehuf	Senessehuf
ሥእሎ	Séllo	Sélo
ሥዩም	Seyyum	Seyoum
ረምሐ	Rämha	Remha
ረታ	Rätta	Reta
ረዳ	Rädda	Redda
ሩጋ	Ruga	Ruga
ሩፋኤል	Rufaél	Rufael
ሪፖርት	Riport	Riport
ሮማነ	Romanä	Romane
ሰላም	Sälam	Selam
ሰሎሞን	Sälomon	Solomon
ሰማያት	Sämayat	Semaiat
ሰብስቤ	Säbsebé	Sebsibe
ሰንበት	Sänbät	Senbet
ሰንደቅ	Sändäq	Sendek
ሰው	Säw	Sew
ሰይድ	Säyd	Seid
ሰይፈ	Säyfä	Seife
ሰይፉ	Säyfu	Seifu
ሲራክ	Sirak	Sirak
ሲሳይ	Sisay	Sisay
ሳሙኤል	Samuél	Samuel
ሳብሬ	Saburé	Sabure
ስመኝ	Semmäň	Semegn
ስቋር	Seqwar	Sekwar
ስብሐት	Sebhat	Sebahat
ስኂን	Sehin	Sehin
ስንዱ	Sendu	Senedu
ስኳር	Sekwar	Sekewar
ስዋሰው	Säwasewä	Sewasew
ስፖርት	Sport	Sport
ሸዋንግዛው	Šäwangezaw	Shewangezaw
ሺመልስ	Šimälles	Shimelles
ሺበሺ	Šibäsi	Shibeshi
ሺፈራው	Šifärraw	Shiferaw
ሻውል	Šawl	Shawel
ሽልማት	SŠellemat	Shilimat
ሽመልስ	Šimälles	Shimelis
ሽብሩ	Šiberu	Shiberu
ሽቶ	Šetto	Shitto
ሽፈራው	Šefärraw	Shiferaw
ቀለመ	Qälämä	Keleme
ቀለመወርቅ	Qälämä-Wärq	Keleme Werke
ቀለታ	Qäläta	Keletta
ቀና	Qänna	Kenna
ቀዳማዊ	Qädamawy	Kedamawe
ቀጂላ	Qäjéla	Kejela
ቀጄላ	Qäjela	Kejela
ቀጸላ	Qäsäla	Kessela
ቂርቆስ	Qirqos	Kirkos
ቅዱስ	Qeddus	Kidus
ቅጣው	Qetaw	Kitaw
ቆስጠንጢኖስ	Qostäntinos	Kostentinos
ቆጠራ	Qotära	Kotera
በለው	Bäläw	Belew
በለጠ	Bällatä	Belete
በላይ	Bälay	Belay
በላይነህ	Bälaynäh	Belaineh
በረከተአብ	Bäräkätab	Bereketeab
በርሄ	Bärhé	Berhe
በሻህ	Bäŝah	Beshahe
በቀለ	Bäqqälä	Bekele
በትእዛዙ	Bätezazu	Betezazu
በአሉ	Bäalu	Bealu
በእምነት	Bäemnät	Beimnet
በኩረ	Bäkurä	Bekure
በዛብህ	Bäzzabbeh	Bezabih
በየነ	Bäyyänä	Beyene
በዬነ	Bäyyänä	Beyene
በጎ	Bägo	Bego
በፈቃደ	Bäfäqadä	Befekade
በፈቃዱ	Bäfäqadu	Befekdu
ቢሰውር	Bisäwwer	Bisewere
ቢያዝን	Biyazen	Biazin
ቢያድጉ	Biyadgu	Biadgu
ባለስልጣን	Balä-Seltan	Bale Seltan
ባልቻ	Balča	Balcha
ባምነው	Bamnäw	Bamnew
ባሪእ	Bari	Bari
ባስልዮስ	Baslyos	Baslios
ባቡር	Babur	Babour
ባንክ	Bank	Bank
ባዕላይ	Baelay	Baelay
ባዩ	Bayyu	Bayu
ባይሳ	Baysa	Baisa
ባይከዳኝ	Baykädaň	Bikedagn
ቤተ	Bétä	Bete
ቤተማርያም	Bétämaryam	Betemariam
ቤት	Bét	Bet
ቤቶች	Betoč	Betoch
ቤካ	Béka	Beka
ብሔራዊ	Behérawi	Beheraw
ብሔር	Behér	Biher
ብሥራት	Besrat	Bisrat
ብሩ	Beru	Biru
ብሬ	Berré	Bire
ብርሀነ	Berhanä	Berhanć
ብርሀኑ	Berhanu	Birhanu
ብርሃነ	Berhanä	Berhane
ብርሃኑ	Berhanu	Berhanu
ብርሃኔ	Berhané	Berhane
ብርሃን	Berhan	Birhan
ብርሃንና	Berhanénna	Berhanena
ብንያም	Benyam	Benyam
ብዙ	Bezu	Bezu
ብዙነህ	Bezunäh	Bezuneh
ቦጋለ	Boggalä	Bogale
ተማሪዎች	Tämäriwoč	Temariwoch
ተረፈ	Tärräfä	Terefe
ተሰማ	Täsämma	Tesema
ተስፋ	Täsfa	Tesfa
ተስፋ እግዚእ	Täsfa-Egzi	Tesfaegzi
ተስፋዬ	Täsfayé	Tesfaye
ተስፍዬ	Täsfayé	Tesfaye
ተሻገር	Täšagär	Teshager
ተሾመ	Täšomä	Teshome
ተቋመ	Taqwamä	Tekome
ተአምሩ	Tameru	Teamru
ተአምራት	Tammerat	Tamerat
ተከስተ	Täkästä	Tekeste
ተካ	Täkka	Teka
ተክለ	Täklä	Tekle
ተክለ ማርያም	Täklämaryam	Tekelemariamm
ተክለሐ	Täklä	Tekle
ተክለሐዋርያት	Täklä-Hawaryat	Tekle Hawariat
ተክለማርያም	Täklämaryam	Teklemariam
ተክለብርሃን	Täklä-Berhan	Tekleberhan
ተክለኃይማኖት	Täklä Haimanot	Tekle Haymanot
ተክለአረጋዊ	Täklärägawi	Teklearegawi
ተክሌ	Täklé	Tekle
ተኽላይ	Tählay	Teklaye
ተወልደ	Täwäldä	Tewolde
ተወልደ ብርሃን	Täwäldä-Berhan	Tewoldeberhan
ተውህቦ	Täwhebo	Tewhbo
ተድላ	Tädla	Tedla
ተገኘ	Tägäňä	Tegegne
ተገኘ ወርቅ	Tägäňä Wärq	Tegegnework
ተገኝ	Tägäň	Tegegn
ተጫነ	Täčanä	Techane
ተፈሪ	Täfäri	Teferi
ተፈራ	Täfärra	Teferra
ቲያትር	Tiyatér	Tiater
ታምሩ	Tameru	Tameru
ታምራት	Tamrat	Tamerat
ታረቀ	Tärräqä	Tareke
ታረቀኝ	Tarräqäń	Tarekgne
ታሲሳ	Tasisa	Tasissa
ታየ	Tayyé	Taye
ታዬ	Tayé	Taye
ታደለ	Taddälä	Taddele
ታደመ	Taddämä	Taddeme
ታደሰ	Taddäsä	Taddese
ታጀበ	Tajjäbä	Tajebe
ታፈረ	Täffärä	Tafere
ታፈሰ	Tafässä	Tafesse
ቴዎድሮስ	Tewodros	Tewodros
ት/ቤት	Temehert Bét	Temhert Bet
ትምህርት	Temehert	Temhret
ትርፌ	Terfé	Tirfe
ትንሣኤ	Tensaé	Tensaye
ትእዛዙ	Tezazu	Tiezazu
ትዛዙ	Tezazu	Tezazu
ቶላ	Tola	Tola
ቸሩ	Čäru	Cheru
ቸርነት	Čärnnät	Cherinet
ኃብተ	Habtä	Habte
ኃዘን	Hazän	Hazen
ኃይለ	Haile	Haile
ኃይለማርያም	Haylä Maryam	Hailemariam
ኃይለማርያም	Haylä Maryam	Haile Mariam
ኃይሉ	Haylu	Hailu
ኃይሌ	Haylé	Haile
ኃይል	Hayl	Hail
ኃይማኖት	Haymanot	Haimanot
ኅሩይ	Heruy	Hiruy
ኅዙናን	Hezunan	Hezunane
ነመራ	Nämära	Nemera
ነቅንቅ	Naqneq	Neknk
ነብየ	Näbeyya	Nebeye
ነብያት	Näbyat	Nebeyate
ነገሥት	Nägäst	Negeste
ነገሮ	Nägäro	Negero
ነገደ	Nágädä	Negede
ነጋሽ	Nägaš	Negash
ኑሮ	Nuro	Nuro
ኔሞ	Némo	Nemmo
ንዋይ	Neway	Niway
ንጉሤ	Negusé	Negussie
ንጉሴ	Negusé	Negussie
ንግድ	Negd	Negid
ኞኞ	Ňňoňňo	Gnogno
አ.አ.	Addis Ababa	Addis Ababa
አህሎት	Ahlot	Ahlot
አለ	Alä	Ale
አለሙ	Alämu	Alemu
አለማየሁ	Alämayyähu	Alemayehu
አለባቸው	Alläbbačäw	Alebachew
አለነ	Allänä	Alene
አሉላ	Alula	Alula
አላዮ	Alayyu	Alayu
አልማዝ	Almaz	Almaz
አልጋነሽ	Alganäš	Algganesh
አሐዱ	Ahadu	Ahadu
አመት	Amät	Amet
አማረ	Amarä	Amare
አማኑኤል	Amanuél	Amanuel
አምላክ	Amlak	Amlak
አምሳለ	Amsalé	Amsale
አምባዬ	Ambayé	Ambaye
አምደሚካኤል	Amdämikael	Amdemichael
አሠጌ	Assäggé	Assagge
አሥረስ	Asräs	Asres
አሥራተ	Asratä	Asrate
አሥራት	Asrat	Asrat
አረጋሽ	Arägaš	Aregash
አረጋኸኝ	Aräggahäň	Aregahegn
አረጋዊ	Arägawi	Aregawi
አረጋይ	Arägay	Aregay
አርአያ	Araya	Araya
አርጋው	Argaw	Argaw
አሮን	Aron	Aron
አሰማኸኝ	Assämmahň	Assemmahegn
አሰፋ	Asäffa	Asefa
አሳዝነው	Asazzänäw	Asazinew
አስረስ	Asräs	Asres
አስታሚዎች	Asattamiwoč	Astemamiwoch
አስናቀ	Asnaqä	Asnake
አስገዶም	Asgädom	Asgedom
አስፈጻሚ	Ašfässami	Asfessami
አስፋወሰን	Asfawasän	Asfawosen
አስፋው	Asfaw	Asfaw
አስፍሐ	Asfeha	Asfeha
አሸብር	Aśšäbber	Ashebir
አሸናፊ	Ašännafi	Ashenafi
አሸኔ	Aššené	Ashine
አሻግሬ	Aŝŝagre	Ashagre
አበራ	Abärra	Abera
አበበ	Abbäbä	Abebe
አበባ	Abbäbä	Abeba
አበባው	Abäbaw	Abebaw
አበጋዝ	Abägaz	Abgaz
አቡነ	Abunä	Abune
አቢይ	Abiy	Abiy
አባቡ	Abbabbu	Ababu
አባተ	Abatä	Abate
አባይ	Abbay	Abay		
አቤ	Abbé	Abbe
አብ	Ab	Ab
አብረሃ	Abrha	Abraha
አብርሃ	Abrha	Abrha
አብርሃም	Abrham	Abrham
አብርሐም	Abrham	Abrham
አብተው	Abtäw	Abtew
አብያተ	Abyatä	Abiate
አብዱል	Abdul	Abdul
አብዲ	Abdi	Abdi
አብዲሳ	Abdissa	Abdissa
አብድረህማን	Abderahman	Abdurahman
አንለይ	Annelläy	Aniley
አንባቢዎች	Anbabiwoč	Anbabiwoch
አንተነህ	Antänäh	Anteneh
አንዳርጌ	Andargé	Andarge
አንድነት	Andennät	Andennet
አእምሮ	Aemero	Aymro
አካዳሚ	Akadami	Akadami
አክሊለ	Aklilä	Aklila
አክሲዮን	Aksiyon	Aksion
አክበር	Akbbär	Akber
አወቀ	Awwäqä	Awoke
አዛናው	Aznaw	Azanaw
አዛዥ	Azzaz	Azzaz
አየለ	Ayyälä	Ayele
አያሌው	Ayyaléw	Ayalew
አይተንፍሱ	Aytänfesu	Aitenfisu
አይቸህ	Ayččäh	Aycheh
አደጉ	Addägu	Adegu
አዲስ	Addis	Addis
አዳሙ	Addamu	Adamu
አዳነ	Adanä	Adane
አዳፍሬ	Addafré	Adafre
አድሐነ	Adhanä	Adhane
አድሚኒስትሬሽን	Administration	Adminstration
አድማሱ	Admasu	Admassu
አድምቄ	Admeqé	Admke
አድራጐት	Adragot	Adragot
አድኃኖም	Adhannom	Adhanom
አድነው	Adenäw	Adenew
አገኘሁ	Agäňähu	Agegnehu
አጉስጢኖስ	Agustinos	Agustinos
አጋ	Aga	Aga
አጋዤ	Agazé	Agazé
አጐናፍር	Agwänafer	Agonafer
አጥናፌ	Atnafé	Atnafe
አፈወርቅ	Afäwärq	Afework
ኢላላ	Ilala	Ilala
ኢሳይያስ	Isayyas	Isayeyas
ኢብራሂም	Ibrahim	Ibrahim
ኢብሳ	Ibsa	Ebsa
ኢትዮጵያ	Ethiopia,	Ethiopia
ኢትዮጵያዊ	Ityopyawi	Ethiopiawi
ኢትዮጵያ፣	Ethiopia,	Ethiopia
ኢንስቲትዪት	Institute	Institute
ኢየሱስ	Iyäsus	Eyesus
ኢያሱ	Eyyasu	Eyasu
ኢደኤ	Eddaé	Edaé
ኤሌክትሪክ	Electrik	Electric
ኤልያስ	Elyas	Elias
ኤርትራ	Eretra	Eritria
ኤባ	Eba	Ebba
ኤፍሬም	Efrém	Efrem
እመቤት	Emmäbet	Emebet
እማኙ	Emmaňu	Emagnu
እምሩ	Emmeru	Emeru
እምቢ	Embi	Embi
እርሻ	Erša	Ersha
እስጢፋኖስ	Estifanos	Estiphanos
እሸቴ	Ešäté	Eshete
እሽቅድምድም	Ešqededem	Eshkedemdem
እናኑ	Ennannu	Enanu
እንደራሴ	Endärasé	Enderassie
እንደሻው	Endaššaw	Endeshaw
እንዳለው	Endaläw	Endalew
እንዳልካቸው	Endalkaččäw	Endalkachew
እንድርያስ	Endreyas	Endrias
እንግዳ	Engeda	Engeda
እንግዳ ወርቅ	Engeda-Wärq	Ingidawork
እንግዳሰው	Engedasäw	Engedasew
እኩልህ	Ekuleh	Ikuleh
እውነቱ	Ewnätu	Ewnetu
እድሪስ	Edris	Edris
እድገት	Edgät	Idigate
እጅጉ	Ejjegu	Ejigu
እግዚህ	Igzi	Egzi
እግዚአብሔር	Egziabhér	Egziabher
እግዚእ	Egzi	Egzi
እግዜር	Egzér	Egzer
እጓለ	Egwalä	Eguale
ኦርቶዶክስ	Ortodox	Ortodox
ከማል	Kämal	Kemal
ከበደ	Käbbädä	Kebede
ከተማ	Kätäm	Ketema
ኩሉ	Kulu	Kulu
ኩማ	Kumma	Kumma
ኩባንያ	Kubbaneyya	Kubania
ኪዳነ	Kidanä	Kidan
ኪዳኔ	Kidané	Kidane
ኪዳን	Kidan	Kidan
ካሕሣይ	Kahsay	Kahsay
ካሠኝ	Kasäň	kasegn
ካሣ	Kasa	Kasa
ካሣዬ	Kasayé	Kasaye
ካሳ	Kasa	Kassa
ካሳሁን	Kasahun	Kasahun
ካሳው	Kasaw	Kassaw
ካሳዬ	Kasayé	Kassaye
ካቢኔ	Kabiné	Kabine
ካቴድራል	Katédral	Cathedral
ክርስቲያናት	Kerstiyanat	Kerestianat
ክርስቲያን	Krestiyan	Krestiyan
ክርስቶስ	Kerestos	Kirstos
ክበበው	Kebäbäw	Kibebew
ክንፈ	Kenfä	Kinfe
ክንፉ	Kenfu	Kinfe
ክፍለ	Kifla	Kifle
ክፍሌ	Keflé	Kifle
ክፍል	Kefl	Kefel
ኮሌጆች	Kollijoč	Kollejoch
ኮከብ	Kokäb	Kokeb
ወልደ	Wäldä	Wolde
ወልደ መስቀል	Woldä-Mäsqäl	Wolde-Meskel
ወልደሚካኤል	Wäldä-Mikaél	Wolde Michael
ወልደማርያም	Wäldämaryam	Woldemariam
ወልደየስ	Wäldäyyäs	Woldeyes
ወልዴ	Wäldé	Wolde
ወልድ	Wäld	Wold
ወሎ	Wällo	Wollo
ወመዘክርና	Wämäzä Kerenna	Wemezekere
ወርቁ	Wärqu	Worku
ወርቄ	Wärqé	Worke
ወርቅ	Wärq	Work
ወርቅነህ	Wärqenäh	Workineh
ወርካዬ	Wärkayé	Workaye
ወሰኔ	Wäsäné	Wessene
ወሰን	Wäsän	Wossen
ወንድ	Wand	Wond
ወንድ ይራድ	Wändyerad	Wondyerad
ወንድሙ	Wändemmu	Wondimu
ወንድማገኝ	Wändemmagäň	Wondemagn
ወንድማገኝሁ	Wändemma-gaňähu	Wondimagegnehu
ወንድሜነህ	Wändemmenäh	Wondmeneh
ወንድምአገኘሁ	Wändmmagäňähu	Wendemeagnehu
ወንድአየሁ	Wandayyähu	Wondayehu
ወንድይራድ	Wand-Yerad	Wendyerad
ወንጂ	Wonji	Wonji
ወንጌላዊት	Wangelawit	Wengelawit
ወይን	Wäyn	Weyn
ወይዘሮ	Yäwäyzro	Yewossero
ወደር	Wädär	Weder
ወደር የለሽ	Wädär Yälläš	Wederyellesh
ወዳጄነህ	Wädajenäh	Wedajeneh
ወዳጅ	Wädaj	Wedage
ወዳጆ	Wodağğo	Wodajo
ዋለሉ	Walälu	Walelu
ዋሴ	Wasé	Wassie
ዋና	Wanna	Wanna
ዋጮ	Wačo	Wako
ውበቴ	Webäté	Webete
ውበት	Webät	Webet
ውቤ	Webé	Wube
ውድነህ	Weddenäh	Wudineh
ዐምደ	Amdä	Amde
ዐምደ ሚካኤል	Amdä-Mikaél	Amdemichael
ዐሥራተ	Asratä	Asrat
ዐይነ	Aynä	Ayne
ዐይነ ዓለም	Aynä-Aläm	Aynalem
ዑስማን	Usman	Usman
ዑቅበአብ	Uqebab	Ukubab
ዑቅባይ	Uqbay	Ekubay
ዓለመወርቅ	Alämä-Wärq	Alemework
ዓለሙ	Alämu	Alemu
ዓለሚ	Alämé	Alemé
ዓለማየሁ	Alämayyähu	Alemayehu
ዓለሜ	Alämé	Aleme
ዓለም	Aläm	Alem
ዓሊ	Ali	Ali
ዓምደ	Amdä	Amde
ዓምደ ሚካኤል	Amdä-Mikaél	Amde-Michael
ዓምደ ሥላሴ	Amdä-Sellasé	Amdeselassie
ዓምደ ጽዮን	Amdä-Şeyon	Amdesion
ዓንዶም	Andom	Andom
ዕቁባ	Equba	Ekube
ዕቁባ እግዚእ	Equba-Egzi	Ekubaegzi
ዕውራን	Ewweran	Eweran
ዘለለው	Zälläläw	Zelelew
ዘለቀ	Zälläqä	Zeleke
ዘሔቦ	Zähebo	Zehebo
ዘመነ	Zämänä	Zemene
ዘመንፈስ	Zämänfäs	Zemenfes
ዘመንፈስ ቅዱስ	Zämänfäs	Zemenfeskedus
ዘረ	Zära	Zera
ዘሪሁይን	Zäryhun	Zerihun
ዘርኦም	Zärom	Zerom
ዘርይሁን	Zäryhun	Zerihun
ዘርፉ	Zärfu	Zerfu
ዘበኛ	Zäbäňa	Zebegna
ዘነበ	Zännäbä	Zenebe
ዘንግ	Zang	Zeng
ዘአብ	Zäab	Zeab
ዘካሪያስ	Zäkkaryas	Zekarias
ዘወልዴ	Zäwäldé	Zewolde
ዘውዱ	Zäwdu	Zewdu
ዘውዲቱ	Zäwditu	Zewditu
ዘውዴ	Zäwde	Zewde
ዘውድነሽ	Zäwdenäš	Zewdnesh
ዘውገ	Zäwgä	Zewge
ዘገብርኤል	Zägäbrél	Zegebriel
ዘገየ	Zägäyyä	Zegaye
ዘፈሩ	Zäfäru	Zeferu
ዛሬ	Zaré	Zare
ዜና	Zéna	Zena
ዜና ማርቆስ	Zena Marqos	Zenamarkos
የሁለተኛው	Yähulätäňňaw	Yehuletegnawe
የሁሉም	Yahullum	Yehulum
የለሽ	Yälläš	Yellesh
የሐረርጌ	Yeharärgé	Yeharegie
የሕዝብ	Yahezb	Yehizb
የሕፃናት	Yahesanat	Yehetsanat
የመርሐ	Yämärha	Yemerha
የመተባበር	Yämättäbabär	Yemetebaber
የመንበረ	Yämänbärä	Yemenbere
የመንበረ ፀባዖት	Yämänbärä Şabaot	Yemenberetsebaot
የመጽሐፍ	Yämäshaf	Yemetshaf
የማነ	Yämanä	Yeman
የማነ ብርሃን	Yämanä-Berhan	Yemaneberhan
የማነ ክርስቶስ	Yämanäkerstos	Yemanekerstos
የምሩ	Yämerru	Yemiru
የምስራቅ	Yamesraq	Yemesrak
የምስራች	Yamessrač	Yemeserach
የምስራች ድምፅ	Yamessrač Demş	Yemeserachdemts
የምድር	Yämder	Yemeder
የሠራዊተ	Yäsärawitä	Yeserawite
የሥራ	Yäsera	Yesera
የሥጋት	Yäsegat	Yesigat
የሰውልክ	Yäsäwlek	Yesewlik
የሱፍ	Yäsuf	Yesuf
የስፖርት	Yäsport	Yesport
የሺመቤት	Yaši Emmäbet	Yeshimebet
የሻነህ	Yäšanäh	Yeshaneh
የሻነው	Yäšanäw	Yeshanwe
የቀኃይለ	Yäqädamawi	Yekedamawi
የቃለ	Yäqalä	Kale
የቅዱስ	Yäqeddusan	Yekdusat
የባሕር	Yäbaher	Yebaher
የቤተ	Yäbetä	Yebete
የተመኝ	Yätämäñ	Yetemegn
የተምሮ	Yätämero	Yetmero
የተሽ	Yätäša	Yetesha
የትምህርት	Yätemehert	Yetemheret
የትግራይ	Yätegray	Yetigraye
የኋላ	Yähwala	Yehwala
የኔ	Yäné	Yene
የኔ ሰው	Yäné-Säw	Yenesew
የንብረት	Yänebrät	Yenebret
የንጉሠ	Yänegusä	Yeneguse
የአምስት	Yammest	Yeameste
የአረኪዎሎጂ	Yarkiwoloji	Yarkiwoloji
የአክሲዮን	Yaksiyon	Yeaksion
የኢትዮጵያ	Yäityopya	Yeityopya
የኤርትራ	Yäertra	Yeértra
የእሑድ	Yaehud	Yehud
የእስላም	Yäeslam	Yeéslalm
የከሳቴ	Yakäsaté	Yekesaté
የክብር	Yakebr	Yekber
የወንጌል	Yäwängel	Yewengel
የወይዘሮ	Yäwäyzäro	Yewyzero
የወጣቶች	Yäwaţţatoč	Yawattatoch
የውነቴ	Yäwnäté	Yewnete
የዓለም	Yaläm	Yealem
የዳግማዊ	Yadagmawi	Yedagmawi
የግሎብ	Yaglob	Yeglob
የግርማዊ	Yagermawi	Yegermawi
የጥጥ	Yatet	Yetet
የጦር	Yätor	Yetore
የጦር ካሣ	Yätorkasa	Yetore Kassa
የፈረስ	Yäfaräs	Yeferes
የፈረንሳይ	Yäfäränsay	Yeferensay
የፍትሐ	Yäfetha	Yefetha
የፍትሐ ብሔር	Yäfethabehér	Yefethabiher
የፕብሊክ	Yapublic	Yepeblik
ዩኒቨርስቲ	Yunivärsiti	Yuniversiti
ያለው	Yaläw	Yalew
ያሬድ	Yaréd	Yaréd
ያኔ	Yanné	Yani
ያዕቆብ	Yaeqob	Yaekob
ያይንሸት	Yaynešät	Yayeneshet
ያገር	Yagär	Yager
ይላቅ	Yelaq	Yelak
ይልማ	Yelma	Yelma
ይሕደጎ	Yihidägo	Yihidago
ይመር	Yemär	Yemer
ይማር	Yemmar	Yemar
ይራድ	Yerad	Yerad
ይርዳው	Yerdaw	Yerdaw
ይርጉ	Yergu	Yirgu
ይርጋ	Yerga	Yirga
ይስሐቅ	Yeshaq	Yishak
ይታጠቁ	Yettatäqu	Yitateku
ይትባረክ	Yetbaräk	Yitbarek
ይኄይስ	Yeheyyes	Yeheyse
ይነሱ	Yennäsu	Yenesu
ይኩኖ	Yekunno	Yekuno
ይኼይስ	Yehéyyes	Yeheyes
ይድነቃቸው	Yednaqaččaw	Yedneqachew
ይገዙ	Yeggäzu	Yigezu
ይግዛው	Yegzaw	Yigzaw
ይፍሩ	Yefru	Yiferu
ዮሐንስ		Yohanis
ዮሴፍ	Yoséf	Yoseph
ዮና	Yona	Yona
ደመኑ	Dämmänu	Damenu
ደመና	Dämmäna	Demene
ደማ	Dama	Dama
ደምሴ	Dämissé	Demisse
ደረጀ	Däräjjä	Dereje
ደሬሳ	Därésa	Deressa
ደርሰህ	Därsäh	Derseh
ደሳለኝ	Dässaläň	Dessalegn
ደሴ	Däsé	Dessie
ደስታ	Dästa	Desta
ደስአለኝ	Dässaläň	Dessalegn	
ደቃ	Däqa	Daka
ደበበ	Däbbäbä	Debebe
ደባልቄ	Däbalqé	Debalqe
ደጀኔ	Däjäné	Dejene
ደጃዝማች	Däjjazmačh	Dejazemach
ደገፋ	Dägäfu	Degefu
ደፈረሱ	Däfärräsu	Deferesu
ደፈረስ	Wärq	Deferese
ዱባለ	Dubbalä	Dubale
ዲሬክሲዮን	Direksiyon	Direksion
ዲበ	Dibä	Dibe
ዳምጣቸው	Damtaččäw	Damtachew
ዳምጤ	Damté	Damte
ዳር	Dar	Dar
ዳሹ	Dašu	Dashu
ዳንዬል	Daniél	Daniel
ዳኘው	Dańäw	Dagnew
ዳኛቸው	Daňaččäw	Dagnacew
ዳኜ	Daňé	Dagne
ዳዊት	Dawit	Dawit
ዳፎ	Daffo	Daffo
ድምፅ	Demş	Demts
ድርጅት	Derejjet	Derijet
ድንቄ	Denqé	Dinke
ድንግል	Dengel	Dingle
ድጉማ	Deguma	Diguma
ድፋዬ	Defayé	Defaye
ጀምበሬ	Jämbäré	Jembere
ጀንበሬ	Janbäré	Jenbere
ጃለታ	Jäläta	Jaleta
ጃፈሮ	Jafäro	Jafero
ገላና	Gäläna	Gelana
ገሠሠ	Gässäsä	Gessesse
ገረመው	Gärrämäw	Geremew
ገሪማ	Gärima	Gerima
ገበየሁ	Gäbäyähu	Gebeyehu
ገቢ	Gebbi	Gibbi
ገብረ	Gäbrä	Gebre
ገብረ ማርያም	Gäbrä-Maryam	Gebremariam
ገብረ ሥላሴ	Gäbräsellasé	Gebre Selassie
ገብረ አምላክ	Gäbramlak	Gebreamlak
ገብረ አብ	Gäbrä-Ab	Gebreab
ገብረ ወልድ	Gäbrä-Wäld	Gebrewold
ገብረ ጻድቅ	Gäbrä-Sadeq	Gebretsadik
ገብረሕይወት	Gäbrä Heywät	Gebrehewot
ገብረመድኅን	Gabrä-mädhen	Gabremedhin
ገብረሚካኤል	Gäbrämikaél	Gebremikael
ገብረሚካኤል	Gäbrä-Mikaél	Gebre Michael
ገብረማርያም	Gäbrä-Maryam	Gebremariam
ገብረአብ	Gäbrab	Gebreab
ገብሩ	Gäbru	Gebru
ገብራይ	Gäbray	Gebray
ገብሬ	Gäbré	Gebre
ገብርኤል	Gabrél	Gabriel
ገነት	Gännät	Genet
ገንዘብ	Gänzäb	Genzeb
ገኝሁ	Gaňähu	Gegnehu
ገዛኸኝ	Gäzzahäň	Gezaghn
ገዳሙ	Gädamu	Gedamu
ጉልማ	Gulemma	Gulma
ጉርሙ	Gurmu	Guremu
ጉበኛ	Gubaňa	Gubegna
ጉባኤ	Gubaé	Gubae
ጉቻለወርቅ	Guččäläwarq	Guchalework
ጉዳይ	Gudday	Gudday
ጉግሣ	Gugsa	Gugsa
ጊዮርጊስ	Giyorgis	Giorgis
ጋርዴ	Garredé	Garide
ጋሻው	Gaššaw	Gashaw
ጋብር	Gaber	Gabre
ጋይም	Gaym	Gaim
ጌራወርቅ	Gerwärq	Gerawork
ጌታሁን	Getahun	Getahun
ጌታቸው	Getaččäw	Getachew
ጌታነህ	Gétanäh	Getaneh
ግርማ	Germa	Girma
ግርማቸው	Germaččäw	Girmachew
ግርማይ	Germay	Girmaye
ግብረ	Gebrä	Gebre
ግዛት	Gizat	Gizat
ግዛው	Gazaw	Gizaw
ግደይ	Gedäy	Gidey
ጎይቶም	Goytom	Gitom
ጐላ	Gwalla	Golla
ጐርፉ	Gwärfu	Gorfu
ጐሽሜ	Gwäšemé	Goshimé
ጐበዜ	Gwäbäzé	Gobeze
ጓጃላ	Gwäjala	Gojela
ጠ/ግ	Täqlay Gezat	Teklay Gezat
ጣፈጠ	Täffäta	Taffete
ጤና	Tena	Tenat
ጥላሁን	Telahun	Telahun
ጥሩነሽ	Terunäš	Tirunesh
ጥበቃ	Tebbäqa	Tebeka
ጥበቡ	Tebäbu	Tibebu
ጥናት	Tinat	Tenate
ጥዑመ	Teumä	Tehume
ጥዑመ ልሳን	Teumä-Lessan	Tehume Lessan
ጦር	Ţor	Tor
ጨርቃ	Čorqa	Chorka
ጫላ	Čala	Challa
ጳውሎስ	Pawlos	Pawelos	
ጸጋ	Şägga	Tsega
ጻድቅ	Sadeq	Tsadik
ጽ/ቤት	Sehfät Bét	Tsehfet Bet
ጽሁፍ	Sehuf	Tshuf
ጽሑፍ	Sehuf	Tsehuf
ጽዮን	Seyon	Tsion
ጽድቅ	SedQ	Tsidk
ጽጌ	Şegé	Tsige
ፀሐይ	Şahay	Sehay
ፀባዖት	Şabaot	Tsebaot
ፀጋ	Şägga	Tsega
ፀጋዬ	Şäggayé	Tsegaye
ፈለቀ	Fälläqä	Feleke
ፈረንጅ	Färänj	Ferenge
ፈረደ	Färrädä	Ferede
ፈቃዱ	Fäqadu	Fecadu
ፈይሳ	Fäyysa	Feissa
ፈድሉ	Fädlu	Fedlu
ፈጠነ	Fättänä	Fetene
ፉትቦል	Futbol	Futbol
ፋሲል	Fasil	Fasil
ፋብሪካ	Fabrika	Fabrika
ፋና	Fana	Fana
ፋንታዬ	Fantayé	Fantaye
ፍላድ	Flad,	Flad,
ፍሎራን	Florent,	Florent,
ፍሬር	Frére	Frére
ፍሬው	Feréw	Ferew
ፍስሐ	Fesseha	Fesseha
ፍስሐዬ	Fessehayé	Fesseha
ፍቃዱ	Feqadu	Fekadu
ፍቅረ	Feqrä	Fekre
ፍቅሩ	Feqru	Fekru
ፍቅር	Feqer	Feker
ፍጡር	Fitur	Fetur
ፓርላሜንት	Parliamént	Parliament
ፕላን	Plan	Plan
ፖሊስ	Polic	Police
ፖስታ	Postal	Posta
