ሀለለ	ኢግ.
ህሉል	ቅ.
ሀለሌ	ስ.
ሀለወ 	ርግ.
ሀላዊ	ቅ.
ሀለወ	ኢግ.
ህልው 	ቅ
ህላዌ	ዘዘ.
ሀላዊ	ቅ.
ህሉና/ህልውና 	ምዘ.
ሀላ	ስ.
ሀሎ	ግ.
ሀሰለ	ኢግ. 
ህሳል 	ዘዘ.
ሀሴን  	ስ.
ሀበባሊ 	ቅ.
ሀቡ 	ግ.
ሀቢ 	ስ.
ሀብለየ	ርግ.
ህብልያ	ዘዘ.
ሀብት 	ስ.
ሀከከ	ርግ.
ሀከክ 	ዘዘ.
ሀከየ 	ኢግ
ሀካይ	ቅ.
ሀኬት	ምዘ.
ሀየል	ስ. (ነባ.)
ሀየየ	ርግ.
ሀየደ	ርግ.
ሀያዲ	ቅ.
ሀይመነ	ርግ.
ሀይማኒ	ቅ.
ሃይማኖት	ምዘ.
ሀይከል 	ስ.
ሀይዶ	ስ.
ሀድአ	ኢግ.
ሀገየ	ኢግ. (ቀተ.)
ሀጋይ 	ዘዘ.
ሀገር	ስ.
ሀገራዊ 	ቅ.
ሀጕለ 	ርግ.
ሀጕል	ዘዘ.
ሀፈወ	ኢግ. 
ሀፍ	ዘዘ.
ሁስጱ	ስ.
ሂጳጳ	ስ.
ሃሌ 	ቅ.
ሃሌታ	ስ.
ሃሌ ሉያ 	ቅ.
ሃይማኖት 	ስ.
ሄላ 	ስ.
ሄርማ	
ሄደ	ርግ.
ሃያዲ 	ቅ.
ሀይድ	ዘዘ
ተሀይድ	ተደ.አ.
ህዩድ	ቅ.
ሄጠ 	ርግ.
ሂጣን 	ምዘ.
ሄጵዲያቆን	ስ.
ሄጵዲጤን 	ስ.
ህለል 	ስ.
ህላዌ	ስ.
ህልው 	ቅ.
ህሳል	ስ.
ህቦ	ስ.
ህንደኬ	
ህኩክ 	ቅ.
ህየንተ	መፃ. እና መግ.
ሆባይ 	ስ.
ሆከ	ርግ.
ሀዋኪ	ቅ.
መሀውክ	ባቅ.ዝከ.
ሀውክ	ዘዘ.
ተሀውክ	ተደ.አ
ህውክ	ቅ.
ሁከት	ሳዘ.
ሊተ	
ለነ	
ለከ	
ለክሙ	
ለኪ	
ለክን	
ሎቱ	
ሎሙ	
ላቲ	
ሎን	
ለሀበ 	ኢግ.
ላህብ	ዘዘ.
ለሀወ	ኢግ.
ለህሀ	ርግ.
ለለ	መዋ.
ለል	
ለልየ	
ለሊነ	
ለሊከ	
ለሊክሙ	
ለሊኪ	
ለሊክን	
ለሊሁ 	
ለሊሆሙ	
ለሊሃ	
ለሊሆን	
ለሐመ 	ኢግ.
ልሑም	ቅ.
ለሐሰ	ርግ.
ለሓሲ	ቅ.
ምልሓስ	ባዘ.
ለሐቀ	ርግ.
መልሕቅ	ባዘ.
ለሐኰ	ርግ.
ልሕኵት	ምዘ.
ለሐየ	ኢግ. 
ልሑይ 	ቅ.
ላሕይ 	ዘዘ.
ለሐፀ	ርግ.
ልሕፀት	ሳዘ.
ለመደ	ርግ.
ልማድ	ዘዘ.
ተልሚድ	ባዘ.
ልሙድ	ቅ.
ለምለመ	ኢግ.
ልምሉም	ቅ.
ልምላሜ	ዘዘ.
ለምሐ 	ኢግ.
ለምዐ	ኢግ.
ልሙዕ	ቅ.
ልምዓት	ሳዘ.
ለምንት	ተግ.
ለምድ	ስ.
ለሰነ	ኢግ
ልሱን 	ቅ.
መለሰን 	ባቅ.
ልሳን	ዘዘ.
ልሳነ እሳት 	
ልሳነ ባሕር	
ልሳነወርቅ	
ልሳነመድሎት	
ልሳነ ሰብእ	
ልሳናዊ	ቅ.
ለስሐ 	ኢ/ርግ. 
ልሱሕ	ቅ.
ልስሐት 	ሳዘ.
ለበበ	ርግ.
ልባብ	ዘዘ.
ለበነ	ርግ.
ልብን	ዘዘ.
ለበወ	ሥግ. 
ልብው	ቅ.
መለብው 	ባቅ.
ልብ	ዘዘ.
ልቡና	ዘዘ.
ለብሐ	ርግ.
ልብሓዊ	ቅ.
ልብሓት 	ሳዘ.
ለብሕ	ዘዘ.
ለብሰ	ርግ.
ልቡስ 	ቅ.
ልብስ	ዘዘ.
ለባሲ	ቅ.
ልብሰት	ሳዘ.
ለበጠ	ርግ.
ለባጢ 	ቅ.
ልቡጥ	ቅ.
ልብጠት	ሳዘ.
ለተመ	አ.ግ.
ለትሐ	ርግ.
መልትሕ	ባቅ.
አልትሐ	አድ.አ. 
አልታሕ	ባዘ. 
መልታሕት	ስ.
ለንጳሰ	ርግ.
ለንጳስ	ዘዘ.
ለተተ	ኢግ.
ልቱት	ቅ.
ለንዴዎን	ስ.
ለንጽ	ስ.
ለአከ	ርግ.
ለአኪ	ቅ.
መልእክት 	ባዘ.
መልአክ	ባዘ.
ልኡክ	ቅ.
ለእክ	ዘዘ.
ለአፈ	ርግ.
ልኡፍ	ቅ.
አፍ	ስ.
ለከ	
ለክሙ	
ለኪ	
ለክን	
ስብሐት ለከ	
ሰላም ለኪ	
ለከወ	እግ.
ለከፈ	ርግ.
ልኩፍ	ቅ.
መልክፍ	ባቅ.
ለክአ 	ርግ.
ልኩእ	ቅ.
መልክእ	ባዘ.
ለወለ	ኢግ.
ለወረ	ርግ.
ልዉር	ቅ.
ለውር	ስ.
ለወወ	ርግ.
ለውለወ	ርግ. 
ለውዝ	ስ.
ለዐለ	ኢግ.
ልዑል	ቅ.
ሉዓሌ	ዘዘ.
ሉዓላዊ 	ቅ.
ልዕልና 	ዘዘ.
ልዕል	ዘዘ.
አልዐለ	አስ.አ
አልዓሊ	ቅ.
መልዕልት	ባከ.
ተለዐለ/ተልዕለ	
ለዐተ	ርግ. 
ለዓት 	ዘዘ.
ለዘ	ኢግ.
ለዝለዘ 	ኢግ.
መለዝልዝ	ባቅ.
ለዝሊዝ	ዘዘ.
ለይቀለ	ርግ.
ለይቀል	ዘዘ.
ለይ	ስ.
ለጐመ	ርግ.
ልጓም 	ዘዘ.
ለገበ 	ርግ.
ለገገ	ኢግ.
ልጋግ	ዘዘ.
ልግነተ 	ርግ.
ልጐን	ዘዘ.
ልጐን	ስ.
ለጠረ	ርግ.
ልጥር	ዘዘ.
ልጥረ ወርቅ	
ለጠነ	ርግ.
ሊጦን 	ዘዘ.
ምልጣን	ባዘ.
ለጥሐ	ኢግ.
ልጡሕ	ቅ.
ለጸቀ	ኢግ.
ልጹቅ	ቅ.
ለፍየ	ርግ.
ለፌ	ዘዘ.
ለፈፈ	ርግ.
ልፋፍ	ዘዘ.
ሉል	ስ.
ሉቃስ	ተጸ.ስ.
ሉዓሌ 	ስ.
ሉያ 	ቅ.
ሊሉይ	ቅ.
ሊሊት	ስ.
ሊሎ	ስ.
ሊቃኖስ	ተጸ.ስ.
ሊባ 	ስ. 
ሊቅ	ቅ.
ሊቀ ሐባዝያን	
ሊቀሕጽዋን	
ሊቀቀጻሕያን 	
ሊቀመበሰላን	
ሊባኖስ	ስ.
ሊባኖሳዊ	ቅ.
ሊተ	ተስ.
ሊተ	
አሌ ሊተ	
ሊተ አርክ	
ሊቶስጥራ 	ስ.
ሊጦን	ስ.
ላሀወ 	ኢግ.
ላህ 	ዘዘ.
ላሁ/ላህላሁ	ስ.
ላህብ	ስ.
ላህይ	ስ.
ላሕም	ስ.
ላባ 	ተጸውኦ ስም
ላቲ	ተስ.
ላኅልኅ	ኢግ.
ልኅሉኅ	ቅ.
ላከወ	ርግ.
ላኰየ	ኢግ.
ላኳ	ዘዘ.
ላዕልዐ	ኢግ.
ላዕላዕ	ቅ.
ላዕላይ	ቅ.
ላይዳ	ስ.
ላጸየ	ርግ.
ልጹይ	ቅ.
መላጺ	ስ.
ላጽቂት 	ስ.
ሌለየ 	ርግ.
ሊሉይ	ቅ.
መሌሊት	ባከ.
ሌሊት 	ስ.
ሌቀ	ኢግ.
ሊቅ	ቅ.
ሊቃናት ፣ ሊቃውንት	ብቁ.
ሊቅና	ምዘ.
ሌወወ	ርግ.
ሌዋዊ	ቅ.
ሌዊ	ተጸ.ስ.
ሌዋታን	ስ.
ሌጌዎን 	ስ.
ልህስ	ኢግ.
ልህቀ	ኢግ.
ሊሂቅ	ቅ.
ልህበ	ኢግ.
ላህብ	ዘዘ.
ልሁይ 	ቅ.
ልህድ	ቅ.
ልሕመ	ኢግ.
ልሔም	ዘዘ.
ልሕሰ	ርግ.
ልሕኵት	ስ.
ልሕደ 	ኢግ.
ልሙድ	ቅ.
ልሳን 	ስ.
ልሳነ ግእዝ	
ልቡና/ልብ 	ስ.
ልብስ 	ስ.
ልብሰ ዐውድ	
ልብሰ አፀድ	
ልብሰመትከፍ	
ልብኔ	ስ.
ልብን 	ስ.
ልዉስ	ቅ.
ልዑል	ቅ.
ልደት 	ስ.
ልገት	ስ.
ልጐት	ስ.
ልጐን	ስ.
ልግነት	ስ.
ልጓም	ስ.
ልጥር 	ስ.
ልፋፍ 	ስ.
ሎሀ	ርግ.
ሎለወ	ሥግ.
ሎሐ	ርግ.
ሎሕ/ለውሕ 	ዘዘ.
ሎሚን	ስ.
ሎስ	ርግ.
ልውስ	ቅ.
ሎቀ	ርግ.
ሎቅሳ	ስ.
ሎዘ	ርግ.
ሎዛዊ	ቅ.
ሎዛ	ስ.
ሎዛን 	ስ.
ሎግዮ	ስ.
ሎጣዊ	ቅ.
ሐለለ	ኢግ.
ሐለመ	ኢግ.
ሐላሚ 	ቅ.
ሕልም	ዘዘ.
ሐለስትዮ	ስ.
ሐለቀ	ርግ.
መሐልቅ 	ባቅ.
ሕልቀት	ምዘ.
ሐለበ	ርግ.
ሐላቢ	ቅ.
ተሐልበ	ተደ. አ.
ሕሉብ	ቅ.
ሕልበት	ሳዘ.
ሐሊብ	ዘዘ.
ማሕለብ	ባዘ.
ሐለተ	ርግ.
ሕለት	ዘዘ.
ሐለየ	ርግ.
ሕሊና	ዘዘ.
ሐለደ	ርግ.
ሐልቀ	ኢግ.
ሐልዘዘ 	ርግ.
ሐልየነ	ርግ.
ሕልያን 	ዘዘ.
ሐሎብ	ስ.
ሐመ	ኢግ
ሕሙም 	ቅ.
ሐማሚ	ቅ.
ሕማም	ዘዘ.
መስተሐምም	ባቀ.
ሐመመ	ኢግ.
ሕመሜ	ዘዘ.
ሐማሚ	ቅ.
ሐመለ	ርግ.
ሐምል	ዘዘ.
ሐምለብሒእ	
አሕመልመለ	አድ.አ.
ሐመልሚል	ቅ.
ሐመልማል	ዘዘ.
ሐምሌ	
ሐመል	ስ.
ሐመረ	ርግ.
ሐመር	ዘዘ.
ሐምር	ስ.
ሐምራዊ	ቅ.
ሐመሰ	ርግ.
ሐመተ	ርግ.
ሕመት	ዘዘ.
ሐመወ	ኢግ.
ተሓመወ	ተዳ.አ.
መስተሓምው	ባቅ.
ታሕማ	ዘዘ.
ሐም/ሐማ	ዘዘ.
ሐማት 	
ሐመዘ	ኢግ.
ሕምዝ	ዘዘ.
ሐመየ	ርግ.
ሐማዪ	ቅ.
ተሐምየ	ተደ.አ.
ሕሙይ	ቅ.
ሐሜት	ዘዘ.
ሕምየት	ሳዘ.
ሐመይት	መድ.ቅ.
አሕመየ	አስ.አ.
ተሓመየ	ተዳ.አ.
አስተሓመየ	አዳ.አ
ሐመየ	ርግ.
ሕሙይ	ቅ.
ሐመደ	ኢግ.
ሐመድ	ዘዘ.
ሐመዳዊ	ቅ.
ሐመዳ	ዘዘ.
ሐመድማድ	ስ.
ሐመገ	ርግ.
ሐማጊ	ቅ.
ተሐመገ	ተደ.አ. 
ሕሙግ	ቅ.
ሕመግ	ዘዘ.
ሐማት	ስ.
ሐማ	
ሐሜለት	ስ.
ሐም	ስ.
ሐምል	ስ.
ሐምሐም	ስ.
ሐሞት 	ስ.
ሐሠመ 	ኢግ.
ሕሡም	ቅ.
ሕሠም	ዘዘ.
ሕሥመት	ሳዘ.
አሕሠመ	አስ.አ.
ሐሣማ	ስ.
ሐሠረ	ርግ.
ሐሣሪ	ቅ.
ሐሠር	ዘዘ.
ሐሠየ	ርግ.
ተሐሠየ/ተሐሥየ 	ተደ.አ.
ሐሤት 	ምዘ.
ሐሥረ	ግ.
ሕሡር	ቅ.
ሐረመ	ርግ.
ሐራሚ	ቅ.
ተሐርመ	ተደ.አ.
ሕሩም	ቅ.
ሕርመት	ሳዘ.
ሕርም	ዘዘ
ትሕርምት 	ምዘ.
ምሕራም	ባዘ.
ሐረረ	ግ.
ሐሩር	ዘዘ.
ሐሪር	ስ.
ሐረስ	ርግ.
ሐራሲ	ቅ.
ሐራሳዊ	ቅ.
ተሐረስ	ተደ.አ.
ሕሩስ 	ቅ.
አሕረስ	አሰ.አ
ማሕረስ	ባዘ.
ሕርሰት	ሳዘ.
ሐርስ	ዘዘ.
ሐሪስ	ስ.
ሐራ	ስ.
ሐረወ	ግ.
ሕሮ	ዘዘ.
ሐራውያ	ምዝ.
ሐረደ	ርግ.
ሐራዲ	ቅ.
ተሐርደ 	ተደ.አ.
ሕሩድ 	ቅ.
ሕርድ	ዘዘ.
ሕርደት	ሳዘ.
ሐረገ	ርግ.
ሐረግ	ዘዘ.
ሐረጸ	ርግ.
ሐራጺ	ቅ.
ተሐርጸ	ተደ.አ.
ሕሩጽ	ቅ.
ሐሪጽ	ዘዘ.
ሐሪጸሐሊብ	ስ
ማሕረጽ	ባዘ.
ሐረፈ	ኢግ.
ሐረፋ	ዘዘ.
ሐራውያ	ስ.
ሐርሶ	ስ.
ሐርበደ	ግ.
ሐርነት	ስ.
ሐርተመ	ኢግ.
ሕርቱም	ቅ.
ሕርትምና	ምዘ.
ሐርገፅ	ስ.
ሐርጌ	ስ.
ሐርጰጰ	ግ.
ሐሰበ 	ርግ.
ሐሳቢ	ቅ.
ተሐሰበ	ተደ.አ.
ሕሱብ	ቅ.
ሐሳብ	ዘዘ.
ተሓሰበ	ተዳ.አ.
ትሕስብት	ምዘ.
ሐሰወ	ርግ.
ሐሳዊ	ቅ.
ተሐሰወ	ተደ.አ.
ሕስው	ቅ.
ሐሰት	ዘዘ.
ሐሰየ 	ርግ.
ሐሳዪ	ቅ.
ተሐሰየ	ተደ.አ.
ሕሱይ	ባቅ.
ሕስየት 	ሳዘ.
ሐሴን 	
ሐሰል	ስ.
ሐስአ	ግ.
ሐቀለ 	ርግ.
ሐቃል	ቅ.
ሐቅል	ዘዘ.
ሐቀረ	አ.ግ.
ሐቃሪ	ቅ.
አስተሐቀረ	አስ.አ
መስተሓቅር	ባቅ.
ሐቀ	ግ.
ሐቅ	ዘዘ.
ሕቅ	ቅ.
ሕቍ	ስ.
ሐቀየ	ርግ.
ሐቃዪ	ቅ.
ተሐቅየ	ተደ.አ.
ሕቁይ	ቅ.
ሐቅየ ሰነን	
ሐቀፈ	ርግ.
ሐቃፊ	ቅ.
ተሐቅፈ	ተደ.አ
ሕቁፍ	ቅ.
ሕቅፈት	ሳዘ.
ሑቃፌ	ዘዘ.
ምሕቃፍ	ባዘ.
ሐበለ	ኢግ.
ሐባሊ	ቅ.
ሐበለ	ርግ.
ሕቡስ	ቅ.
ሐብስ	ዘዘ.
ሐበበ	ርግ.
ተሐበበ	ተደ.አ
ሐቢብ	ዘዘ.
ሐበነ	ርግ.
ሕባኔ	ዘዘ.
ሐበዘ	ርግ.
ሐባዚ	ቅ.
ሐበየ	ርግ.
ተሐበየ	ተደ.አ.
ተሐባዪ	ቅ.
ሕብየት 	ሳዘ.
ሐበጠ	ኢግ.
ሐባጢ	ቅ.
ሕበጥ 	ዘዘ.
ሐብለ	ርግ.
ሐባሊ	ቅ.
ተሐብለ	ተደ.አ.
ሕቡል	ቅ.
ሕብል	ዘዘ.
ሕብለት	ሳዘ.
ሐብልየ	ርግ.
ሕብልያ	ዘዘ.
ሐብረተ	ርግ.
ሐብቀቀ	ርግ.
ሐተተ	ሥግ.
ሐታቲ	ቅ.
መሐትት	ባቅ.
ሐተታ	ዘዘ.
ሐነቀ	ርግ.
ሐነከ	ርግ.
ሕኑክ	ቅ.
ማሕነክ	ባዘ.
ሕንክ	
ሐነወ	ርግ.
ሐናዊ	ቅ.
ሐኖት 	ዘዘ.
ሐነጸ	ርግ.
ሐናጺ	ቅ.
ሐነጽት	መድ.ቅ.
ተሐነጸ	ተደ.አ.
ሕኑጽ	ቅ.
ሕንጸት	ሳዘ.
ሕንጻ	ዘዘ.
ሕንፄ	ዘዘ. ዝከ.
ሐንቀቀ	ኢግ.
ሕንቁቅ	ቅ.
ሕንቃቄ	ዘዘ.
ሐንበለ	ርግ.
ሕንባል 	ዘዘ.
ሐንበበ	ርግ.
ሕንቡብ	ቅ.
ሕንባብ 	ዘዘ.
ሐንከሰ	ኢግ.
ሐንካስ	ቅ.
ሕንካሴ	ዘዘ.
ሕንክስና	ምዘ. ዝከ.
ሐንክሶ	ስ.
ሐንዘር	ስ.
ሐንጶን	ስ.
ሐንፈጠ	ርግ.
ሐንፈፀ	ርግ.
ሕንፉፅ 	ዘዘ.
ሐከመ	ርግ.
ሐኪም	ቅ.
ሐከከ	ኢግ.
ሐካኪ	ቅ.
ሕከክ	ዘዘ.
ተሐከ	ተደ.አ.
ሕኩክ 	ቅ.
ሐከክ	ዘዘ.
ሐከየ	ኢግ.
ሐካይ 	ቅ.
ሐወለ	ርግ.
ሐዋሊ	ቅ.
ሐወልት 	መድ.ቅ.
ተሐወለ	ተደ.አ.
ሕውል	ቅ.
ሐውል	ዘዘ.
ሐውልት 	ምዘ.
ሐወዘ	ኢግ.
ሐዋዝ	ቅ.
ሐውዝ	ዘዘ.
ሐወየ	ኢግ.
ሐዋዪ	ቅ.
ሕዋይ	ዘዘ.
ሐው 	ዘዘ.
ሐዊ	ስ.
ሐወጸ	ርግ.
ሐዋጺ	ቅ.
መሐውጽ	ባቅ.
ምሕዋጽ	ባዘ.
ተሐወጸ	ተደ.አ.
ሕዉጽ	ቅ.
ሕዋጼ	ዘዘ.
ሐዊሳ	ስ.
ሐዋርያ	ስ.
ሐውልት	ስ.
ሐዘለ	ርግ.
ሐዛሊ	ቅ.
ምሕዛል	ባዘ.
ሕዝል	ስ.
ሐዘበ	ርግ.
ሐዛቢ	ቅ.
ተሐዘበ	ተደ.አ.
ሕዙብ	ቅ.
ትሕዝብት	ምዘ.
ሕዝብ	ስ.
ሕዝባዊ 	ቅ.
ሕዝብና/ሕዝብነት 	ምዘ.
ሐዘዘ	ርግ.
ሐዝሐዝ	ስ.
ሐዝአ	ርግ.
ሐዛኢ	ቅ.
ሕዝእ	ዘዘ.
ሕዝአት	ሳዘ.
ተሐዝአ	ተደ.አ.
ሕዙእ	ቅ.
ሐይመት	ስ.
ሐይብ	ስ.
ሐይወ	ኢግ.
ሕያው	ቅ.
ሕይወት 	ምዘ.
ሕያውና	ምዘ.
ማሕያዊ	ባቅ.
መሕያው	ባዘ. 
ሐደመ	ርግ.
ሐዳሚ	ቅ.
መሐድም	ዘዘ.
ሐደሰ 	ርግ.
ሐዳሲ	ቅ.
ሐደሰት 	መድ.ቅ.
ተሐደሰ	ተደ.አ.
ሐዲስ 	ቅ.
ሕዳሴ	ዘዘ.
ሐደፈ	ርግ.
ሐዳፍ 	ስ.
ሐገመ	ርግ.
ሐገዘ	ርግ.
ሐገዝ	ዘዘ.
ሐገየ	ኢግ.
ሐጋይ 	ዘዘ.
ሐገገ	ርግ.
ሐጋጊ	ቅ.
ተሐገገ	ተደ.አ.
ሕጉግ	ቅ.
ሕገጠባይዕ	
ሕግሥጋ	
ሐገፈ	ርግ.
ሐገፋ	ዘዘ.
ሐጌ	ስ.
ሐጠበ	ርግ.
ሐጣቢ	ቅ.
ሐጥብ	ዘዘ.
ሐጸረ	ርግ.
ሐጻሪ	ቅ.
ሐጹር	ዘዘ.
ተሐጽረ	ተደ.አ.
ሕጹር	ቅ.
ሐጸበ	ርግ.
ሕጽበት	ሳዘ.
ሐጻቢ	ቅ.
ሐጸ	ኢግ.
ሕጸጽ	ዘዘ.
ሕጹጽ	ቅ.
ሕጸት 	ሳዘ.
ሑጻጼ	ዘዘ.
ሐጽ	ስ.
ሐፀነ	ርግ.
ሐፃኒ	ቅ.
ሕፃን	ዘዘ.
ሕፅን	ዘዘ.
ተሐፅነ	ተደ.አ
ሕፁን	ቅ.
ማሕፀን	ባዘ.
ሐፀየ	ርግ.
ሐፃዪ	ቅ.
ሕፄ	ዘዘ.
ሕፅየት 	ሳዘ.
ተሐፅየ	ተደ.አ.
ሕፁይ	ቅ.
ሐፄ	ስ.
ሐፄጌ	ቅ.
ሐፈሰ	ርግ.
ሐፈነ	ርግ.
ሕፍን	ዘዘ.
ሐፈወ	ኢግ.
ሐፍ	ዘዘ.
ሑት	ስ.
ሒስ	ስ.
ሔለይ	ስ.
ሔረቅ	ስ.
ሔረበ	ርግ.
ሔሬቢ	ዘዘ.
ሔሬብ	ዘዘ.
ሔሰ	ርግ.
ሐያሲ	ቅ.
ሒስ	ዘዘ.
ሒስት	ሳዘ.
ተሐይስ	ተደ.አ.
ሕዩስ	ቅ.
ተሓየሰ	ተዳ.አ.
ሔሴሜት	ስ.
ሔበ	ርግ.
ሐያቢ	ቅ.
ማሕየብ	ባዘ.
ሕየብ 	ዘዘ.
ሔንቂ	ስ.
ሔከ	ርግ.
ሐያኪ	ቅ.
ሒከት	ሳዘ.
ሒክ	ዘዘ.
ሔዋን	ስ.
ሔው	ስ.
ሔደ	ርግ.
ሐያዲ	ቅ.
ሕለት	ስ.
ሕሊና	ስ.
ሕልያን	ስ.
ሕልጽ	ስ.
ሕመት	ስ.
ሕመግ	ስ.
ሕማም	ስ.
ሕምስ	ስ.
ሕምዝ	ስ.
ሕርመት	ስ.
ሕርቱም	ቅ.
ሕርወት	ስ.
ሕሮ	ስ.
ሕሳዌ	ስ.
ሕስት	ስ.
ልብስ ሕስት	
ሕቅ	ቅ
ሕቁና	ስ.
ሕባኔ	ስ.
ሕንቅርት 	ስ.
ሕንባል	ስ.
ሕንብርብሬ	ስ.
ሕንብርት	ስ.
ሕንካሴ	ስ.
ሕንጽዋል	ስ.
ሕዋር	ስ.
ሕዋስ	ስ.
ሕዝቅኤል	ስ.
ሕዝብ 	ስ.
ሕዝባዊ 	ቅ.
ሕያው	ቅ.
ሕይወት	ስ.
ሕድአት	ስ.
ሕገ መዋ.	
ሕገ ሰብእ እኄሊ	
መግ. ሕገ ጾመ ሙሴ	
ሕጋዊ 	ቅ.
ሕግ	ስ.
ሕጠት 	ስ.
ሕጠት ሰናፔ	
ሕፃብ	ስ.
ሕፃን	ስ.
ሕፄ	ስ.
ሕፅው	ቅ.
ሖረ	ኢግ.
ሐዋሪ/ሐዋርያ 	ቅ.
ምሕዋር	ባቅ.
ሕዋር 	ዘዘ.
ሖሰ	ርግ.
ተሓዋሲ	ቅ.
ሕዋስ	ስ.
መሀረ	ርግ.
መሃሪ	ቅ.
መምህር 	ባቅ.
ተምህር	ተደ.አ. 
ምሁር	ቅ.
ትምህርት 	ምዘ.
ተመሃሪ	ስ.
መሀከ	ኢ/ርግ.
መሃኪ	ቅ.
ምህከት	ሳዘ.
መሀክይ	ቅ.
መለለ	ርግ.
መለሰ	ርግ.
መለቀ	ርግ.
ሚላቅ	ዘዘ.
መለብው	ቅ.
መለንስ	ስ.
መለከ	ርግ.
መላኪ	ቅ.
መለኮት	ስ.
መለኮታዊ	ቅ.
ምልክና	ምዘ.
መለከት	ስ.
መለየ	ርግ.
መሌሊት	ስ.
መለጠ	ርግ.
መለጸ	ግ.
መላጺ	ዘዘ.
መሊጦን 	ስ.
መላህቅት 	ቅ.
መላንው	ስ.
መላጺ 	ስ.
መሌሊት	ስ.
መልሐ	ርግ.
ምልሕ 	ዘዘ.
መልሕቅ	ስ.
መልብስ	ስ.
መልታሕት 	ስ.
መልአክ	ስ.
መልክእ	ስ.
መልዐ	ርግ.
ምሉዕ	ቅ.
መልግም	ስ.
መልጰጶን	ስ.
መሎኬ	ስ.
መሐለ	ሥግ.
መሓሊ	ቅ.
መሐላ	ዘዘ.
መሐልቅ	ቅ.
መሐረ	ርግ.
መሓሪ	ቅ.
ተምሕረ	ተደ.አ.
ምሕረት	ምዘ.
ምሑር	ቅ.
መሐሰ	ርግ.
መሓስዕ	ስ.
መሐትምት	ስ.
መሐነ	ርግ.
መሓን	ቅ.
ምሕን	ዘዘ.
መሐና	ስ.
መሐከ	ኢግ.
ምሑክ	ቅ.
መሐወ	ርግ.
መሐውክ	ባቅ.
መሐዘ	ኢግ.
መሐዛ	ዘዘ.
መሐደምት	ስ.
መሐጸ	ኢግ.
ምሑጽ	ቅ.
ማሕጸን 	ምዘ.
መሐፀ	ርግ.
ማሕፄ	ዘዘ.
መሐፒል	ስ.
መመተ	ኢግ.
ምማቴ	ዘዘ.
መምዐ	ኢግ.
ምምዓ	ዘዘ.
ምማዔ	ዘዘ.
መምዐለ	ርግ.
መምዕል	ቅ.
መምዕላይ	ምቅ.
መሥረተ	ርግ.
መሠረት	ዘዘ.
መሠቀ	ርግ.
መሠቅ	ዘዘ.
መሠደ	ርግ.
መሠጠ	ርግ.
መሣጢ	ቅ.
መሠጥ	መድ.ቅ.
ምሥጥ	ዘዘ.
ተመስጠ	ተደ.አ.
ምሡጥ	ቅ.
መሣውር	ስ.
መሥዔ	ስ.
መሥዕል	ቅ.
መሥገርት	ስ.
መሥገርተግሥ	(መግ.)
መረ	ኢግ.
መሪር	ቅ.
ምሩር	ቅ.
ምረት	ሳዘ.
ምረር	ዘዘ.
መረሰ	ኢግ.
መረቅ	ስ.
መረብ	ስ.
መረተ	ርግ.
ምርት 	ዘዘ.
መረየ	ኢግ.
ማሪ	ቅ.
መረደ	ርግ.
መራድ	ቅ.
መረገ	ርግ.
መራጊ	ቅ.
ተመርገ	(ተደ.አ.)
ምሩግ	ቅ.
ምረግ	ዘዘ.
መረግድ	ስ.
መሪር	ቅ.
መራናት	ስ.
መሬት	ስ.
መሬታዊ	ቅ.
መርህብ	ስ.
መርሐ	ርግ.
መራሒ	ቅ.
መርሕ	ስወቅ.
መርሐእውር	
ተመርሐ	ተደ.አ. 
ምሩሕ	ቅ.
መርመሬ	ስ.
መርመር	ስ.
መርመተ	ርግ.
መርማቲ 	ቅ.
መርሰሰ	ርግ.
መርሰስ	ዘዘ.
መርስ	ስ.
መርሳኒ	ስ.
መርቁቶ	ስ.
መርቄ	ስ.
መርበብት 	ስ.
መርብዕት 	ስ.
መርእይ	ስ.
መርከብ	ስ.
መርወይ	ስ.
ወርዋህት	ስ.
መርዐ	ኢግ.
መርዓ	ዘዘ.
መርዓት 	ስ.
መርዓዊ	ስ.
መርዔት	ስ.
መርዝም	ስ.
መርደደ	ርግ.
መርዳዲ	ቅ.
መርዴድ 	ዘዘ.
መርግሕ	ስ.
መርጡል	ስ.
መርፈቅ	ስ.
መርፍዕ	ስ.
መሰለ	ኢግ.
መሰለ	ርግ.
መሳሊ	ቅ.
ምሳሌ	ዘዘ.
ምስል	ዘዘ.
መስርሕ	ቅ.
መስርይ	ቅ.
መሰንቆ	ስ.
መሰከ	ርግ.
መሲሕ	ቅ.
መሳብዕ	ቅ.
መሳይምት	ስ.
መስልም	ስ.
መስሐ	ርግ.
መሲሕ	ቅ.
ምሳሕ	ዘዘ.
መስመክ.	ስ.
መስረቁ 	ስ.
መስረብ	ስ.
መስረፍ	ስ.
መስቀል	ርግ.
ምስቁል	ቅ.
አመሰቀለ 	አስ.
መስቀል	ስ.
መስቄሎን 	ስ.
መስቄ	ስ.
መስበልት	ስ.
መስብክ 	ስ.
መስተሀብ	ቅ.
መስተሀብብ	ቅ.
መስተሐምው	ቅ.
መስተራትዕ	ስ.
መስተአድ	ስ.
መስተካ	ስ.
መስተገብር	ቅ.
መስተጋብዕ	ስ.
መስተፅዕን 	ቅ.
መስቴማ	ስ.
መስቴ	ስ.
መስነቅ	ስ.
መስእል	ቅ.
መስከረም	
መስከነ	ግ.
ምስኪን	ቅ.
መስወ	ኢግ.
መስዔ	ስ.
መስዕ	ስ.
መስየ	ኢግ.
ምሴት	ምዘ.
መስጴጦምያ	
መስፈጥ	ስ.
መስፍን	ቅ.
መሶብ	ስ.
መቀለ	ርግ.
መቃል	ቅ.
መቈረ	ርግ.
መቈሰ	ርግ.
መቀስ	ዘዘ.
መቀቀ	ኢግ.
መቀነ	ግ.
መቃን	ቅ.
መቀነት	ስ.
መቍፀርት	ስ.
መቃምር	ስ.
መቃርዕ	ስ.
መቃስምት	ስ.
መቃብሩር	ስ.
መቃብር	ስ.
መቃይድ	ስ.
መቅለድ	ስ.
መቅለዘ	ርግ.
መቅለዝ	ዘዘ.
መቅረጽ	ስ.
መቅርብ	ቅ.
መቅበርት	ስ.
መቅንት	ስ.
መቍዓል	ስ.
መቅዓት	ስ.
መቅጽሐዕዝን	ስ.
መቅድኅ	ስ.
መቅድን	ስ.
መቅጹት	ስ.
መቅፈርት 	ስ.
መበለ	ኢ/ርግ.
አመበለ	አድ.አ
መበለት 	ስ.
መባሕት	ስ.
መብራ	ስ.
መብዕስ	ቅ.
መተረ	ርግ.
መታሪ	ቅ.
ተመትረ	ተደ.አ
ምቱር	ቅ.
ምታር	ዘዘ.
ምትረት	ሳዘ.
መትር	ዘዘ.
መተርእስ	ስ
መተቀ	ኢግ.
ምቱቅ	ቅ.
ምትቀት	ሳዘ.
መተነ	ኢግ.
ምቱን	ቅ.
ምትን	ዘዘ.
መተንብል	ቅ.
መታሕል	ቅ.
መታግር	ስ.
መትሀ	ርግ.
መታሂ	ቅ.
ተመትሀ	ተደ.አ.
ምቱህ	ቅ.
ምትሀት	ሳዘ.
ምትሀታዊ	ቅ.
መትሐ	ኢግ.
ምቱሕ	ቅ.
ምትሕት	ባዘ.
ምትአንተል	ቅ.
መትክልት	ስ.
መነ	
መነሳንስ 	ስ.
መነነ	ርግ.
መናኒ	ቅ.
ምናኔ	ዘዘ.
ተመነነ	ተደ.አ
ምኑን	ቅ.
መነየ	ርግ.
ምኔት	ምዘ.
መነኮስ	ስ.
መነኮሳዊት	ቅ.
መነጽር	ቅ.
መኑ	ተስ.
መና	ስ.
መንሰወ	ርግ.
ምንስው	ቅ.
መናስው	መድ.ቅ.
መንሱት	ምዝ.
መንቀቀ	ርግ.
መንቅዕት	ስ.
መንበር	ስ.
መንበረ ልዑል	
መንቢህ	ስ.
መንተወ	ኢግ.
ምንትው	ቅ.
ምንታዌ	ዘዘ.
ምንትውና	ምዘ.
መንታ 	ዘዘ.
መንተሌ	ስ.
መንተፈ	ርግ.
መንኮሰ	ኢግ.
መነኮስ 	ዘዘ.
ምንኩስና	ምዘ.
መንከስ	ስ.
መንካ	ስ.
መንክር	ቅ.
መንኮብያ	ስ.
መንዚራን	ቅ.
መንዚር	ስ.
መንዛህልል	ቅ.
መንዝኅ	ግ.
ምንዙኅ	ቅ.
መንደልቶጹግ	ስ.
መንድቅ	ስ.
መንደፍ	ቅ.
መንዲል	ስ.
መንዳድ	ስ.
መንገለ	መዋ.
መንገኒቅ	ስ.
መንገን	ስ.
መንገድ	ስ.
መንግሥት	ስ.
መንግሥተ ሰማይ	
መንግሥተ ዓለም	
መንግር	ባቅ.
መንጠፍት	ስ.
መንጢጥ	ስ.
መንጦላዕት	ስ.
መንጦላዕተ ወርቅ	
መንጦላዕተ ቤተ መቅደስ	
መንጦላዕተ ደመና	
መንጦላዕተ ብርሃን	
መንጸፍ	ስ.
መንፈቅ	ስ.
መንፈቀ ዕለት	
መንፈቀ ወርኅ	
መንፈቀ ዓመት	
መንፈቀ ኅብስት 	
መንፈቀ መና 	
መንፌ	ስ.
መአሰ	ርግ.
ማእስ	ዘዘ.
መአስበት	ስ.
መአተ	ግ.
ምእት	ዘዘ.
አምኣት	
አምኣታት	
መኣንፍት	ስ.
መአነ	ርግ.
ማእን	ዘዘ.
መአን	ስ.
መአኅዝ	ስ.
መአከ	ኢግ.
ምኡክ	ቅ.
መከለ	ርግ.
ምኩል	ቅ.
መከረ	ርግ.
መካሪ	ቅ.
ምክር	ዘዘ.
ተመክረ	ተደ.አ.
ምኩር	ቅ.
ተማከረ	ተደ.አ.
መከረ	ርግ.
መካሪ	ቅ.
መከራ	ዘዘ.
ተመከረ	ተደ.አ.
ምኩር	ቅ.
መከር	ስ.
መከርክር	ስ.
መኰንን	ቅ.
መከየድ	ስ.
መኩረቢ	ስ.
መኵሲ	ቅ.
መካን	ቅ.
መካን	ስ.
መካነ ቅዱሳን	
መካነ ዕረፍት	
መካነ አራዊት 	
መካነ ሰብእ	
መክሊት	ስ.
መክሐ	ኢግ.
መካሒ	ቅ.
መካሕ	ቅ.
ተመክሐ	ግ.
ምኩሕ	ቅ.
ምክሕ	ዘዘ.
ትምክሕት	ምዘ.
መክሪት	ስ.
መክብብ	ባቅ.
መክነ	ግ.
መካን	ቅ.
ምክነት	ሳዘ.
መምክን	ባቀ.
መክኑን	ቅ.
መክድን	ባቅ.
መክፈልት	ስ.
መክፌ	ስ.
መወልጥ	ባዘ.
መዊት	ስ.
መዋርሕት	ስ.
መዋዕል	ስ.
መዋድህ	ስ.
መዋድድ	ስ.
መዓርግ	ስ.
መዓቅድ	ባዘ.
መዐደ	ርግ.
መዓዲ	ቅ.
ምዕዳን	ምዘ.
መዘረ	ርግ.
መዛሪ	ቅ.
ምዝር	ዘ.
መዝርእ	ስ.
መዘነ	ርግ.
መዛኒ	ቅ.
ተመዘነ	ተደ.አ.
ምዙን 	ቅ.
ሚዛን	ዘዘ.
መዘክር	ባቅ.
መዘ 	ርግ.
መዘዝ 	ዘዘ.
መዘይን	ቅ.
መዘገ	ርግ.
መዜንው	ባቅ.
መዝሐ	ኢግ.
ምዙሕ	ቅ.
መዝመዘ	ርግ.
መዝሙር	ስ.
መዝረብ	ስ.
መዝራዕት	ስ.
መዝርእ	ስ.
መዝበረ	ርግ.
መዝባሪ	ቅ.
መዝበር	ስ.
መዝገብ	ስ.
መዝግነ	ርግ.
ምዝጋና 	ዘዘ.
ተመዝገነ 	ተደ.አ.
ምዝጉን	ቅ
መዝግሕ	ስ.
መየነ	ርግ.
መኒያ	ቅ.
ተመየነ	(ተደ.አ.)
ምዩን	ቅ.
ምያኔ	ዘዘ.
መደልው	ባቅ.
መደረ	ኢ/ርግ.
ምድር	ስ.
ምድራዊ	ቅ.
መደብ	ስ.
መዲና	ስ.
መዳምሕ	ስ.
መድሐ	ርግ.
መድሔ	ስ.
መድረክ	ስ.
መድቅሐ	ርግ.
መድቅሕ	ቅ.
መድቅቅ	ስ.
መድበል	ስ.
መድበራ	ስ.
መድኃኒት 	ስ.
መዶኬ	ስ.
መገለ	ኢግ.
መግል	ዘዘ.
መገበ	ርግ.
መጋቢ	ቅ.
መጋቢት	ስ.
መገብት	መድ.ቅ.
ምግብ	ዘዘ.
ምግብና	ምዘ.
መገን	ስ.
መጕሥዕ	ስ.
መጕረብ	ስ.
መጕርይም 	ስ.
መጕረጽ	ስ.
መጋዝህ	ስ.
መጋዝዕ	ስ.
መግነዝ	ስ.
መግዝእ	ስ.
መጠራ	ስ.
መጠቀ	ርግ.
መጣቂ	ቅ.
ተመጥቀ 	ተደ.አ
ምጡቅ	ቅ.
ምጥቀት	ሳዘ.
መምጠቅ	ባዘ.
መጠብቅ	ቅ.
መጠነ	ርግ.
መጣኒ	ቅ.
መጠን	ዘዘ.
ተመጠነ 	ተደ.አ.
ምጡን	ቅ.
ምጣኔ	ዘዘ.
መጠነ	መዋ.
መጠወ	ርግ.
መጣዊ	ቅ.
ተመጠወ	ተደ.አ
ምጥው	ቅ.
ምጣዌ	ዘዘ.
መጠይቅ	ባቅ.
መጣዕው	ቅ.
መጥለውዝ	ስ.
መጥማዕ	ስ.
መጥረብሊስ	ስ.
መጥሮአሊስ	ስ.
መጥቅዕ	ስ.
መጥቅዐ ብሩር	
መጥባሕት	ስ.
መጸ	ግ.
መጸረ	ርግ.
መጸብሕ	ስ.
መጸብሓዊ	ቅ.
መጻውዕት	ስ.
መጽለወ	ግ.
ምጽልው	ቅ.
መጽበለ	ርግ.
መጽሐይይ	ስ.
መጽሐፍ	ስ.
መጽሔት	ስ.
መጽመድ	ስ.
መጽርይ	ስ.
መጽብሕ	ስ
መጽንሕ	ስ.
መጽአ	ኢግ.
መጻኢ	ቅ.
መምጽኢ	ባቅ.
ምጽአት	ሳዘ.
መጽአሞ	ስ.
መጽዕቅ	ቅ.
መጽዕን	ስ.
መጽያሕት	ስ.
መጺጽ	ቅ.
መጽፈርት	ስ.
መጾር	ስ.
መፀወ	ኢግ.
መፀው	ዘዘ.
መፀ	ኢግ.
መፂፅ	ዘዘ.
ምፀት 	ሳዘ.
መፅመር	ስ.
መፅምር	ስ.
ሙባዕ	ቅ.
ሙናህ	ስ.
ሙዝያሁ	ስ.
ሙዳሱጣ	ቅ.
ሙዳይ	ስ.
ሙዳየማይ	
ሙዳየኤርግ	
ሙዳየምጽዋት	
ሙጋእ	ስ.
ሙጻእ	ስ.
ሚ	ተስ.
ሚላቅ	ስ.
ሚልክያስ	ስ.
ሚካኤል	
ሚዐዝያ	ስ.
ሚዛን	ስ.
ማህለለ	ኢግ.
ምህላ	ዘዘ.
ማህረከ	ርግ.
ማህራኪ	ቅ.
ምህርካ	ዘዘ.
ተማህረከ	ተደ.አ.
ምህሩክ	ቅ.
ማህረጽ	ስ.
ማህዝን	ስ.
ማህው	ስ.
ማለወ	ርግ. 
ማሕሜ	ስ.
ማሕረስ	ስ.
ማሕየበ	ስ.
ማሪ	ቅ.
ማራ	ስ.
ማር	ቅ.
ማርቆስ	ተጸ.ስ.
ማርያም	ተጸ.ስ.
ማርያ	ተጸ.ስ.
ማስነ	ኢግ.
ማሳኒ/ሙሱን 	ቅ.
ሙስና	ዘዘ.
ማቴዎስ	ተጸ.ስ.
ማትያስ	ተጸ.ስ.
ማኅተም	ስ.
ማእሠር	ቅ.
ማእዜ	ተስ.
ማእድ	ስ.
ማእረር	ስ.
ማውታ	ስ.
ዕጓለ ማውታ	
ማዕለልት	ስ.
ማዕሌት	ስ.
ማዕሠርት	ስ.
ማዕረብት	ስ.
ማዕረተ	ርግ.
ማዕሰበ	ኢግ.
ማዓስብ 	ዘዘ.
ማዕስ	ስ.
ማዕበል	ስ.
ማዕነፍ	ስ.
ማዕኰት	ስ.
ማዕከክ	ስ.
ማዕክጥ 	ስ.
ማዕዶት	ስ.
ማዕገት	ስ.
ማዕፈርት	ስ.
ማይ	ስ.
ማየ ልብን	
ማየ ሕመት	
ማየ ሕይወት	
ማየ ዝናብ	
ማዮባሊ	ስ.
ማድጋ	ስ.
ማጎግ	ስ.
ሜላት	ስ.
ሜላኒ	ስ.
ሜላንትራ	ስ.
ሜላንትና	ስ.
ሜሎስ	ስ.
ሜመየ	ርግ.
ሜሰ	ግ.
መያሲ	ቅ.
ሜስ	ዘዘ.
ሜሮን	ስ.
ሜዓ	ስ.
ሜጥራ	ስ.
ምሁዝ	ቅ.
ምህላ	ስ.
ምህርካ	ስ.
ምህወ	ኢግ.
ምህው	ቅ.
ማህው	ስ.
ምሕራም	ስ.
ምሕፃብ	ስ.
ምሥራብ	ስ.
ምሥያም	ስ.
ምሥያጥ	ስ.
ምሥጢር	ስ.
ምራቅ	ስ.
ምራእ	ስ.
ምርስኔ	ስ.
ምርካብ	ስ.
ምርዓ	ስ.
ምርዓት	ሳዘ.
ምርያ 	ስ.
ምርፋቅ	ስ.
ምሳር	ስ.
ምስለ	መፃ.
ምስሌየ	
ምስሌነ	
ምስሌከ	
ምስሌክሙ	
ምስሌኪ	
ምስሌክን	
ምስሌሁ	
ምስሌሆሙ	
ምስሌሃ	
ምስሌሆን	
ምስል	ስ.
ምስሐል	ስ.
ምስሐግ	ስ.
ምስር	ስ.
ምስር	ስ.
ምስቁል	ቅ.
ምስካይ 	ቅ.
ምስክ	ስ.
ምቅማሕ	ስ.
ምቅዳኅ	ስ.
ምቅዳኅ ማይ	
ምቅዳኅ ወይን	
ምብኳህ	ስ.
ምናሴ	ተጸ.ስ
ማናን	ስ.
ምኔት	ስ.
ምንሐል	ስ.
ምንሐር	ስ.
ምንሐብ	ስ.
ምንት	ተሰ.
ምንት ውእቱ ዝንቱ	
ምንትኒ/ምንትሂ	
ኢታንሥእ ምንተኒ ነገረ ዘኢያንበርከ 	
ኢምንት 	
ምንዓው	ስ.
ምንዳቤ	ስ.
ምንዳድ	ስ.
ምትፋይ	ስ.
ምእመን	ቅ.
ምእኖ	ስ.
ምኮና	ስ.
ምዕራግ	ስ.
ምዕስብና	ስ.
ምዕቃል	ስ.
ምዕቅብና	ስ.
ምዕኖ	ስ.
ምዕከ	ኢግ.
ምዑክ	ቅ.
ምዕዘ	ኢግ.
መዓዛ	ዘዘ.
ምዑዝ	ቅ.
መዓዛ ጽጌ	
ምዕዳው 	ስ.
ምዝላል	ስ.
ምዝማር	ስ.
ምዝራቅ	ስ.
ምዝር	ስ.
ምዳቍ/ምዳቆ	ስ.
ምድር	ስ.
ምድረ ርስት	
ምድረገነት	
ምድቃስ	ስ.
ምጕህና	ስ.
ምጕባዕ	ስ.
ምግብ	ስ.
ምጣኔ	ዘዘ.
ምጽላል	ስ.
ምጽሐል	ስ.
ምጽናዕ	ስ.
ምጽንዓት	ስ.
ምጽንጋዕ	ስ.
ምጽዋት	ስ.
ሞሠርት	ስ.
ሞራእ	ስ.
ሞርቅሐ	ርግ.
ሞቀ	ኢግ.
ምውቅ	ቅ.
ሙቀት	ሳዘ.
ሙቀተ ፀሐይ	
ሞቅሐ	ርግ.
ሞቅሕ	ዘዘ.
ሙቁሕ	ቅ.
ሞዐ	ርግ.
መዋዒ	ቅ.
መዊዕ	ንአ.
ደብረ መዊዕ	
ሞገር	ስ.
ዕጣነ ሞገር 	
ሞገርት	ስ.
ሞገስ	ስ.
ግርማ ሞገስ	
ሞገድ	ስ.
ሞግእ	ስ.
ሞጥሐ	ርግ.
ሞጣሕት	ምዘ.
ሞጸፈ	ርግ.
ሞጸፍ	ዘዘ.
ሞጻሕት	ስ.
ሞጽሐ	ርግ.
ሞፀ	ርግ.
ሞፃ	ዘዘ.
ሞፈር	ስ.
ሞፈጥ	ስ.
ሠለሰ	ርግ.
ሠላሲ	ቅ.
አሠለሰ	አሰ.አ
መሠልስ	ቅ.
ተሠለሰ	ተደ.አ.
ሥሉስ	ቅ.
ሥላሴ	ዘዘ.
ትሥልስት	ባከዘ.
ተሥላስ	ባዘ.
ሠላስ	አን.ቅ.
ሠለስት/ሠለስቱ	ቅ.
ሠለስት 	ስ.
ሠሉስ	
ሣልስ/ሣልስት	ቅ.
ሣልሳዊ	ቅ.
ሣልሳይ	ቅ.
ሣልሳይት 	
ሣልሲት	
ሥልስ	
ሠላሳ	
ሥልሳ	
ሠለቀ	ኢግ.
ተሣለቀ 	ተዳ.አ.
መስተሣልቅ	ቅ.
ሥላቅ	ዘዘ.
ሠለጠ	ኢግ.
ሥሉጥ	ቅ.
ሥልጣን	ምዘ.
ሥልጣናዊ	ቅ.
ሥልጣኔ	ዘዘ.
ሠላጢን	ስ.
ሠሌዳ	ስ.
ሠምረ	ርግ.
ሠማሪ	ቅ.
አሥመረ	አስ.አ.
መሥመሪ	ቅ.
ተሠምረ	ተደ.አ.
ሥሙር	ቅ.
ሥምረት	ሳዘ.
መሥመር	ባዘ.
ሠሥዐ	ኢግ.
ሥሡዕ	ቅ.
ሥሣዔ	ዘዘ.
ሥሥዕት	ምዘ.
አሠሥዐ	አስ.አ.
አሠሣዒ	ቅ.
ሠረመ	ርግ.
ሠርም	ዘዘ.
ሠረረ	ኢግ.
ሥሩር	ቅ.
ሠረቀ	ኢግ.
ሥርቀት	ሳዘ.
ሠርቅ	ዘዘ.
ሠርቃዊ	ቅ.
ምሥራቅ	ባዘ.
ምሥራቃዊ	ቅ.
አሥረቀ	አስ.አ.
አሥርቆት	ምዘ.
ሠርቅ	ዘዘ.
ሠረበ	ርግ.
ሠርብ	ዘዘ.
መሥረብ	ባዘ.
ሠረከ	ርግ.
ሢራክ	ዘዘ.
ሠርክ	ዘዘ.
ሠረወ	ኢግ.
ሠርዌ	ዘዘ.
ሥርው	ዘዘ.
ሥርወሕሩም	
ሠረዘ	ርግ.
ሠረዝ	ዘዘ.
ሠረየ	ርግ.
ሠራዪ	ቅ.
መሠርይ	ቅ.
ሥራይ	ዘዘ.
መፍትሔሥራይ	
ሠረየ	ርግ.
ሠረጸ	ግ.
ሠራጺ	ቅ.
ሥሩጽ	ቅ.
ሠርጽ	ዘዘ.
አሥረጸ	አስ.አ.
አሥራጺ	ቅ.
ሠርሐ	ርግ.
ተሠርሐ	ተደ.አ.
ሥሩሕ	ቅ.
ሠርክ	ስ.
ሠውር	ስ.
ሠርዐ	ርግ.
ሠራዒ	ቅ.
ተሠርዐ	ተደ.አ.
ሥሩዕ	ቅ.
ሥርዓት	ምዘ.
ሥራዕ	ስ.
ሠርገለ	ርግ.
ሠረገላ	ስ.
ሠረገላዊ	ቅ.
ሠረገላምድር	
ሠረገላሰማይ	
ሠርገወ	ርግ.
ሠረጋዊ	ቅ.
ተሠርገወ	ተደ.አ
ሥርግው	ቅ.
ሥርጋዌ	ዘዘ.
ሠርጕ	ዘዘ.
ሠቀ	ርግ.
ሠቅ	ዘዘ.
ሠቅሠቀ	ርግ.
ተሠቅሰቀ	ተደ.አ
ሥቅሡቅ	ቅ.
ሠቅሠቅ	ዘዘ.
ሠበጠ  	ርግ.
አሥበጠ	አስ.አ.
ሥባጥ	ዘዘ.
ሠብሐ	ኢግ.
ሥቡሕ	ቅ.
ሥብሕ	ዘዘ.
አሥብሐ	አድ.አ.
አሥባሒ	ቅ.
ምሥባሕ	ባዘ.
ሠተረ	ርግ.
ተሠትረ	ተደ.አ
ሥቱር	ቅ.
መሥተር	ባዘ.
ሠትር	ዘዘ.
ሠነቀ	ርግ.
ሥንቅ	ዘዘ.
አሥነቀ	አስ.አ.
መሥነቂ	ቅ.
መሥነቅ/መሥነቅት 	ባዘ.
ሠነየ	ኢግ.
ተሠነየ	ተደ.አ
ሥኑይ	ቅ.
ቤተምሥናይ	
ሥን 	ዘዘ.
ሥነጽሑፍ	
ሥነቃል	
ሥነልቡና	
ሥነመንግሥት	
አሠነየ 	አስ.አ.
መሠነይ	ባቅ.
ሠንሰለ	ርግ.
ሠናስል	ዘዘ.
ሠአነ	ርግ.
ሥኡን	ቅ.
ሣእን	ዘዘ.
ሠከረ	ርግ.
ተሠክረ	ተደ.አ
ሥኩር	ቅ.
ሠክር	ዘዘ.
ሠወረ	ርግ.
ሠዋሪ	ቅ.
ተሠወረ 	ተደ. አ.
ሥዉር	ቅ.
መሠውር	ባቅ.
ሠወነ	ኢግ.
ሠዋኒ	ቅ.
ሠወን	ዘዘ.
ምሥዋን 	ባዘ.
ሠውር	ስ.
ሠወየ	ኢግ.
ሠዋዪ	ቅ.
ሥውይ	ቅ.
ሠዊት	ዘዘ.
ሥውየት	ሳዘ.
ሠዐለ	ርግ.
ሠዐሊ	ቅ.
ተሥዕለ	ተደ.አ
ሥዑል	ቅ.
ሥዕል	ዘዘ.
ሥዕለማርያም	
አሥዐለ	አስ.አ.
መሥዕል	ባቅ.
ሠዕዐ	ርግ.
ሥዓዕ	ዘዘ.
ሠዘየ	ርግ.
ተሠዝየ	ተደ.አ.
ሥዙይ	ቅ.
ሠየነ	ርግ.
ሠያኒ	ቅ.
ሥንት	ምዘ.
መሥያን	
ሠያጢ	ቅ.
ሠደየ	ርግ.
ሠዳሄ	ስ.
ሠገረ	ርግ.
ሠጋሪ	ቅ.
መሠግር	ባቅ.
መሥገርት 	ባከዘ.
ተሠግረ	ተደ.አ
ሥጉር	ቅ.
ሥግረት	ሳዘ.
ሠገር	ዘዘ.
ሠገራዊ	ቅ.
ሠገራ	ዘዘ.
ሠገወ	ኢግ.
ሥጋ	ዘዘ.
ሥጋዊ	ቅ.
ተሠገወ	ተደ.አ
ሥግው	ቅ.
ሥጋዌ	ዘዘ.
ትሥጉት	ባከዘ.
ሠግረ	ኢግ.
ሠጋሪ	ቅ.
ሠጋር	ቅ.
ሥግረት	ሳዘ.
አሥገረ	አስ.አ.
አሥጋሪ	ቅ.
ሠግር	ዘዘ.
ሠጠቀ	ርግ.
ተሠጥቀ	ተደ.አ.
ሥጡቅ	ቅ.
ሥጥቀት	ሳዘ.
ሠጠየ	ኢግ.
ሥጡይ	ቅ.
ሥጥየት	ሳዘ.
ሠጠጠ	ርግ.
ሠጣጢ	ቅ.
ተሠጠ	ተደ.አ
ሥጡጥ	ቅ.
ሥጠት	ሳዘ.
ሠጸረ	ርግ.
ተሠጽረ	ተደ.አ
ሥጹር	ቅ.
ሥጻር	ዘዘ.
ሡራሄ	ስ.
ሢመት	ስ.
ሢራክ	
ሣህል	ስ.
ሣህር	ስ.
ሣህበበ	ኢግ.
ሥህቡብ	ቅ.
ሣረረ	ርግ.
ሣራሪ	ቅ.
ሡራሬ	ዘዘ.
ተሣረረ	ተደ.አ
ሡሩር	ቅ.
ሣሬት	ስ.
ሣርኅ	ኢግ.
ሡሩኅ	ቅ.
ሡራሄ	ዘዘ.
ሣቀየ	ሥግ.
ሣቃዪ	ቅ.
መሥቄ	ዘዘ.
ተሣቀየ 	ተደ.አ
ሥቁይ	ቅ.
ሥቃይ	ዘዘ.
ሣኒታ	ስ.
ሣዕሥዐ	ኢግ.
ሥዕሡዕ	ቅ.
ሣዕሣዕ	ዘዘ.
ሥዕር	ስ.እሳር
ሣዕረማይ	ስ.
ሣጹን	ስ.
ሤመ 	ሥግ.
ሠያሚ	ቅ.
ተሠይመ 	ተደ.አ
ሥዩም	ቅ.
ሢመት	ምዘ.
ምሥያም	ባዘ.
ሤመት	ርግ.
ተሠይመተ	ተደ.አ
ሤሬቅ	ስ.
ሤቅ	ስ.
ሤበ	ኢግ.
ሠያብ	ቅ.
ሥዩብ	ቅ.
ሢበት	ዘዘ.
ሤጠ	ርግ.
ሠያጢ	ቅ.
ሤጥ	ዘዘ.
ምሥያጥ	ባዘ.
ምሥያጣዊ	ቅ.
ተሠይጠ	ተደ.አ.
ሥዩጥ	ቅ.
ሢጠት	ሳዘ.
ተሣየጠ	ተዳ.አ
ተሣያጢ	ቅ.
ሠያጢ ወተሣያጢ	
አስተሣየጠ	አዳ.አ.
መስተሣይጥ	ባቅ.
ሥህረ	ግ.
ሥህወ	ርግ.
ሥሕጸ	ርግ.
ሥሑጽ	ቅ.
ሥሕጸት	ስ.
ሥራብ	ስ.
ሥራይ	ስ.
ሥርሐት	ስ.
ሥርቆ	ስ.
ሥርናይ	ስ.
ሥርዋጽ	ስ.
ሥርግው	ቅ.
ሥርጋዌ	ስ.
ሥኅተ	ኢግ.
ሠኃቲ	ቅ.
ሥኅት	ቅ.
ሣኅት	ዘዘ.
አሥኅተ	አስ.አ.
አሥኃቲ	ቅ.
ሥእበ	ግ.
ሥኡብ	ቅ.
ሥእበት	ሳዘ.
ሥዕል	ስ.
ሥዕረ	ኢግ.
ሥዑር	ቅ.
ሥዕርት	ምዘ.
መሥዕርት	ባከዘ.
ሣዕር	ዘዘ.
ሦከ	ርግ.
ሦክ	ዘዘ.
ሦካዊ	ቅ.
ሦዐ	ርግ.
ሠዋዒ	ቅ.
ሣውዕ	ዘዘ.
ምሥዋዕ	ባዘ.
ተሦዐ	ተደ.አ.
ሥዉዕ	ቅ.
ሡዐት	ሳዘ.
መሥዋዕት	ባከዘ.
ሦጠ	ርግ.
ሠዋጢ	ቅ.
ተሠውጠ	ተደ.አ.
ሥውጥ	ቅ.
ሡጠት 	ሳዘ. 
ሦር	ስ.
ረሐን	ርግ.
ረሐኒ	ቅ.
ራሕን	ዘዘ.
ረመለ	ርግ.
ረምል	ዘዘ.
መርመሌ	ባዘ.
ረመ	ር/ኢግ.
አርመመ	አስ.አ
አርማሚ	ቅ.
መርምም	ባቅ.
መርመም	ባዘ.
አርምሞ	ዘዘ.
ተረመ	ተደ.አ
ርሙም	ቅ.
ረመየ	ርግ.
ረማዪ 	ቅ.
ርምየት	ምዘ.
ተረምየ 	ተደ.አ.
ርሙይ	ቅ.
ርምየት	ሳዘ.
ረመፀ	ርግ.
ረመፅ	ዘዘ.
ረምፅ	ዘዘ.
ረምሐ	ርግ.
ረምሕ	ዘዘ.
አርማሕ	ተጸስ.
ረምሓይ	ተጸስ.
ረምሰ	ርግ.
ረምስ	ዘዘ.
ረሥአ	ኢግ.
ርሡእ	ቅ.
ርሥአት	ሳዘ.
ርሥእ	ዘዘ.
ርሥኣን	ምዘ.
ርሥእና	ምዘ.
ረሰወ	ርግ.
ረሳዊ	ቅ.
መርስው	ባቅ.
መርሶ	ዘዘ.
መርስ	ዘዘ.
ረሰየ	ርግ.
ረሳዪ	ቅ.
ተረሰየ 	ተደ.አ.
ርሱይ	ቅ.
ትርሲት	ባከዘ.
ረስሐ	ኢግ.
ርሱሕ	ቅ.
ርስሐት 	ሳዘ.
ርስሕ	ዘዘ.
ረስነ	ኢግ.
ርሱን	ቅ.
ርስነት	ሳዘ.
ረስን	ዘዘ.
አርሰነ	አድ.አ
አርሳኒ 	ቅ.
ረስዐ	ርግ.
ረሲዕ	ቅ.
ራስዕ	ቅ.
ርስዐት	ሳዘ.
ተረስዐ	ተደ.አ.
ርሱዕ	ቅ.
ርስዓን	ምዘ.
ርስዕና	ምዘ.
አርስዐ	አስ.አ.
መርስዒ	ቅ.
ረቀመ	ርግ.
ረቃሚ	ቅ.
ረቀ	ኢግ.
ረቂቅ	ቅ.
ርቀት	ሳዘ.
አርቀቀ	አድ.አ.
ረቅ	ዘዘ.
ረቀየ	ርግ.
ረቃዪ	ቅ.
ተረቅየ	ተደ.አ.
ርቁይ	ቅ.
ርቅየት 	ሳዘ.
ምርቃይ	ባዘ.
መርቄ	ባዘ.
ረቅሐ	ርግ.
ረቅሕ	ዘዘ.
ረበ	ኢግ.
ረባቢ	ቅ.
መረብ	ባዘ.
አድገመረብ	
መርበብት	ባከዘ.
ተረበ	ተደ.አ
ርቡብ	ቅ.
ርበት	ሳዘ.
አርባብ	
ረቢ	
ረቡኒ	
ረብሐ	ር/ኢግ.
ረባሒ	ቅ.
ተረብሐ	ተደ.አ
ርቡሕ	ቅ.
ርባሕ	ዘዘ.
ርባሕ/ረብሕ	ዘዘ.
ርብሓዊ	ቅ.
ያርብሕ	ባቅ.
ያርብሓዊ	ቅ.
ረብዐ	ርግ.
ረባዒ	ቅ.
መርብዕት	ባከዘ.
ተረብዐ	ተደ.አ
ርቡዕ	ቅ.
ርባዔ	ዘዘ.
ሩባዔ	ዘዘ.
ትርብዕት	ባከዘ.
ረቡዕ	
ራብዕ	ዘዘ.
ራብዓዊ/ራብዓይ	ቅ.
አርባዕ	አን.ቅ
አርባዕት/አርባዕቱ	ተባ.ቅ.
አርባዕት	
አርብዓ	ባዘ.
አርብዓዊ	ቅ.
ረተመ	ርግ.
ረትዐ	ር/ኢግ.
ራትዕ	ቅ.
ርቱዕ	ቅ.
ርትዕ	ዘዘ.
አርትዐ	አስ.አ
አርታዒ	ቅ.
መርትዒ	ባቀ.
አስተራትዐ	አዳ.አ
መስተራትዕ	ባቀ.
ረአመ	ኢግ.
ረከበ	ርግ.
ረካቢ	ቅ.
ርካብ	ዘዘ.
መርከብ	ስ.
ተረክበ	ተደ.አ.
ርኩብ	ቅ.
ርክበት	ሳዘ.
ሩካቤ	ዘዘ.
ሩካቤሥጋ	ጥቃ.
ምርካብ	ባዘ.
አስተርከበ	አስ.አ.
እስትርኩብ	ቅ.
አስተራከበ	አዳ.አ.
ርኵስ	ኢግ.
ርኩስ	ቅ.
ርኵሰት	ሳዘ.
ርኵስና	ምዘ.
ርኵስ	ዘዘ.
አርኰሰ	አስ.አ.
ረወለ	ርግ.
ረወየ	ግ.
ረዋዪ	ቅ.
ርዉይ	ቅ.
ርውየት	ሳዘ.
ረዋሒ	ቅ.
ረዋዲ	ቅ.
ረዋጺ	ቅ.
ረውሕ	ስ.
ረውሐ	ርግ.
ረውሕ	ዘዘ.
ረዐመ	ኢግ.
ረዓም	ዘዘ.
ረዐየ	ርግ.
ረዓዪ	ቅ.
ረዓይት	ብቁ.
ረዓይታዊ	ቅ.
ተረዐየ	ተደ.አ.
ርዑይ	ቅ.
መርዐይ	ባዘ.
መርዔት	ባከዘ.
ረዝመ	ኢግ.
ረዛሚ	ቅ.
ርዙም	ቅ.
ርዝመት	ሳዘ.
ረመየ	ኢግ.
ራማ	ጥዘ.
አርያም	
አርያማዊ	ቅ.
ረየፀ	ርግ.
ረያፂ	ቅ.
ተረየፀ	ተደ.አ.
ርዩፅ	ቅ.
ረደየ	ርግ.
ረዳዪ	ቅ.
ተረድየ	ተደ.አ.
ተረዳዪ	ቅ.
ርዱይ	ቅ.
ርድየት 	ሳዘ.
ርዴ	ጥዘ.
ረዳ	ስ.
ጽጌረዳ	
ረድአ	ርግ.
ረዳኢ	ቅ.
መርድእ	ባቅ.
ረድእ	ዘዘ.
ተረድአ	ተደ.አ.
ርዱእ	ቅ.
ረድኤት	ምዘ.
ረድፈ	ርግ.
ረድፍ	ዘዘ.
ረገመ	ርግ.
ረጋሚ	ቅ.
መርገም	ባዘ.
ተረግመ	ተደ.አ.
ርጉም	ቅ.
ርግመት	ሳዘ.
ረገበ	ኢግ.
ርግብ	ዘዘ.
ረገነ	ርግ.
ረገነ	ግ.
ራግን/ረግን	ዘዘ.
ረጐነ	ኢግ.
ራጕናት	ስ.
ረገዘ	ርግ.
ተረግዘ	ተደ.አ.
ርጉዝ	ቅ.
ርግዘት	ሳዘ.
ተራገዘ	ተደራ.አ
ራግዝ	ስ.
ረገፀ	ርግ.
ረጋፂ	ቅ.
ተረግፀ	ተደ.አ.
ርጉፅ	ቅ.
ርግፀት	ሳዘ.
ተራገፀ	ተደራ.አ.
አስተራገፀ	አስ.አ.
ትርጋፅ	ባዘ.
መርገፅ	ባዘ.
ምርጋፅ	ባዘ.
ረግፈ	ኢግ.
ርጉፍ	ቅ.
መርገፍ	ባዘ.
ረግረገ	ኢግ.
ረግረግ	ዘዘ.
ረግዐ	ኢግ.
ርጉዕ	ቅ.
ርግዓት	ሳዘ.
አርግዐ	አሰ.አ
አርጋዒ	ቅ.
ርጉዕ	ቅ.
ረጠነ	ርግ.
ርጢን	ስ.
ረጥበ 	ኢግ.
ርጡብ	ቅ.
ርጥበት	ሳዘ.
ረፈቀ	ኢግ.
ረፋቂ	ቅ.
መርፈቅ	ባዘ.
ምርፋቅ	ባዘ.
ረፍአ	ግ.
ረፋኢ	ቅ.
ተረፍአ	ተደ.አ.
ርፉእ	ቅ.
ርፍአት	ሳዘ.
ርፍእ	ዘዘ.
መርፍእ	ባዘ.
ምርፋእ	ባዘ.
ሩካም	ስ.
ሩዝ	ስ.
ሩፋኤል	
ሪዶን 	ስ.
ራማ	ስ.
ራምሴ	
ራምኖን	ስ.
ራስ	ስ.
ራኅርኅ	ቅ.
ርኅራኄ	ጥዘ.
አራኅርኅ	አስ.አ.
ራኩል	ስ.
ራኩብ	ስ.
ራዛ	ስ.
ራጉኤል	
ራግሄ	ስ.
ራግማ	ስ.
ራግናት 	ስ.
ራፋ	ስ.
ርህደ	ኢግ.
ራህድ	ዘዘ.
ርሕስ	ኢግ.
ርሑስ	ቅ.
አርሐሰ	አስ.አ.
አርሓሲ	ቅ.
ምርሓስ	ባዘ.
ርሕቀ	ኢግ.
ረሓቂ	ቅ.
ርሑቅ	ቅ.
ርሕቀት	ሳዘ.
ርሕቅና	ምዘ.
አርሐቀ	አስ.አ
መርሓቂ	ባቅ.
መርሕቅ	ባቅ.
ተራሐቀ	ተደራ.አ.
ርሕበ	ኢግ.
ርሒብ	ቅ.
ርሕብ	ዘዘ.
አርሐበ	አስ.አ
አርሓቢ	ቅ.
መርሕብ	ባዘ.
ርሕየ	ግ.
ረሓዪ	ቅ.
ርሔ	ዘዘ.
ርሕፀ	ር/ኢግ.
ርሑፅ	ቅ.
ራሕፅ	ዘዘ.
ርሳስ	ስ.
ርኅበ	ኢግ.
ርኁብ	ቅ.
ረኅብ	ዘዘ.
አርኅብ	ባቅ.
ርኅወ	ርግ.
ረኅዊ	ቅ.
ተርኅወ	ተደ.አ
ርኅው	ቅ.
አርኅወ	አሰ.አ.
አርኅዊ	ቅ.
መርኆ	ባዘ.
ርኤም	ስ.
ርእሰ	ኢግ.
ርኡስ	ቅ.
ርእስርኡሳን	
ርእስና	ምዘ.
ተርእሰ	ተደ.አ
ትርኣስ	ዘዘ.
ርእየ	ግ.
እር. ይሬኢ	
ይርአይ	ዘአ.
ርእይ/ርእዮት	
ራኣዪ	ቅ.
ራኣይ	ዘዘ.
ራእይ	ዘዘ.
አርአየ/አስተርአየ	አስ.አ.
አርኣያ	ዘዘ.
ተርእየ	ተደ.አ.
ርኡይ	ቅ.
ርእየት	ሳዘ.
ምርኣይ	ባዘ.
ርኵ	ስ.
ርዕወ	ርግ.
ረዓዊ	ቅ.
አርዐወ	አስ.አ
አርዑት	ምዘ.
ርዕደ	ኢግ.
ርዑድ	ቅ.
ረዓድ	ዘዘ.
አርዐደ	አሰ.አ.
መርዕድ	ባቅ.
ርጢን	ስ.
ሮሐ 	ግ.
ረዋሒ	ቅ.
ረውሕ	ዘዘ.
መረውሕ	ባዘ.
መርዋሕት	ባከዘ.
ምርዋሕ	ዘዘ.
ሮማን	ስ.
ሮማይስጥ	
ሮሜ	ስ.
ሮም	ስ.
ሮምያ	ስ.
ሮሰ	ርግ.
ሮሳ	ስ.
ሮቤል	ተጸ.ስ.
ሮዛ	ስ.
ሮደ	ርግ.
ረዋዲ	ቅ.
ተረውደ	ተደ.አ
ርውድ	ቅ.
ሩደት	ሳዘ.
ሮዳስ	ስ.
ሮጸ	ኢግ.
ረዋጺ	ቅ.
ሩጸት	ሳዘ.
አሮጸ	አስ.አ.
ምርዋጽ	ባዘ.
ሰለመ	ኢግ.
አስለመ	አድ.አ
እስላም	ዘዘ.
መስልም	ባቀ.
መስልማዊ	ቅ.
ተሳለመ	ተደራ.አ.
ሱላሜ	ዘዘ.
ሰላም	ዘዘ.
ሰላማዊ	ቅ.
አስተሳለመ	አደራ.አ.
መስተሳልም	ባቀ.
ሰላማ	ተጸ.ስ.
ስለቀ	ርግ.
ስለበ	ርግ.
ሰላቢ	ቅ.
ተሰለበ	ተደ.አ.
ስሉብ	ቅ.
ስልበት	ሳዘ.
ስለተ	ርግ.
ሰላቲ	ቅ.
ስላት	ዘዘ.
ስልት	ዘዘ.
ስለከ	ኢግ.
ስልክ 	ዘዘ.
ስለደ	ኢግ.
ሰለጠ	ርግ.
ሰላጢ	ቅ.
መስለጥ	ባቅ.
ሥላጤ	ዘዘ.
ተስልጠ	ተደ.አ
ስሉጥ	ቅ.
ስለፈ	ኢግ.
ስልፍ	ዘዘ.
ስለፐ	ርግ.
ስሊፕ	ዘዘ.
ሰሊሆም	ስ.
ሰሊሆት	ስ.
ሰሊክ	ስ.
ሰላምሂ	ስ.
ሰላም	ስ.
ሰልሞን	ስ.
ሰልፕ	ስ.
ሰሎሜ	ተጸ.ስ.
ሰሎሞን	ተጸ.ስ.
ሰሐለ	ርግ.
ሰሓሊ	ቅ.
ተስሕለ	ተደ.አ
ስሑል	ቅ.
ምስሓል	ባዘ.
ስሕለት	ሳዘ.
ሰሐቀ	ዘዘ.
ሰሐበ	ርግ.
ሰሓቢ	ቅ.
አስሐበ	አስ.አ.
መስሕብ	ባቅ.
ተስሕበ	ተደ.አ.
ስሑብ	ቅ.
ስሕበት	ሳዘ.
ምስሓብ	ባዘ.
ሰሐተ	ኢግ.
ሳሕት	ዘዘ.
ሰሐገ	ኢ/ርግ.
ሰሓጊ	ቅ.
ምስሓግ	ባዘ.
ሰሐጠ	ርግ.
ሰሓጢ	ቅ.
ተስሕጠ	ተደ.አ
ስሑጥ	ቅ.
ስሕጠት	ሳዘ.
ሰሐጰ	ርግ.
ስመነ	ርግ.
ሰማኒ	ቅ.
ሰማኒቱ	ቅ.
ሰማኒቱ እንስት 	
ስመንቱ 	
ስመንቱ ዕደው	
ተሰመነ	ተደ.አ.
ስሙን	ቅ.
ስምን	ዘዘ.
ሰሙን	ቅ.
አመሰሙን ዕለት	
ሳምን/ሳምንት	ቅ.
ሳምናዊ/ሳምናይ 	ቅ.
ሳምናዊት/ሳምናዪት/ሳምኒት	ቅ.
ሰመን	ስ.
ሳምኒት	ስ.
ሰማኒያ	ስ.
ሰሜን	ስ.
ስምከ	ርግ.
ሰማኪ	ቅ.
ስሙክ	ቅ.
ስምከት	ሳዘ.
አስመከ	አስ.አ
ምስማክ	ባዘ.
ሰመክ	
ሰመዘ	ርግ.
ሰማዝ	ዘዘ.
ሰመየ	ርግ.
ሰማዪ	ቅ.
ተሰምየ	ተደ.አ.
ስሙይ	ቅ.
ስም	ዘዘ.
ስማዊ	ቅ.
ሰማያዊ	ቅ.
ሰመጥ	ስ.
ሰምረ	ኢግ.
ስሙር	ቅ.
ስምር	ዘዘ.
አስመረ	አስ.አ.
አስማሪ	ቅ.
ሰምዐ	ርግ.
ስማዒ	ቅ.
ሰማዕት	ቅ.
ተስምዐ	ተደ.አ.
ስሙዕ	ቅ.
ስምዓት	ሳዘ.
ስምዕ	ዘዘ.
ስማዔ	ዘዘ.
አስምዐ	አስ.አ.
መስምዕ	ባቅ.
መስማዕ	ባዘ.
ሰምዕ	ስ.
ሰረሰር	ስ.
ሰረቀ	ርግ.
ሰራቂ	ቅ.
ተሰርቀ	ተደ.አ.
ስሩቅ	ቅ.
ስርቀት	ሳዘ.
ሰርቅ	ዘዘ.
ስረበ	ኢግ.
ሰርብ	ዘዘ.
ሰረወ	ርግ.
ሰራዊ	ቅ.
ሰራዌ	ዘዘ.
ሰረየ 	ርግ.
ሰራዪ	ቅ.
ተሰርየ	ተደ.አ.
ስሩይ	ቅ.
ስርየት	ሳዘ.
አስተሰረየ 	አስ.አ.
መስተሰረይ	ባቅ.
ሰረገ	ርግ.
ሰራጊ	ቅ.
ሰርግ	ዘዘ.
ሰረፈ	ርግ.
ሰራፊ	ቅ.
መስረፍ	ባዘ.
ሱራፊ	ስ.
ሱራፌል/ሱራፌም/ሱራፌን	
ሰራሲሮት	ስ.
ሰራግልዮን	ስ.
ሰርሐ	ርግ.
ሰራሒ	ቅ.
ስሩሕ	ቅ.
ስራሕ	ዘዘ.
አስርሐ	አስ.አ
መስርሕ	ባቅ.
ሰርን	ስ.
ሰርበብት	ስ.
ሰርኔስ	ስ.
ሰርኖስ	ስ.
ሰርዌ	ስ.
ስርድዮን	ስ.
ሰርጣን 	
ሰሰለ	ኢግ.
ሰሳሊ	ቅ.
ስሱል	ቅ.
ስሳሌ	ዘዘ.
አሰሰለ	አስ.አ.
አሰሳሊ	ቅ.
መሰስል	ባቀ.
ሰሰነ	ርግ.
ሰሳኒ	ቅ.
ስሰን	ዘዘ.
ሰስአ	ኢግ.
ስሱእ	ቅ.
ስስኣ	ዘዘ.
ሰቀለ	ርግ.
ሰቃሊ	ቅ.
ተሰቅለ	ተደ.አ.
ስቁል	ቅ.
ስቅለት	ሳዘ.
መስቀል	ባዘ.
ሰቀላ	ስ.
ሰቀመ	ርግ.
ሰቄማ	ዘዘ.
ስቈረ	ርግ.
ሰቋሪ	ቅ.
ተሰቍረ	ተደ.አ.
ስቁር	ቅ.
ስቍረት	ሳዘ.
መስቈር	ባዘ.
መስቀር	ስ.
ሰቈቀወ	ኢግ.
ሰቈቃው	ዘዘ.
አስቈቀወ	አስ.አ.
ሰቀየ	ርግ.
ሰቃዪ	ቅ.
ተሰቅየ	ተደ.አ.
ስቁይ	ቅ.
ስቅየት	ሳዘ.
መስቄ	ባዘ.
ሰቂኖን	ስ.
ሰቄዘር 	ስ.
ሰቅል	ስ.
ሰቅሰቅ	ስ.
ሰቅሱቅ	ስ.
ሰቅ	ስ.
ሰቆራር	ስ.
ሰበረ	ርግ.
ሰባሪ	ቅ.
መስብር	ባቅ.
ተሰበረ	ተደ.አ
ስቡር	ቅ.
ስብረት	ሳዘ.
ስባር	ዘዘ.
ሰበርት 	ስ.
ሰበቀ	ርግ.
ሰባቂ 	ቅ.
ሰበቅታኒ	
ሰበበ	ርግ.
ሰባቢ	ቅ.
ሰበብ	ዘዘ.
ሰበን	ስ.
ሰብከ	ርግ.
ሰባኪ	ቅ.
ተሰብከ	ተደ.አ.
ስቡክ	ቅ.
ስብከት	ሳዘ.
ስብከተጌና	
ሰበከ	ርግ.
ሰባኪ	ቅ.
ተሰበከ	ተደ.አ.
ስቡክ	ቅ.
ስብኮ	ዘዘ.
መስብክ	ባዘ.
ሰብለ	ኢግ.
ሰብል	ዘዘ.
መስበልት	ባከዘ.
ስብሐ	ርግ.
ሰባሒ	ቅ.
ተሰብሐ	ተደ.አ.
ስቡሕ	ቅ.
ስባሔ	ዘዘ.
ስብሐት	ምዘ.
ሰበሰበ	ርግ.
ሰብሳብ	ዘዘ.
ሰብእ	ዘዘ.
ሰብአቤት	
ሰብአዓይን 	
ሰብአሐጽ	
ሰብአአፍራስ	
ሰብአምሥያጥ	
ሰብአዜና	
ሰብአ ኢትዮጵያ 	
ሰብኣዊ	ቅ.
ሰብእና	ምዘ፣
ተሰብአ	ተደ.አ.
ስቡእ	ቅ.
ትስብእት	ምዘ.
ሰብዐ	ርግ.
ሰባዓ	ቅ.
መስብዓ	ቅ.
ተሰብዐ	ተደ.አ.
ስቡዕ	ቅ.
ስባዔ	ዘዘ.
ስቡዑ	አን.ቅ.
ሰብዑ አንስት	
ሰብዐቱ	(ት) ተባ.ቅ.
ሰቡዕ	
ስቡዑ	ቅ.
ሱባዔ	ዘዘ.
ሳብዕ	ቅ.
ሳብዓዊ	ቅ.
ሰብዕ	
ምስብዒት	
ትስብዕት	
ሰብዓ	
ሰብዕ/ሰብዓት	
ሰብድዓት	ስ.
ሰቦ	ስ.
ሰተረ	ርግ.
ሰተመ	ኢግ.
ሰተረ	ርግ.
ሰታሪ	ቅ.
ሰተተ	ኢግ.
ስቱት	ቅ.
አስተተ	አድ.አ.
መስተቲ	ቅ.
ሰትዐ	ኢግ.
አስትዐ	አስ.አ.
አስትዓ	ዘዘ.
ሰትየ 	ርግ.
ስታዪ	ቅ.
ተሰትየ	ተደ.አ.
ስቱይ	ቅ.
ስትየት	ሳዘ.
ስቴ	ዘዘ.
ስታይ	ዘዘ.
አሰተየ	አስ.አ.
አስታዪ	ቅ.
ምስታይ	ባዘ.
ሰት	ስ.
ሰኅነ	ኢግ.
ስኁን	ቅ.
ስኂን	ዘዘ.
አስኅነ	አስ.አ.
መስኅንት	ባከዘ.
ሰነመ	ኢግ.
ስናም	ዘዘ.
ሰነቀ	ግ.
ስንቅ	ዘዘ.
ሰነነ	ግ.
ሰናኒ	ቅ.
መስንን	ባቅ.
ተሰነ	ተደ.አ.
ስኑን	ቅ.
ስን	ዘዘ.
ተሳነነ	ተዳ.አ.
ተስናን	ዘዘ.
አስተሳነነ	አዳ.አ.
መስተሳንን	ባቅ.
ሰነወ	ርግ.
መስኖ	ባዘ.
ሰነየ	ርግ.
ሳንይ	ቅ.
ሳኒት	ቅ.
ሳኒታ	ስ.
ስኑይ	
ሰነጸ	ርግ.
ሰናጺ	ቅ.
ተሰነጸ	ተደ.አ.
ስኑጽ	ቅ.
ሰናፊል	ስ.
ሰኔ	ስ.
ስንሆተ	ርግ.
ሰንሐ	ግ.
ስኑሕ	ቅ.
ስንሐት	ሳዘ.
ሰንሰለ	ርግ.
ሰናስል	ዘዘ.
ሰንሰሪቅ	ስ.
ሰንቀወ	ርግ.
ሰንቃዊ	ቅ.
መሰንቆ	ባዘ.
መሰንቃዊ	ባቅ.
ተሰንቀወ	ተደ.አ.
ስንቃዌ	ዘዘ.
ሰንበል	ስ.
ሰንበልት	ስ.
ሰንበተ	ግ.
ሰንበት	ዘዘ.
ሰንበተ አይሁድ	
ሰንበተእሑድ	
ሰንበታዊ	ቅ.
ሰንቡዕ	ስ.
ሰንቢል	ስ.
ሰንብዑ	ስ.
ሰንቡላ	ስ.
ሰንተው	ስ.
ሰንአለ	ርግ.
ስንአሌ	ዘዘ.
ተሰንአለ	ተደ.አ.
ሰንአ	ርግ.
ስንእ	ዘዘ.
ሰንአወ	ርግ.
ተሰንአወ	ተዳአ.
ተሰንኣዊ	ቅ.
ስንእው	ቅ.
ስንአዌ	ዘዘ.
ሰንከተ	ርግ.
ሰንኮሪስ	ቅ.
ሰንደል 	ስ.
ሰንደቅ	ስ.
ሰንዱን	ስ.
ሰንድሮስ	ስ.
ሰንጐጐ	ርግ.
ስንጐጕ	ዘዘ.
ሰንፔር	ስ.
ሰአለ	ርግ.
ሰኣሊ	ቅ.
ሰአልት	መድ.ቅ.
ምስኣል	ባቅ.
ተስእለ	ተደ.አ.
ስኡል	ቅ.
ስእለት	ሳዘ.
አስአለ	አስ.አ.
አስኣሊ	ቅ.
ሰአበ	ግ.
ሰከለ	ርግ.
አስካል	ባዘ.
ሰከመ	ርግ.
ሰካሚ	ቅ.
ተሰክመ	ተደ.አ.
ስኩም	ቅ.
ስክመት	ሳዘ.
ሰክም	ዘዘ.
አስከመ	አስ.አ
መስክም	ባቅ.
ምስካም	ባቅ.
ሰኰሰ	ኢግ.
ሰከበ	ኢግ.
ሰካቢ	ቅ.
ስኩብ	ቅ.
ስክበት	ሳዘ.
አስከበ	አስ.አ.
መስከቢ	ቅ.
መስክብ	ቅ.
ምስካብ	
ሰኰተ	ኢግ.
ስኰት	ስ.
ስከነ	ኢግ.
ሰኮና	ዘዘ.
ሰከወ	ር.ግ.
መስኮት	ባዘ.
ሰከዘ	ርግ.
ሰኬዛ	ዘዘ.
ሰከየ	ርግ.
ሰካዪ	ቅ.
መስክይ	ባቅ.
ተሰከየ	ተደ.አ.
ስኩይ	ቅ.
ስክየት	ሳዘ.
ምስካይ	ባዘ.
ሰኪኖን	ስ.
ሰክረ	ኢግ.
ሰካሪ	ቅ.
ስኩር	ቅ.
ስክረት	ሳዘ.
ስካር	ዘዘ.
ሰክር	ዘዘ.
ተሳከረ	ተደ.አ
ሰክየት	ርግ.
ተሰካተየ	ተዳ.አ.
ስክታይ	ዘዘ.
ሰክዐ	ርግ.
ሰካዒ	ቅ.
ተስክዐ	ተደ.አ.
ስኩዕ	ቅ.
ስኵዐ	ርግ.
ሰኳዒ	ቅ.
ተሰክዐ	ተደ.አ.
ስኩዕ	ቅ.
ስኵዐ	ርግ.
ሰኳዒ	ቅ.
ሰካዕር	ስ.
ሰኳዕት	ስ.
ሰኮሞ	ስ.
ሰኰት	ስ.
ስኰተ ተመስቀል	
ስኮና	ስ.
ሰወረ	ርግ.
ሰዋሪ	ቅ.
መስውር	ቅ.
ተሰወረ	ተደ.አ.
ስውር	ቅ.
ስዋሬ	ዘዘ.
ሰወነ	ርግ.
ሰወን	ዘዘ.
ሰወየ	ኢግ.
ሰዊት	ባዘ.
ሰወጠ	ርግ.
ሰውጥ	ዘዘ.
ሰውር	ስ.
ሰውሰወ	ርግ.
ሰዋሰው	ዘዘ.
ሰዐለ	ኢግ.
ሰዓል	ዘዘ.
ሰዐመ	ርግ.
ሰዓሚ	ቅ.
ተስዕመ	ተደ.አ.
ስዑም	ቅ.
ተሳዐመ	ተዳ.አ.
ስዕመት	ሳዘ.
ሰዐረ	ርግ.
ሰዓሪ	ቅ.
ተስዕረ	ተደ.አ.
ስዑር	ቅ.
ስዕርት	ሳዘ.
ሰዐወ	ኢግ.
ሰዓ	ዘዘ.
ሳዕ	ዘዘ.
ሰዓት/ሰዐት	ምዘ.
ሰዐደ	ኢግ.
ሰዓዲ	ቅ.
ሰዘረ	ርግ.
ስዝር	ዘዘ.
ሰየፈ	ርግ.
ሰያፊ	ቅ.
ሰይፍ	ዘዘ.
ሰዐየ	ርግ.
መስዔ	ባዘ.
ሰያሕ	ስ.
ሰደል	ስ.
ስይቀል	ስ.
ሰይ	ተግ.
ሰይልየ	
ሰይለከ	
ሰይጥነ	ርግ.
ስይጣን 	ዘዘ.
ስይጣናዊ	ቅ.
ሳጥና 	ስ.
ሳጥናኤል	
ሰደረ	ርግ.
ሳዶር	ዘዘ.
ሰደሰ	ርግ.
ሰዳሲ	ቅ.
ተሰደሰ 	ተደ.አ.
ስዱስ	ቅ.
ስድስቱ	ተባ.ቅ.
ስድሱ	አን.ቅ.
ስዳሴ	ዘዘ.
ስዱስ	የዕ.ቅ.
ስድስ	
ሳድስ	ቅ.
ሳድሳዊ	ቅ.
ሳድሳይ	ተባ.ቅ.
ሳድሲት	አን.ቅ.
ስድሳ	ስ.
ሰደቀ	ርግ.
ሰዳቂ	ቅ.
ተሰደቀ	ተደ.አ.
ስዱቅ	ቅ.
ሰደቃ	
ስድቅ	ዘዘ.
ሳዶቅ	ተጸ.ስ.
ሰዱቃዊ	ቅ.
ሰደየ	ርግ.
ሰዳዪ	ቅ.
ሻዳይ	
ኤልሻዳይ	
ሰደደ	ርግ.
ሰዳዲ	ቅ.
ተሰደ	ተደ.አ.
ስዱድ	ቅ.
ስደት	ሳዘ.
ሰደፍ	ስ.
ሰድሉ	ስ.
ሰዶም	ስ.
ሰዶማዊ	ቅ.
ሰገለ	ኢግ.
አስገለ	አስ.አ.
አስጋሊ	ቅ.
ሰገል	ዘዘ.
ሰገላዊ	ቅ.
ሰግላ	ዘዘ.
ሰገመ	ርግ.
ሰጋሚ	ቅ.
ተሰግመ	ተደ.አ.
ስጉም	ቅ.
ስግመት	ሳዘ.
ሰገም	ስ.
ሰገነ	ኢግ.
ሰጋኒ	ቅ.
ሰገኖ	ስ.
ሰገነት	ምዘ.
ሰገደ	ኢግ.
ሰጋዲ	ቅ.
ስጉድ	
ስግደት	ሳዘ.
አስገደ	አስ.አ.
ምስጋድ	ባቅ.
ተሰግደ	ተደ.
ሰግላ	ስ.
ሰግላጥ	ስ.
ሰግም	ስ.
ሰጕዐ	ርግ.
ሰጠረ	ርግ.
ምስጢር	ባዘ.
ምሥጢራዊ	ቅ.
ሰጠቀ	ርግ.
ሰጣቂ	ቅ.
ስጥቀት	ሳዘ.
ሰጠወ	ርግ.
ሰጣዊ	ቅ.
መሰጥው	ባቅ.
ተሰጥወ	ተደ.አ.
ስጥው	ቅ.
ተሰጣዊ	ቅ.
ስጥወት	ሳዘ.
ስጣዌ	ዘዘ.
ተሰጥዎ	ዘዘ.
ሰጠየ	ርግ.
ሰጠጠ	ርግ.
ሰጣጢ	ቅ.
ተሰጠ	ተደ.አ.
ስጡጥ	ቅ.
ስጠት	ዘዘ.
ሰጠጵዮን	ስ.
ሰጡቃሌ	ስ.
ሰጢን	ስ
ሰጥሐ	ርግ.
ሰጣሒ	ቅ.
መሰጥሕ	ባቅ.
መስጥሕ	ስ.
ስጥሐት	ሳዘ.
ምስጣሕ	ባዘ.
ሰጥመ	ግ.
ስጡም	ቅ.
ስጥመት	ሳዘ.
አሰጠመ	አስ.አ.
መስጥም	ባቅ.
ሰጥረጲሎን	ስ.
ሰጦሱስ	ስ.
ሰጰለክስ	ስ.
ሰጲራ	ስ.
ሰፈለ	ርግ.
ሰፋሊ	ቅ.
ሰፈረ	ርግ.
ሰፋሪ	ቅ.
አሰፈረ	አስ.አ.
ተሰፍረ	ተደ.አ.
ስፉር	ቅ.
ስፍረት	ሳዘ.
ስፍር	ዘዘ.
መስፈርት	ባከዘ.
ሰፈር	ዘዘ.
ምስፍር	ባቅ.
ሰፈርኮል	ስ.
ሰፈርጐል	ስ.
ሰፈነ	ኢግ.
ሰፋኒ	ቅ.
ስፉን	ቅ.
መስፍን	ባዘ.
ምስፍና	ምዘ.
አሰፈነ	አስ.አ.
ሰፈወ	ርግ.
ሰፋዊ	ቅ.
ተሰፈወ	ተደ.አ.
ስፍው	ቅ.
ተስፋ	ባዘ.
አስፈወ	አስ.አ.
ሰፈየ	ርግ.
ሰፋዪ	ቅ.
መስፌ	ባዘ.
ተሰፍየ	ተደ.አ.
ስፉይ	ቅ.
ስፍየት	ሳዘ.
ምስፋይ	ባዘ.
ሰፈደ	ኢግ.
ሰፋዲ	ቅ.
ሰፌድ	ስ.
ሰፈጠ	ርግ.
ሰፋጢ	ቅ.
ተሰፍጠ	ተደ.አ.
ስፉጥ	ቅ.
ስፍጠት	ሳዘ.
ምስፋጥ	ባቅ.
ሰፈፈ	ኢግ.
ስፉፍ	ቅ.
ሰፈፍ	ዘዘ.
ሰፊሮስ 	ስ.
ሰፋድል	ስ.
ሰፌልያ	ስ.
ሰፍሐ	ርግ.
ተስፍሐ	ተደ.አ.
ስፉሕ	ቅ.
ስፍሐት	ሳዘ.
ስፍሕ	ዘዘ.
ምስፋሕ	ባዘ.
ሰፍነግ	ስ.
ሰፒራ	ስ.
ሱላሚ	ስ.
ሱላማጢስ	ቅ.
ሱራፊ	ስ.
ሱራፌል	
ሱርስት	ስ.
ሱርትዮን	ስ.
ሲሃት	ቅ.
ሱራጌ	ስ.
ሱስናብራ	ስ.
ሱዕ	ስ.
ሱጡቃጢስ	ስ.
ሱፋሔ	ስ.
ሲላን	ስ.
ሲሎንዲስ	ስ.
ሲህ	ስ.
ሲርኖን	ስ.
ሲሮብ	ስ.
ሲሲት	ስ.
ሲሳይ	ስ.
ሲበት	ስ.
ሲባ	ስ.
ሲናዲቆን	ስ.
ሲኖዶስ	ስ.
ሲኦል	ስ.
ሳሌም	ስ.
ንጉሠ ሳሌም	
ሳሕስሐ	ኢግ.
ሳሕሳሕ	ቅ.
አንሳሕስሐ	አስ.አ.
አንሳሕሳሒ	ቅ.
ነሰሕሳሕ	ዘዘ.
ሳሕበበ 	ግ.
ስሕቡብ	ቅ.
ሳሙን	ስ.
ሳሜን	ስ.
ሳሙኤል	ተጸስ.
ሳቀየ	ርግ.
ስቃይ	ዘዘ.
ሳባ	ስ.
ሳቤቅ	ስ.
ዕፀሳቤቅ	ስ.
ሳተፈ	ርግ.
ሳታፊ	ቅ.
ተሳተፈ	ተዳ.አ.
ተሳታፊ	ቅ.
ሱቱፍ	ቅ.
ሱታፌ	ዘዘ.
አስተሳተፈ	አስ.አ.
መስተሳትፍ	ባቅ.
ሳውዕ	ስ.
ሳዓ	ስ.
ሳዓር	ስ.
ሳዕስዐ	ኢግ.
ሳዕሳዕ	ቅ.
ሳይዳ	ስ.
ሳጥናኤል	ስ.
ሴሐ	ር/ኢግ.
ሰያሒ	ቅ.
ሰያሕ	ቅ.
ሲሕ	ስ.
ስያሕ	ዘዘ.
ሴም	ተጸ.ሰ.
ነገደ-ሴም	
ሴማዊ	
ሴረተ	ርግ.
ሴረከ	ኢግ.
ሲራክ	ስ.
ሴረየ	ርግ.
ሲሩይ	ቅ.
ሲራይ	ስ.
ሴሩግ	ስ.
ሴሮሕ	ስ.
ሴሰየ	ርግ.
ሴሳዪ	ቅ.
መሴሰይ	ባቅ.
ተሴሰየ	ተደ.አ.
ሲሱይ	ቅ.
ሲሳይ	ዘዘ.
ሲሲት	ምዘ.
ሴበ	ኢግ.
ሰያቢ	ቅ.
ሰያብ	ቅ.
ሲበት	ምዘ.
ሴኔስሮስ	ስ.
ሴክል	ስ.
ስህከ	ግ.
ስህየ	ርግ.
ስላቅ	ስ.
ስሕተ	ኢግ.
ሰሓቲ	ቅ.
ተስሕተ	ተደ.አ.
ስሑት	ቅ.
ስሕተት	ሳዘ.
አስሐተ	አስ.አ.
አስሐቲ	ቅ.
መስሐቲ	ባቅ.
መስሕት	ባቅ.
ስሕከ	ኢግ.
ስሑክ	ቅ.
ስሕከት	ሳዘ.
ሳሕክ	ዘዘ.
ስሕወ	ሥግ.
ሰሓዊ	ቅ.
ሳሕው	ዘዘ.
አስሐወ	አስ.አ.
አስሓዊ	ቅ.
ስሕጠ	ርግ.
ሰሐጢ	ቅ.
ስመጥ	ስ.
ስማኅ	ስ.
ስማዝያሁ	ስ.
ስርወኅሩም	ስ.
ስብሐት	ስ.
ስብዓት	ስ.
ስኂን	ስ.
ስናም	ቅ.
ስናም	ቅ.
ስናፔ	ስ.
ስንሕ	ስ.
ስን	ስ.
ስንካዕሩር	ስ.
ስንክሳር	
ስንዳሌ	ስ.
ቤተ ስንዳሌ	ስ.
ስኖባር	ስ.
ስእርት	ስ.
ስእነ	ኢግ.
ስኡን	ቅ.
ስእነት	ሳዘ
ስዕበ	ግ.
ስዑብ	ቅ.
ስዕበት	ሳዘ.
ስጋድ	ስ.
ስጕርድ	ስ.
ስጥየት 	ስ.
ስፋሪዳ	ስ.
ስፍን	ተው.ስ
ሶመን	ስ.
ሶም	ስ.
ሶራ	ስ.
ሶር	ስ.
ሶርቃ	ስ.
ሶርዮን	ስ.
ሶስን	ስ.
ሶስወ	ርግ.
ሶሳዊ	ቅ.
ሰዋስው 	ዘዘ.
ሶቀ	ርግ.
ሰዋቂ	ቅ.
ተሰውቀ	ተደ.አ.
ስውቅ	ቅ.
ሶቅ	ዘዘ.
ሱቅ	ዘዘ.
ሶበርት 	ስ.
ሶበ	መዋ.
ሶቤሃ	ተስ.
ሶከር	ስ.
ሶደ	ርግ.
መስውድ	ባዘ.
ሶጠ	ርግ.
ሰዋጢ	ቅ.
ተሰውጠ	ተደ.አ.
ስውጥ	ቅ.
ሱጠት	ሳዘ.
ስውጥ	ዘዘ.
ሶፍያ	ስ.
ሶፎንያስ	ተጸስ.
ቀለ	ኢግ.
ቀሊል	ቅ.
ቅለት	ሳዘ.
አቅለለ	አስ.አ.
ቀለመ	ርግ.
ቀላሚ	ቅ.
ተቀለመ	ተደ.አ.
ቅሉም	ቅ.
ቅልመት	ሳዘ.
ቀለም	ዘዘ.
ቀለምሲስ	ስ.
ቀለምጤዳ	ስ.
ቀለምጺጽ	ስ.
ቀለሰ	ርግ.
ቀላሲ	ቅ.
ተቀልሰ	ተደ.አ.
ቅሉስ	ቅ.
ተቃላሰ	ተዳ.አ.
አስተቃለሰ	አስ.አ.
ቀለበ	ርግ.
ቁላቤ	ዘዘ.
ቀልብ	ዘዘ.
ቀለንቶን	ስ.
ቀለወ	ርግ.
ተቀልወ	ተደ.አ.
ቅልው	ቅ.
ቈላ	ዘዘ.
ቈለዘ	ርግ.
መቍለዝ	ባዘ.
ቍልዝ	ዘዘ.
ቀለየ	ኢግ.
ቅሉይ	ቅ.
ቀላይ	ዘዘ.
አቅለየ	አስ.አ.
ቀለደ 	ርግ.
መቅለድ	ባዘ.
ቀልድ	
ቀለጰ	ርግ.
ቈለፈ	ርግ.
ቁልፍ	ዘዘ.
ተቈለፈ	ተደ.አ.
ቈላፍ	ቅ.
ቍልፈት	ሳዘ.
ቀላቂል	ስ.
ቀለምንጦስ	
ቀልቀለ	ርግ.
ነቀልቃል 	ባዘ.
ቈልቈለ	ርግ.
ተቈልቈለ	ተደ.አ
ቍልቍል	ቅ.
ቍልቍለት	ሳዘ.
ቍልቍሊት	ምዘ.
ቍልቍሊተሖረ	
ቀልቀል	ስ.
ቀልዐ	ርግ.
ቀላዒ	ቅ.
መቅልዕ	ባቅ.
ተቀልዐ	ተደ.አ.
ቅሉዕ	ቅ.
ቅልዓ	ዘዘ.
ቀልደደ	ርግ.
ቀልድድ	ስ.
ተቀልደደ	ተደ.አ.
ቅልዱድ	ቅ.
ቀልጰጰ	ርግ.
ቀልጰጵ	ዘዘ.
ተቀልጰጰ	ተደ.አ.
ቀሐመ	ርግ.
ቀሐሚ	ቅ.
ቃሕም	ዘዘ.
አቅሐመ	አስ.አ.
ቀሐረ	ርግ.
ቀሐወ	ኢግ.
አቅሐወ	አስ.አ.
ተቃሐወ	ተዳ.አ.
ቃሕው	ዘዘ.
ቀሕቅሐ	ርግ.
ቀመለ	ርግ.
ቅማል	ዘዘ.
ቀመረ	ርግ.
ተቀመረ	ተደ.አ.
ቅሙር	ቅ.
ቀመር	ዘዘ.
ቁማር	ዘዘ.
ቀመጠ	ርግ.
ቅምጥ	ዘዘ.
ቀሚስ	ስ.
ቀማጥር	ስ.
ቀምሐ	ርግ.
ቀምሕ	ዘዘ.
ምቅማሕ	ባዘ.
ቀምጠወ	ርግ.
ቀሠመ	ርግ.
ቀሣሚ	ቅ.
ተቀሥመ	ተደ.አ.
ቅሡም	ቅ.
ቅሥመት	ሳዘ.
ቀሥም	ዘዘ.
ተቅሣም	ባዘ.
ቀሠረ	ርግ.
ቅሣር	ዘዘ.
ቀሠጠ	ርግ.
ቀሣጢ	ቅ.
ቀሠፈ	ርግ.
ቀሣፊ	ቅ.
ተቀሥፈ	ተደ.አ.
ቅሡፍ	ቅ.
ቅሥፈት	ሳዘ.
መቅሠፍት	ባከዘ.
ምቅሣፍ	ባቅ.
ቀሠፋይ	ስ.
ቀሡት	ስ.
ቀሥተመ	ርግ.
ቀሥት	ስ.
ቀሥፍ	ስ.
ቀረመ	ርግ.
ቀራሚ	ቅ.
ተቀርመ	ተደ.አ.
ቅሩም	ቅ.
ቀርም	ዘዘ.
ተቅራም	ባዘ.
ተቃረመ	ተደ.አ.
ተቃራሚ	ቅ.
ቅርመት	ሳዘ.
ቈረ	ኢግ.
ቈሪር	ቅ.
ቍረት	ሳዘ.
ቍር	ዘዘ.
አቍረረ	አስ.አ
መቍረሪ	ቅ.
መቍረር	ባዘ.
ቈረቈር	ስ.
ቀረብ	ስ.
ቀረነ	ርግ.
ቀራኒ	ቅ.
ቀርን	ዘዘ.
ተቃረነ	ተደ.አ.
ተቃራኒ	ቅ.
አስተቃረነ	አዳ.አ.
መስተቃርን	ባቅ.
ቀረየ	ኢግ.
ቀራዪ	ቅ.
ቀረጸ	ርግ.
ቀራጺ 	ቅ.
ተቀርጸ	ተደ.አ.
ቅሩጽ	ቅ.
ቅርጽ	ዘዘ.
ቅርጸት	ሳዘ.
ቀረፀ	ርግ.
ቀራፂ	ቅ.
ተቀርፀ	ተደ.አ.
ቅሩፅ	ቅ.
ቀረፅ	ዘዘ.
አቅረፀ	አስ.አ.
ቀረፈ	ርግ.
ቅራፍ	ስወቅ.
ቅርፍት 	ምዘ.
ቀራቢብ	ስ.
ቀራንዮ	ስ.
ቀሬናዊ	ቅ.
ቀርሐ	ርግ.
ቀራሕ	ቅ.
ቅርሐት	ሳዘ.
ቀርመዝ	ስ.
ቀርሜሎስ	ስ.
ቀርቀር	ስ.
ቀርቄሰ	ኢግ.
ቀርቂስ	ዘዘ.
ቀርበ	ግ.
ቅሩብ	ቅ.
ቈርቈረ	ርግ.
ተቈርቈረ	ተደ.አ.
ቍርቁር	ቅ.
ቈረቈር	ዘዘ.
ቀርቂስ	ስ.
ቀርነለው	ስ.
ቀርነብ	ስ.
ቀርነናእ	ስ.
ቈርነናዕ	ስ.
ቀርነው	ስ.
ቈርኔን	ስ.
ቀርንብ	ስ.
ቀርን	ስ.
ቀርነነጌ	
ቀርነዝብጦ	
ቀርአ	ርግ.
ቀርድ	ስ.
ቀርጠሎን	ስ.
ቀርጠፋሉ	ስ.
ቀርጣልስ	ስ.
ቀርጰጰ	ርግ.
ቀርጳጲ	ቅ.
ተቀርጰጰ	ተደ.አ.
ቀሰመ	ርግ.
ቀሳሚ	ቅ.
መቅሰም	ባቅ.
ቀሰም	ዘዘ.
ተቀስመ/ተቀሰመ	ተደ.አ.
ቅሱም	ቅ.
ቅሳሜ	ዘዘ.
ቀሰመ	ኢግ.
ቀሳሚ	ቅ.
መቅስም	ባቅ.
ምቅሳም	ባዘ.
ቀስም	ዘዘ.
ቀሰ	ኢግ.
ቀሲስ	ቅ.
ቀስ	ዘዘ
ቅስና	ምዘ.
ቀሰጠ	ርግ.
ቀሳጢ	ቅ.
ቀሱት	ስ.
ቈስለ	ግ.
ቍሱል	ቅ.
ቍስል	ዘዘ.
ቍስለት	ሳዘ.
ቈስቈስ	ስ.
ቀሰተወ	ርግ.
ቀስታዊ	ቅ.
ቀስታም	ምዘ.
ቀስት	ዘዘ.
ቈስያ	ስ.
ቈስጤ	ስ.
ቀቀበ	ርግ.
ቀቃቢ	ቅ.
ቀቀብ	ዘዘ.
ቀቀኖ	ስ.
ቈቀወ	ግ.
ቈቍአ	ኢግ.
ቀበለ	ርግ.
ተቀበለ	ተደ.አ.
ቅቡል	ቅ.
ተቀባሊ	ቅ.
ቅበላ/ቅባሌ	ዘዘ.
ተቃበለ	ተደ.አ.
ቀበረ	ርግ.
ቀባሪ	ቅ.
ቀበረ	ዘዘ.
ቀበሮ	ስ.
ተቀበረ	ተደ.አ.
ቅቡር	ቅ.
መቅበር	ባዘ.
መቃብር	ባዘ.
ቀበወ	ርግ.
ተቀብወ	ተደ.አ.
ቅብው	ቅ.
ቀበየ	ርግ.
ቀባዪ	ቅ.
ተቀብየ	ተደ.አ.
ቅቡይ	ቅ.
ቀበያውበጠ	ሥግ.
ቀበያውባጢ	ቅ.
ቀብቀበ	ርግ.
ቅብቅብ	ዘዘ.
ቀብተተ	ርግ.
ቀብዐ	ርግ.
ቀባዒ	ቅ.
ተቀብዐ	ተደ.አ.
ቅቡዕ	ቅ.
ቅብዐት	ሳዘ.
ቅብዕ	ዘዘ.
ምቅባዕ	ባዘ.
ቀብጸ	ኢግ.
ቅቡጽ	ቅ.
ቅብጸት	ሳዘ.
ቀተለ	ርግ.
ቀታሊ	ቅ.
ቀትል	ዘዘ.
መቅትል	ባቅ.
ምቅታል	ባዘ.
ተቀትለ	ተደ.አ.
ቅቱል	ቅ.
ተቃተለ	ተዳ.አ
አቅተለ	አስ.አ.
አስተቃተለ	አዳ.አ.
ቀተረ	ርግ.
ቅታሬ	ዘዘ.
ቅታሬ እጣን 	
ቀተተ	ኢግ.
ቀተት	ዘዘ.
ቀታት	ስ.
ቀነተ	ርግ.
ቅኑት	ቅ.
ቅናት	ዘዘ.
ቀነወ	ርግ.
ቀናዊ	ቅ.
ቀኖት	ምዘ.
ቀኖተ ሀጺን	
ተቀነወ	ተደ.አ.
ቅንው	ቅ.
ቀነየ	ርግ.
ቅኔ	ዘዘ.
ተቀንየ	(ተደ.አ.)
ቅኑይ	ቅ.
ቀነጸ	ኢግ.
ቀናንሞስ	ስ.
ቀንሞስ	ስ.
ቀንዐ	ኢግ.
ቀናኢ	ቅ.
ቅንዐት	ሳዘ.
ቀንዓት	ስ.
ቀንጠበ	ርግ.
ቅንጣቢ	ዘዘ.
ቀንጦስጠ	ሥግ.
ቀንጦሳጢ	ቅ.
ቀኖና	ስ.
ቀውስ	ስ.
ቀውዐ	ግ.
ቀውዕ	ዘዘ.
ቀዋሚ	ቅ.
ቈዐለ	ኢግ.
ቀዐነ	ርግ.
ተቃዐነ	ተደ.አ.
መቅዐን	ባቅ.
ቀየመ	ርግ.
ቀያሚ	ቅ.
ቅያሜ	ዘዘ.
ቂም	ዘዘ.
አስተቀየመ	አስ.አ.
መስተቀይም	ባቀ.
ቀይህ	ቅ.
ቀይጡን	ስ.
ቀደመ	ርግ.
ቀዳሚ	ቅ.
ቀዳም	ዘዘ.
ቀዳማዊ	ቅ.
ቀዳማይ	ቅ.
ቅድመ	ተግ.
ቅድም	ዘዘ.
ቅድምና	ምዘ.
አቅደመ	አስ.አ.
አቅዲሙ	ተግ.
መቅድም	ባዘ.
ተቀድመ	ተደ.አ.
ቅዱም	ቅ.
ቅድመት	ሳዘ.
ተቀደመ	ተዳ.አ.
ቀደሰ	ርግ.
ቀዳሲ	ቅ.
ተቀደሰ	ተደ.አ.
ቅዱስ	ቅ.
ቅድስተቅዱሳን	ጥቃ.
ቅዳሴ	ዘዘ.
ቅድስና	ምዘ.
ቅድሳት	ምዘ.
መቅደስ	ባዘ.
ቀደወ	ኢግ.
ቀዳዊ	ቅ.
ቅድው	ቅ.
አቅደወ	አስ.አ.
ቀደ	ርግ.
ቀደፈ	ርግ.
መቅደፍ	ባዘ.
ቀድሐ	ርግ.
ቀዳሒ	ቅ.
መቅድሕት	በከዘ.
መቅድሕ	ባቅ.
ምቅዳሕ	ባዘ.
ተቀድሐ	ተደ.አ.
ቅዱሕ	ቅ.
ቅድሐት	ሳዘ.
ቀድሕ	ዘዘ.
ቀጋ	ስ.
ቀጠበ	ርግ.
ቀጠነ	ኢግ.
ቀጢን	ቅ.
ቅጥነት	ሳዘ.
ቅጠን	ዘዘ.
ቁጥን	ዘዘ.
አቅጠነ	አስ.አ.
አቅጣኒ	ቅ.
መቅጠኒ	ቅ.
መቅጠን	ባዘ.
ቈጠጠ	ኢግ.
ቈጢጥ	ቅ.
ቍጠጥ	ዘዘ.
ቍጣጥ	ዘዘ.
ቀጠፈ	ርግ.
ቀጣፊ	ቅ.
ተቀጥፈ	ተደ.አ.
ቅጡፍ	ቅ.
ቅጥፈት	ሳዘ.
ቅጣፍ	ዘዘ.
ቀጥቀጠ	ርግ.
ቀጥቃጢ	ቅ.
ተቀጥቀጠ	ተደ.አ.
ቅጥቁጥ	ቅ.
ቅጥቃጤ	ዘዘ.
ቈጥዐ	ኢግ.
ቍጡዕ	ቅ.
ቍጥዓ	ዘዘ.
አስተቆ?ጥዐ	አስ.አ.
ቀጸለ	ርግ.
አስተቀጸለ	አስ.አ.
ተቀጸለ	ተደ.አ.
ቅጹል	ቅ.
ተቅጺል	ዘዘ.
ቀጸላ	ዘዘ.
ቈጸለ	ኢግ.
ቍጹል	ቅ.
ቈጽል	ዘዘ.
አቍጸለ	አስ.አ.
ቀጸረ	ርግ.
ቀጻሪ	ቅ.
ተቀጽረ	ተደ.አ.
ቅጹር	ቅ.
ቅጽር	ዘዘ.
ቈጸረ	ርግ.
ቈጻሪ	ቅ.
ተቈጽረ	ተደ.አ.
ቍጹር	ቅ.
ቍጽረት	ሳዘ.
ቍጽር	ዘዘ.
ቍጽሮ	ዘዘ.
ቀጸበ	ርግ.
ተቃጸበ	ተደ.አ.
ቅጽበት	ሳዘ.
ቀጸለ	ርግ.
ቀጸፈሉ	ስ.
ቀጺመት	ስ.
ቀጻዕ/ቀጻ	ስ.
ቀጻጴ	ስ.
ቀጽቀጸ	ርግ.
ቅጽቃጼ	ዘዘ.
ቀጽዐ	ርግ.
ተቀጽዐ	ተደ.አ.
ቅጹዕ	ቅ.
ቀፀወ	ርግ.
መቅፁት	ባከዘ.
ቀፈለ	ርግ.
ተቀፍለ	ተደ.አ.
ቅፉል	ቅ.
ቅፍሎ	ዘዘ.
መቅፈል	ባዘ.
ቀፈረ	ርግ.
ቀፈር	ዘዘ.
መቅፈርት	ባከዘ.
ቀፈት	ስ.
ቀፈጸ	ርግ.
ቀፋጺ	ቅ.
ተቀፍጸ	ተደ.አ.
ቅፉጽ	ቅ.
ቀፈፈ	ኢግ.
ቀፎ	ስ.
ቁንስጣጌ	ስ.
ቁንጽል	ስ.
ቂሳኖስ	ስ.
ቂም	ስ.
ቂራጥ	ስ.
ቂርቆስ	ተጸ.አ
ቂሳርያ	
ቃህም	ስ.
ቃል	ስ.
ቃሕቅሐ	ርግ.
ቃሕዋ	ስ.
ቃማ	ስ.
ቃሩራ	ስ.
ቃርሐ	ርግ.
ቃርሕ	ዘዘ.
ቃር	ስ.
ቃስ	ስ.
ቃቂል	ስ.
ቃቂር	ስ.
ቃቡ	ስ.
ቃባ	ስ.
ቃቤላ	ስ.
ቃነየ	ርግ.
ቅኔ	ዘዘ.
ቃና	ስ.
ቃውላ	ስ.
ቋዕ	ስ.
ቃዲ	ቅ.
ቃዴስ	ስ.
ቃግሥት	ስ.
ቃፍ	ስ.
ቄሐ	ኢግ.
ቀይሕ	ቅ.
ቂሐት	ሳዘ.
ቅያሔ	ዘዘ.
አቅየሐይሐ	አስ.አ.
ቄሳር	ስ.
ቄቀየ	ኢግ.
ቂቁይ	ቅ.
ቄቅሐ	ርግ.
ቄቃሒ	ቅ.
ቄቅሕ	ዘዘ.
መቄቅሕ	ባቅ.
ቄአ	ግ.
አቄአ	አስ.አ.
ቄውንቄ	ስ.
ቄዳር	
ቄዳርስ	ስ.
ቄዴም	ስ.
ቄድር	ስ.
ቄድሮስ	
ቄጵርስስ	ስ.
ቄፋዝ	ስ.
ቅታሬ	ስ.
ቅትራት	ስ.
ቍጠጥ	ስ.
ቍጥ	ስ.
ቅጥራን	ስ.
ቍጥን	ስ.
ቅጽቃጼ	ስ.
ቅፍር	ስ.
ቆመ	ሥግ.
ቀዋሚ	ቅ.
ቅዉም	ቅ.
ቁመት	ሳዘ
ቆም	ዘዘ.
ምቅዋም	ባዘ.
አቀመ	አስ.አ.
ያቁም	ባዘ.
ተቃወመ	ተዳ.አ.
ተቃዋሚ	ቅ.
ቃውሞ	ቅ.
ተቅዋም	ባዘ.
አስተቃወመ	አዳ.አ.
መስተቃውም	ባቅ.
ቆሞስ	ስ.
ቆራህ	ስ.
ቆሮስ	ስ.
ቆለውዳ	ስ.
ቆሊ	ስ.
ቆላ	ስ.
ቆሰቆስ	ስ.
ቆስያት	ስ.
ቆቅሐ	ግ.
ቆቃሕ	ዘዘ.
ቆቅሕ	ዘዘ.
ቆበረ	ግ.
ቆባር	ስ.
ቆብኒ	ስ.
ቆብዕ	ስ.
ቆዐ	ግ.
ቆዕ	ዘዘ.
ቆጰረ	ርግ.
ቆጵሮስ	ስ.
ቆጶን	ስ.
ቆፍ 	
በ	መዋ.
በሀም	ስውቅ.
በሀነ	ኢግ.
በለ	ኢግ.
አብለለ	አድ.አ.
ብሉል	ቅ.
አብላሊት	
በለስ	ስ.
በለሳን	ስ.
በለሶን	ስ.
በለቀ	ኢግ.
ብሉቅ	ቅ.
ባላቅ	ዘዘ.
በለተ	ርግ.
በላቲ	ቅ.
ባላታ/ብላቴና/ብላቴን	ቅ.
ብላቴን ጌታ	
ተበለተ	ተደ.አ.
ብሉት	ቅ.
መበለት	ባዘ.
በለን	ስ.
በለው	ስ.
በለዝ	ስ.
በሊን	ስ.
በሊኖን	ስ.
በልበለ	ኢግ.
ብልባሌ	ዘዘ.
በልኅ	ግ.
በሊኅ	ቅ.
ብልኅ	ዘዘ.
ብልኅ	ቅ.
ብልኅት	አስ.አ
መብልኂ	ባቅ.
መብልኅ	ባዘ.
ምብላኅ	ባዘ.
በልዐ	ርግ.
በላዒ	ቅ.
አብልዐ	አስ.አ.
መብልዕ	ባዘ.
ምብላዕ	ባዘ.
ተበልዐ	ተደ.አ.
ብሉዕ	ቅ.
ብላዕ	ዘዘ.
ብልዓት	ሳዘ.
በልየ	ኢግ.
በላዪ	ቅ.
ብሉይ	ቅ.
ብሉየ-መዋዕል	(ጥቃ.)
ብልየት	ሳዘ.
አብለየ	አስ.አ.
አብላዪ	ቅ.
መብለዪ	ቅ.
በልግር	ስ.
በሐ	
በሐከ	
በሐክሙ	
በሐኪ	
በሐክን	
በሐከ እግዚእየ	
በሐተ	ኢግ.
ብሑት	ቅ.
መብሕት	ባቅ.
በሕብሐ	ርግ.
ተበሕብሐ	ተደ.አ.
ብሕባሔ	ዘዘ.
በሠረ	ርግ.
በሣሪ	ቅ.
አብሠረ	አስ.አ.
አብሣሪ	ቅ.
ተበሥረ	ተደ.አ.
ብሥራት	ምዘ.
ብሥራታዊ	ቅ.
በረ	ርግ.
ተበረ	ተደ.አ.
ብሩር	ቅ.
ብሩር	ዘዘ.
በረረ	ኢግ.
በራሪ	ቅ.
በር	ዘዘ.
በረቀ	ኢግ.
መብረቅ	ባዘ.
በረቅ	ዘዘ.
በረከ	ኢግ.
ብሩክ	ቅ.
አብረከ	አስ.አ.
በረዘ	ርግ.
ተበረዘ	ተደ.አ.
ብሩዝ	ቅ.
ብርዝ	ዘዘ.
ተብሪዝ	ባዘ.
በረየ	ግ.
በሬ	ዘዘ.
በሪሆት	ስ.
በራቄኔም	ስ.
በርሀየ	ግ.
በርሃ	ዘዘ.
በረደ	ኢግ.
በራዲ	ቅ.
በረድ	ዘዘ.
አብረደ 	አስ.አ.
በረጸ	ኢግ.
ተባረጸ	ተደ.አ.
በረጽ	ዘዘ.
በራ	ስ.
በር	ስ.
በርሀ	ኢግ.
ብሩህ	ቅ.
በርህ	ዘዘ.
ብርሃን	ምዘ.
ብርሀነልብ	ጥቃ.
ብርሃነመብረቅ	ጥቃ.
ብርሀነዓይን	ጥቃ.
ብርሃናዊ	ቅ.
ብርሃና	ዘዘ.
አብርሀ	አስ.አ.
መብርሂ	ባቀ.
መብርህ	ዘዘ.
በርሐ	ኢግ.
በራሕ	ቅ.
በርበረ	ርግ.
በርባሪ	ቅ.
በርበር	ዘዘ.
በርበሬ	ዘዘ.
በርባሮስ	ስ.
በርተሎሜዎስ	ተጸስ.
በርናባስ	ተጸስ.
በርዐ	ኢግ.
ብርዕ	ዘዘ.
በርደደ	ኢግ.
መብረድ 	ባዘ.
በሰለ	ኢግ.
ተብስለ	ተደ.አ.
ብሱል	ቅ.
ተብሲል	ባዘ.
ብስሎ	ዘዘ.
አብሰለ	አስ.አ.
አብሳሊ	ቅ.
መብስል	ባቅ.
በስበሰ	ኢ/ርግ.
አንበስበሰ	አስ.አ.
በቀለ	ርግ.
በቃሊ	ቅ.
በቀል	ዘዘ.
በቀለ	መግ.
መብቅል	ባቅ.
መስተበቅል	ባቅ.
ተበቀለ	ተደ.አ.
ተበቃሊ	ቅ.
በቅል	ስ.
በቈለ 	ኢግ.
በቋሊ	ቅ.
አብቈለ	አስ.አ.
በቍል	ዘዘ.
አብቍልት	ባከዘ.
በቀልት	ስ.
በቍላ	ዘዘ.
በቀወ	ኢግ.
ብቅው	ቅ.
ብቅወት	ሳዘ.
ብቃው	ዘዘ.
አብቀወ	አድ.አ.
በቈጸ	ርግ.
ተበቍጸ	ተደ.አ.
ብቍጽ	ቅ.
ምብቋጽ	ባዘ.
በቅበቀ	ርግ.
በቍዐ	ርግ.
በቋዒ	ቅ.
ተብቍዐ	ተደ.አ.
ብቁዕ	ቅ.
ብቍዓት	ሳዘ.
ብቍዔት	ሳዘ.
ባቍዕ	ዘዘ.
በበ	መዋ.
በብላት	ስ.
በተ	ግ.
ብቱት	ቅ.
በተረ	ርግ.
በትር	ዘዘ.
በትረኅጺን	ጥቃ.
በትረመሐፒል	ጥቃ.
በትረነገድ	
በትረያርክ	ጥቃ.
በተነ	ርግ.
በተከ	ርግ.
ተበትከ	ተደ.አ.
ብቱክ	ቅ.
ብትክ	ዘዘ.
ብትከት	ሳዘ.
በትበተ	ርግ.
በኁበኈ	ኢግ.
ብኍባኄ	ዘዘ.
በነተ	ርግ.
ብነት	ዘዘ.
በከ	ኢግ.
በክ	ቅ.
በኰረ	ርግ.
በኳሪ	ቅ.
ተበኲረ	ተደ.አ.
ብኩር	ቅ.
በኲር	ዘዘ.
ብኲርና/በኲርና 	ምዘ.
በከየ	ኢግ.
በካዪ	ቅ.
መብክይ	ባቅ.
ብኩይ	ቅ.
ብካይ	ዘዘ.
አብከየ	አስ.አ
አባከየ	ተደ.አ.
አስተባከየ	አዳ.አ.
በኲሐ	ርግ.
አብኲሐ	አስ.አ.
መብኲሕ	ባቅ.
ምብኳሕ	ባዘ.
በዐረ	ርግ.
ብዕር	ዘዘ.
ብዕራ/ብዕራይ	ዝከ.
ብዕራዊ	ቅ.
ምብዓር	ባዘ.
በዐደ	ርግ.
በዓዲ	ቅ.
ተብዕደ	ተደ.አ.
ብዑድ	ቅ.
ባዕድ	ዘዘ.
ብዓዴ	ዘዘ.
ባዕድና	ምዘ.
በዓል	ስ.
በዓልት	ስ.
በዓለሐመር	
በዓለመዝገብ (መዛግብት)	
በዓለምሳሌ	
በዓለርዴ	
በዓለሰይፍ	
በዓለቤት	
በዓለንዋይ	
በዓለእቶን	
በዓለኪን	
በዓለውዴት	
በዓለዕዳ	
በዓለጊዜ	
በዓል	ስ.
በዓለአርብዓ	ጥቃ.
በዓለሃምሳ	
በዓለመርዓ	
በዓል	ስ.
በዓት	ስ.
በዘ	መግ.
በዘተ	ርግ.
በዛቲ	ቅ.
ተበዘተ	ተደ.አ.
ብዙት	ቅ.
በዝበዘ	ርግ.
በዝኅ	ኢግ.
ብዙኅ	ቅ.
ብዝኅት	ሳዘ.
ብዝኅ	ዘዘ.
አብዝኅ	አስ.አ.
አብዛኂ	ቅ.
መብዛኂ	ባቅ.
መብዝኅት	ቅ.
ተባዝኅ	ተዳ.አ.
አስተባዝኅ	አዳ.አ.
በየነ	ርግ.
በያኒ	ቅ.
መበይን	ባቅ.
ተበየነ	ተደ.አ.
ብዩን	ቅ.
በይነ	መግ.
በይነ ምንት ጸላዕከኒ	
በይነ ዘአፍቀርኩከ አፍቅረኒ	
በደለ	ርግ.
በደል	ዘዘ.
በደረ	ርግ.
በዳሪ	ቅ.
በድር	ዘዘ.
አብደረ	አስ.አ.
ተበድረ	ተደ.አ.
ብዱር	ቅ.
ተባደረ	ተዳ.አ.
አስተባደረ	አዳ.አ.
በደቀ	ርግ.
በዳቂ	ቅ.
በደነ	ኢግ.
በድን	ዘዘ.
በደዶ	ስ.
በድበደ	ኢግ.
ብድብድ	ዘዘ.
በድወ	ርግ.
ብድው	ቅ.
ብድወት	ሳዘ.
በድው	ዘዘ.
በዳ	ዘዘ.
አብደወ	አስ.አ.
ተባደወ	ተደ.አ.
በገረ	ርግ.
ቢጋር	ዘዘ.
በገነ	ርግ.
በገና	ዘዘ.
በገናዊ	ቅ.
በግበገ	ርግ.
በግዐ	ግ.
በግዕ	ዘዘ.
በግዕት	አን.በግ.
በግ	
አባግዕ	
በጠ	ኢግ.
በጠለ	ኢግ.
በጣሊ	ቅ.
ብጡል	ቅ.
ብጥለት	ሳዘ.
አብጠለ	አስ.አ.
አብጣሊ	ቅ.
መብጠሊ	ባቅ.
በጠረ	ርግ.
አብጠረ	አስ.አ.
ተበጥረ	ተደ.አ.
ብጡር	ቅ.
ምብጣር	ባዘ.
በጠሰ	ርግ.
ባጦስ	ዘዘ.
በጣጣ	ስ.
በጥሐ	ርግ.
በጣሒ	ቅ.
ተበጥሐ	ተደ.አ.
ብጡሕ	ቅ.
ብጥሐት	ሳዘ.
በጢሕ	ዘዘ.
በጥሪቃ	ስ.
በጥበጠ	ርግ.
በጸለ	ርግ.
ተበጽለ	ተደ.አ.
ብጽል	ዘዘ.
በጽል	ዘዘ.
በጼቃ	ስ.
በጽሐ	ኢግ.
በጻሒ	ቅ.
ብጹሕ	ቅ.
በጽሒ	ትግ.
ብጽሐት	ሳዘ.
ብጽሕ	ዘዘ.
አብጽሐ	አስ.አ.
አብጻሒ	ቅ.
መብጽሒ	ባቅ.
ምብጻሕ	ባዘ.
በፀወ	ኢግ.
ብፃው	ዘዘ.
ምብፃው	ባዘ.
በፅዐ	ርግ.
አብፅዐ	አደ.አ.
ተበፅዐ	ተደ.አ.
ብፁዕ	ቅ.
ብፅዐት	ሳዘ.
ብፅዕና	ምዘ.
ብፅዕ	ዘዘ.
ብፅዓን	ምዘ.
ቡራቴ	ስ.
ቡራት	ዝከ.
ቡባ	ስ.
ቢሕ	ስ.
ቢረሌ	ስ.
ቢስም	ስ.
ቢሶስ	ስ.
ቢዶን	ስ.
ቢጸልቁማ	ስ.
ባህነነ	ኢግ.
ብህኑን	ቅ.
ባህን	ዘዘ.
ባህናን	ምዘ.
ባለቀ	ግ.
ባልቄ	ዘዘ.
ባሉጥ	ስ.
ባላቅ	ስ.
ባላን	ስ.
ባልሐ	ርግ.
ባላሒ	ቅ.
ተባልሐ	ተደ.አ.
ብሉሕ	ቅ.
ባሕረረ	ኢግ.
አባሕረረ	አስ.አ.
ባሕሩስ	ስ.
ባሕር	ስ.
ባሕርይ	ስ.
ባሕተወ	ርግ.
ባሕትዎ	ዘዘ.
ባሕታዊ	ቅ.
ብሕትው	ቅ.
ብሕታዌ	ዘዘ.
ብሕትውና	ምዘ.
ተባሕተወ	ተዳ.አ.
ባሕቱ	መፃ
ባሕቲት	ተግ.
ባሕቲትየ	
ባሕቲትነ	
ባሕቲትክሙ	
ባሕቲትኪ	
ባሕቲትክን	
ባሕቲቱ	
ባሕቲቶሙ	
ባሕቲት	
ባሕቲቶን	
ባሕብሐ	ኢግ.
ብሕባሔ	ዘዘ.
ባርቶስ	ስ.
ባቡት	ስ.
ባቲ	
መጽአ ባቲ	
ባማ	ስ.
ባሦር	ስ.
ባረከ	ርግ.
ተባረከ	ተደ.አ.
ቡሩክ	ቅ.
ቡራኬ	ዘዘ.
በረከት	ምዘ.
አስተባረከ	አዳ.አ.
ባረየ	ርግ.
ተባረየ	ተዳ.አ.
ብሬት	ምዘ.
እብሬት	ባከዘ.
ባሲልያ	ስ.
ባስልዮስ	ተጸ.ስ.
ባበለ	ኢግ.
ባቢሎን	
ባቢሎናዊ	ቅ.
ባቤል	ዝከ.
ባቡቴ	ስ.
ባቡት	ስ.
ባባ	ስ.
ባተለ	ግ.
ባቱል	ቅ.
ብቱል	ቅ.
ባውሳ	ስ.
ባዕስ	ስ.
ባዚቃ	ስ.
ባዚቅ	ስ.
ባዜቃ	ስ.
ባዝራ	ስ.
ባዝግና	ስ.
ባደስ	ስ.
ቤላ	ርግ.
ቤልሖር	ስ.
ቤርሳቤሕ	ስ.
ቤርሴክታን	ስ.
ቤቃ	ስ.
ቤርክታን	ስ.
ቤተ	ኢግ.
በያቲ	ቅ.
ቤት	ዘዘ.
ታቦት	
ቤተላሕ	
ቤተልሔም	
ቤተልብስ 	
ቤተሐተታ	
ቤተሐኖት	
በተሕሙም	
ቤተሕሙም ዘዓይን	
ቤተሕሙም ዘልብ	
ቤተሕሙም ዘስን	
ቤተመምህራን	
ዓቢይ ቤተምህራን	
ቤተመርዓ	
ቤተመበስላን	
ቤተመንግሥት 	
ቤተመንጽሒ	
ቤተመዛግብት	
ቤተመያሲ	
ቤተግዝእ	
ቤተመጥባሕት	
ቤተመጻሕፍት	
ቤተሙታን	
ቤተማዕረፅ	
ቤተማይ	
ቤተምሥያጥ	
ቤተምርፋቅ	
ቤተምሳሕ	
ቤተምስል	
ቤተምስል ወድምፅ	
ቤተምኅባዝ	
ቤተምንዳድ	
ቤተሞቅሕ	
ቤተርእስ	
ቤተርእይ	
ቤተስታይ	
ቤተብለኔ	
ቤተተወኔት	
ቤተትምህርት 	
ቤተኃይል ዘማኅቶት 	
ቤተ ኅትመት 	
ቤተነግድ	
ቤተንዋም	
ቤተአልባስ 	
ቤተአፈው	
ቤተአንስት	
ቤተአፍስት	
ቤተእድ	
ቤተእግር	
ቤተክህነት	
ቤተክሣድ	
ቤተወይን	
ቤተዕክል	
ቤተዝሙት	
ቤተድምፅ	
ቤተድራር	
ቤተድውያን 	
ቤተጉባኤ	
ቤተግዝእ	
ቤተጣዕም	
ቤተጣዖት	
ቤተጥብሐት	
ቤተጥዒና	
ቤተጦማር	
ቤተጸብሕ	
ቤተጽሕፈት	
ዓቢይ ቤተጽሕፈት	
ቤተጽዋዔ	
ቤተፍሥሐ	
ቤተፍትሕ	
ቤተፍት	
ቤዐለ	ግ.
ቤዓሊ	ቅ.
ቤዘወ	ርግ.
ቤዛዊ	ቅ.
መቤዝው	ባቅ.
ቤዛ	ዘዘ.
ተቤዘወ	ተደ.አ.
ቢዝው	ቅ.
ቤዝ	ስ.
ቤዴ	ስ.
ቤጸ	ርግ.
በያጺ	ቅ.
ቢጽ	ዘዘ.
ተባየጸ	ተዳ.አ.
አስተባየጸ	አስ.አ.
መስተባይጽ	ባቅ.
ቤጻ	ስ.
ብሄማ	ስ.
ብሄሞት	ስ.
ብህለ	ርግ.
በሃሊ	ቅ.
ባህል	ዘዘ.
አብሀለ	አስ.አ.
አብሃሊ	ቅ.
ተብህለ	ተደ.አ.
ብሁል	ቅ.
ብህመ	ኢግ.
ብሁም	ቅ.
በሃም	ዘዘ.
ብህመት	ሳዘ.
ብለኔ	ስ.
ብሉር	ስ.
ብሌን	ስ.
ብልቲት	ስ.
ብሔ	ስ.
ብሕረ	ኢግ.
ባሕር	ዘዘ.
ባሕረሐሳብ	ጥቃ.
ባሕረብርት	ጥቃ.
ባሕረኤሎን	ስ.
ባሕረእሳት	ጥቃ.
ብሔር	ዘዘ.
ብሕተ	ኢግ.
ብሑት	ቅ.
አብሐተ	አድ.አ.
መባሕት	ባዘ.
ብሕአ	ኢግ.
ብሑእ	ቅ.
ብሑኣን ፍሬያተ ወይን	
ብሕአት	ሳዘ.
ብሕእ	ዘዘ.
ብሒእ	ዘዘ.
አብሕአ	አስ.አ.
ተብሕአ	ተደ.አ.
ብሕውስ	ስ.
ብሕው	ስ.
ብረት	ስ.
ብሩር	ስ.
ብራና	ስ.
ብርስን	ስ.
ብርስኖት	ስ.
ብርቢር	ስ.
ብርት	ስ.
ብርትኳን	ስ.
ብርኒ	ስ.
ብርኩታ	ስ.
ብርክ	ስ.
ብርክኤል	ስ.
ብርዕ	ስ.
ብርጋና	ስ.
ብናሴ	ስ.
ብንት	ስ.
ብእሰ	ኢግ.
በኣሲ	ቅ.
ብእሲ	ዘዘ.
ብእሲሁ	
ብእሴደም	(ጥቃ.)
ብእሴሐቅል	
ብእሴምድር	
ብእሲት	ስ.
ብእሲታ	
ብእሲቶ	
ብእሴውስጥ	ስ.
ብእዛ	ስ.
ብዉሕ	ቅ.
ብውሕ	ትአ.
ብዔል	
ብዔዛ	ስ.
ብዕለ	ኢግ.
ባዕል	ቅ.
ባዕላይ	ቅ.
ብዑል	ቅ.
ብዕል	ዘዘ.
አብዐለ	አስ.አ.
መብዐሊ	ባቅ.
መብዕል	ባቅ.
ብዕራይ	ስ.
ብዕዛ	ስ.
ብዝር	ስ.
ብዝያሁ	ስ.
ብየ	
ብድዮን	ስ.
ብጽዓት	ስ.
ቦ	ግ.
ቦሙ	
ቦን	
ቦኑ	ተግ.
ቦሐ	ኢግ.
ተበውሐ	
ብዉሕ	ቅ.
ብውሕና	ምዘ.
ቦአ	ኢግ.
በዋኢ	ቅ.
በአት	ሳዘ.
በኣት	ምዘ.
አብአ	አስ.
አባኢ	ቅ.
ሙባእ	ባዘ.
መባእ	ባዘ.
ቦቀ	ርግ.
ቦቅ.	ዘዘ.
ቦክ	ስ.
ቦዐ	ርግ.
ባዕ	ዘዘ.
ተለሐሰ	ኢግ.
ተለሐየ	ኢግ.
ተለሐፈ	ኢግ.
ልሑፍ	ቅ.
ተለመ	ርግ.
ትልም	ዘዘ.
ተለወ	ርግ.
ተላዊ	ቅ.
መትልው	ባቅ.
መትለው	ባዘ.
ትልወት	ሳዘ.
አትለወ	አስ.አ.
ተታለወ	ተዳ.አ.
አስተታለወ	አዳ.አ.
መስተታልው	ባቅ.
ተለዐለ	ግ.
ተላቤ	ስ.
ተላወሰ	ኢግ.
ተላዕ	ስ.
ተላጸቀ	ኢግ.
ልጹቅ	ቅ.
ልጽቅ	ዘዘ.
ተልዕለ	ኢግ.
ይትሌዓል	ዘአ/ትአ.
ተልዕሎ/ተልዕሎት	ንአ.
ልዑል	ቅ.
ሉዓሌ	ዘዘ.
ልዕልና	ምዘ.
ላዕል	ዘዘ.
ተልፍዮስ	ስ.
ተሐተ	ኢግ.
ተሓቲ	ቅ.
ተትሕተ	
ትሑት	ቅ.
ታሕት	ዘዘ.
ታሕታዊ	ቅ.
ታሕታይ	ቅ.
ትሕትና	ምዘ.
አትሐተ	አስ.አ.
አትሐቲ	ቅ.
መትሓቲ	ባቅ.
መትሕት	ባዘ.
መትሕታዊ	ባቅ.
ተሐልየ	ርግ.
ሕልያን	ምዘ.
ተሐመየ	ኢግ.
ታሕማ	ዘዘ.
ተሐሥየ	ኢግ.
ሐሤት	ዘዘ.
ተሐበለ	ርግ.
ሕባሌ	ዘዘ.
ተሐበየ	ርግ.
ተሐውሰ	ግ.
ተሐዘበ	ርግ.
ተሐዛቢ	ቅ.
ትሕዝብት	ምዘ.
ተሐየየ	ርግ.
ይትሔየይ	ትንአ.
ይትሐየይ	
ይትሐየይ	ትአ.
ተሐይዮ/ተሐይዮት	
ተሐያዪ	ቅ.
ተመ	ኢግ.
ተማም	ቅ.
ተመርት	ስ.
ተመርዐወ	ኢግ.
ምርዕው	ቅ.
መርዓዊ	ዘዘ.
መርዓት	
መርዓውት	መድ.
ተመርጐዘ	ርግ.
ምርጒዝ	ዘዘ.
ተመስከነ	ግ.
ምስኪን 	ቅ.
ተመነየ	ርግ.
ተምኔት	ምዘ.
ተመን	ስ.
ተመንደበ	ግ.
ምንዱብ	ቅ.
ምንዳቤ	ዘዘ.
ተመኩስየ	ኢግ.
ምኩስይ	ቅ.
መኩሴ	ዘዘ.
ተመክሐ	ግ.
ተመካሂ	ቅ.
ምክሕ	ዘዘ.
ትምክሕት	ምዘ.
ተመዝበረ	ግ.
ተመዝገነ	ኢግ.
ምዝጋና	ዘዘ.
ተመዝጐለ	ኢግ.
ተመየነ	ርግ.
ትምይንት	ዘዘ.
ተመጠወ	ግ.
ተማህለለ	ኢግ.
ምህላ	ዘዘ.
ተማልአ	ርግ.
ተማወቀ	(ተደ.አ.)
ተማዕለየ	ግ.
ማዕሌት	ስ.
ተሜርጋብ	ስ.
ተምር	ስ.
ተምኔት	ስ.
ተምዐ	ኢግ.
ተማዒ	ቅ.
ተምያን	ስ.
ተሞገሰ	ኢግ.
ሞገስ	ዘዘ.
ተሞጥሐ	ግ.
ተሠርሐ	ግ.
ተሠርገወ	ግ
ተሠወረ	ግ.
ተሠይመ	ግ.
ተሠይጠ	ግ.
ተሠገወ	ኢግ.
ሥግው	ቅ.
ሥጋዌ	ዘዘ.
ሥጋ	ዘዘ.
መሠግው	
ተሠጥመ	ግ.
ሥጡም	ቅ.
ተሣሀለ	ግ.
ይሤሀል	ትንአ.
ይሣሀል	ዘአ/ትአ.
ተሣህሎ/ተሣህልት	ንአ.
ሥሁል	ቅ.
መስተሣህል	ባቅ.
ምሥሀል	ባዘ.
ተሥላስ	ስ.
ተሥዕለ	ግ.
ተሥዕረ	ግ.
ተረከ	ርግ.
ታሪክ	ዘዘ.
ተራኅርኀ	ግ.
ይትረኀራኀ	ተንአ.
ይትራኅራኅ	ዘአ/ትአ.
ተራኅር ኖ/ተራኅር ኖት	ንአ.
ርኅሩኅ	ቅ.
ርኅራኄ	ዘዘ.
ተራፊ	ስ.
ተርሙስ	ስ.
ተርሚን	ስ.
ተርሜን	ስ.
ተርሴስ	ስ.
ተርኅወ	ግ.
ተርኰሰ	ርግ.
ተርጐመ	ርግ.
ተርጓሚ	ቅ.
ትርጕማን	ቅ.
ተተረጐመ	ተደ.አ.
ትርጕም	ቅ.
ትርጓሜ	ዘዘ.
ተርፈ	ኢግ.
ተራፊ	ቅ.
ትሩፍ	ቅ.
ትራፍ	ዘዘ.
ተረፍ	ዘዘ.
አትረፈ	አስ.አ.
መትረፍ	ባቅ.
ተሰብአ	ግ.
ሰብእ	ዘዘ.
ሰብአ ዓለም	
ሰብአ ኢትዮጵያ 	
ሰብአ አፍራስ	
ተሰንአለ	ግ.
ተሰአለ	ግ.
ተሰካተየ	ግ.
ተሰውጠ	ኢግ.
ሥዉጥ	ቅ.
ተሰጥወ	ርግ.
ይስጦ	ትን.አ.
ይሰጦ/ይሰጦ	ዘአ/ትአ.
ተሰጥዎ	ዘዘ.
ተሳለቀ	ግ.
ስላቅ	ዘዘ.
ተሳነነ	ኢግ.
ተስናን	ዘዘ.
ተስዐ	ርግ.
ተሳዒ	ቅ.
ትሱዕ	ቅ.
ትሳዔ	ዘዘ.
ትስዑ	አን.ቅ.
ተስዑ ደንግል	ተባ.ቅ.
ተስዓቱ	ተባ.ቅ.
ተስዓቱ ቅዱሳን 	
ተሱዕ/ተሱዓት	
ትስዕ	ዘዘ.
ታስዕ	ቅ.
ታስዓይ/ዓዊ	ተባ.ቅ.
ታስዓዊት/ይት	አን.ቅ.
ተስዓ	ዘዘ.
ተስፋ	ስ.
ተቀበለ	ርግ.
ቅበላ	ዘዘ.
ተቀነወ	ግ.
ተቀናደወ	ግ.
ተቀየመ	ግ.
ቂም	ዘዘ.
ተቈጥዐ	ግ.
ቍጥዓ	ዘዘ.
ተቀጸለ	ርግ.
ተቃለሰ	ግ.
ተቅላስ	ዘዘ.
ተቃረነ	ርግ.
ተቃራኒ	ቅ.
ቅራኔ	ዘዘ.
ተቃወመ	ግ.
ተቃዋሚ	ቅ.
ተቅራም	ስ.
ተቅሳም	ስ.
ተቅዋም	ስ.
ተቅዳ	ስ.
ተበቀለ	ግ.
በቀል	ዘዘ.
ተበአሰ	ግ.
ባእሰ	ዘዘ.
ተበኲረ	አግ.
ብኲርና	ምዘ.
በኲር	ቅ.
ተበውሐ	ግ.
ብውሕ	ቅ.
መባሕት	
ተባረጸ	ርግ.
ተቤሳ	ስ.
ተብሲል	ስ.
ተብዐ	ርግ.
ተባዒ	ቅ.
ተባዕ	ቅ.
ትቡዕ	ቅ.
ትብዐት	ሳዘ.
ትብዕ	ዘዘ.
ትብዕና	ምዘ.
ተባዕት	ምዘ.
ተባዕታዊ/ታይ	ቅ.
አትብዐ	አስ.አ.
ተታብዐ	ተዳ.አ.
አስተታብዐ	አዳ.አ.
ተኀለለ	ግ.
ተኀርመ	ግ.
ተኀጒለ	ግ.
ተነሐየ	ግ.
መናሕይ	ባቅ.
ተነበየ	ርግ.
ነቢይ	ቅ.
ነቢያት 	መድ.ቅ.
ትንቢት 	ምዘ.
ተነ	ኢግ.
አትነነ	አስ.አ.
ተን	ዘዘ.
ተነወረ	ግ.
ነውር	ዘዘ.
ተነጽለ	ግ.
ተናቀወ	ግ.
ተናደፈ	ግ.
ተንሐ	ርግ.
ትኑሕ	ቅ.
ትናሕ	ዘዘ.
ተንሕደ	ኢግ.
ተንሥአ	ኢግ.
ትንሣኤ	ዘዘ.
መንሥኢ	ቅ.
ተንበለ	ርግ.
ተንባሊ	ቅ.
መተንብል	ባቅ.
ተንባል	ቅ.
ተንባል	ቅ.
ተንባላታዊ/ታይ	ቅ.
ትንባሌ	ዘዘ.
ትንብልና 	ምዘ.
ተንተነ	ኢግ.
ትንቱን	ቅ.
ትንታኔ	ዘዘ.
ተንከራ	ስ.
ተንከተም	ስ.
ተንፈሰ	ኢግ.
እስትንፋስ 	ባዘ.
ተአረቀ	ርግ.
አራቂ	ቅ.
እርቅ	ዘዘ.
ተአርወየ	ግ.
ይትአረወይ	ትንአ.
ይትአርወይ	ዘአ/ትእ.
ተአርወዮ/ተ አርውዮት	ንአ.
አርዌ	ዘዘ.
ተአርዘ	ርግ.
አራዝ	ዘዘ.
ተአቅጸ	ግ.
ተአንሰሰ	ግ.
ይትአነሰስ	ትንአ.
ይትአንሰስ	ዘአ./ትአ.
ተአንስሶ/ተአንስሶት	ንአ.
እንሰሳ	ዘዘ.
ተአኀወ	ግ.
እኅው	ዘዘ.
እኁ	ዘዘ
ተአንበሰ	ግ.
አንበሳ	ዘዘ.
ተአንተለ	ርግ.
ተአንገደ	ግ.
እንግዳ	ዘዘ.
ተአውገ	ኢግ.
ተአይኀ	ግ.
ተአገለ	ርግ.
ተኣጋሊ	ቅ.
ትእግልት	ምዘ.
ተአጽፈ	ርግ.
ኡጹፍ	ቅ.
አጽፍ	ዘዘ.
ተከለ	ርግ.
ተካሊ	ቅ.
ተክል	ዘዘ.
ተተክለ	ግ.
ትኩል	ቅ.
ተኰሰ	ርግ.
ተከተ	አ./ርግ.
ትኩት	ቅ.
ትክቶ	ዘዘ.
ትካት	ዘዘ.
ተከነሰ	ግ.
ክናሴ	ዘዘ.
ተከወለ	ግ.
ከዋላ	ዘዘ.
ተከውረ	ርግ.
ተከውሰ	ኢግ.
ተከዘ	ኢግ.
ትኩዝ	ቅ.
ትካዜ	ዘዘ.
ተከፈ	ርግ.
መትከፍ	ባዘ.
ተካሀለ	ግ.
ተካየደ	ኢግ.
ኪዳን	ዘዘ.
ተካፈለ	ርግ.
ተኬንው	ባቅ.
ተክህነ	ርግ.
ተክለ	መዋ.
ተክሉ	ስ.
ተክሊል	ስ.
ተኲላ	ስ.
ተወተ	ርግ.
ቶታን	ምዘ.
ተወነ	ግ.
ተወን	ዘዘ.
ተወኀውኀ	ግ.
ተወከለ	ሥግ.
ውክል	ቅ.
ትውክልት	ምዘ.
ተውህሰ	ግ.
ዋህስ	ዘዘ.
ተዋቀሰ	ግ.
ተዋነየ	ግ.
ተዋከተ	ግ.
ተዋክሐ	ግ.
ተውር	ስ.
ተዐበየ	ግ.
ዕቡይ	ቅ.
ትዕቢት	ምዘ.
ተዐወረ	ርግ.
ተዓዋሪ	ቅ.
ተዐየረ	ርግ.
ተዓያሪ	ቅ.
ትዕይርት	ምዘ.
ተዐየነ	ግ.
ትዕይንት	ምዘ.
ተዐገሰ	ርግ.
ተዐጋሲ	ቅ.
ትዕግስት	ምዘ.
ተዘከረ	ርግ.
ተዝካር	ዘዘ.
ተዛወረ	ግ.
ተዝኅረ	ግ.
ይዜኅረ	ትአ.
ይዘኀር	ዘአ/ትአ
ትዝኅርት	ምዕ.
ዝኁር	ቅ.
ተየውኀ	ግ.
የዋኀ	ቅ.
ይዋኄ	ዘዘ.
ተደወለ	ኢግ.
ይዴሎ	ትንአ.
ይደሎ	ዘአ/ትአ.
ተደልዎ/ተደልዎት	ንአ.
ድልው	ቅ.
ተደመ	ኢግ.
መድምም	ባቅ.
ተደረ	ርግ.
ድራር	ምዘ.
ተደብተረ	ግ.
ተደንገለ	ግ.
ድንግልና	ምዘ.
ድንጋሌ	ዘዘ.
ድንግል	ቅ.
ተዳሂ	ስ.
ተዳረገ	ርግ.
ደርግ	ዘዘ.
ድርገት	ሳዘ.
ተዳበለ	ኢግ.
ደባል	ዘዘ.
ተዳወለ	ርግ.
ደወል	ዘዘ.
ተዳደቀ	ርግ.
ድድቅ	ዘዘ.
ተድህለ	ግ.
ተድባብ	ስ.
ተድኅረ	ግ.
ተገልበበ	ግ.
ግልቡብ	ቅ.
ተገረ	ኢ/ርግ.
መትገር	ባዘ.
ተገበረ	ርግ.
መስተገብር	ባቅ.
ተገዐዘ	ግ.
ጋዕዝ	ዘዘ.
ተገየረ	ግ.
ግዩር	ቅ.
ተጋብዐ	ግ.
ጉባዔ	ዘዘ.
ተጋነየ	ግ.
ተጋንዮ	ዘዘ.
ተጋወረ	ግ.
ጎር	ዘዘ.
ተጋደለ	ኢግ.
ተጋዳሊ	ቅ.
ገድል	ዘዘ.
ተጋድሎ	ዘዘ.
ተግሀ	ኢግ.
ተጋሂ	ቅ.
ትጉህ	ቅ.
ትግሀት	ሳዘ.
ትጋህ	ዘዘ.
አትግህ	አስ.አ.
ተግህሰ	ኢግ.
ግሁስ	ቅ.
ተግሣፅ	ምዘ.
ተግቢጥ	ስ.
ተጠበ	ግ.
ተጠብለለ	ግ.
ተጠወቀ	ግ.
ጥውቅ	ቅ.
ተጠየረ	ግ.
ጥያሬ	ዘዘ.
ተጣሐረ	ግ.
ተጰጰሰ	ግ.
ጳጳስ 	ዘዘ.
ተጸለለ	ግ.
ተጸርአ	ግ.
ተጸወሰ	ግ.
ተጸወገ	ግ.
ጸዋግ	ቅ.
ተጻብአ	ግ.
ጸብእ	ዘዘ.
ተጻባኢ	ቅ.
ተጽራሕ	ስ.
ተጽዕቀ	ግ.
ይጼዐቅ	ትንአ.
ይጸዕቅ	ዘአ/ትአ
ተጽዕቆ/ተጽዕቆት	ንአ.
ጼዕቅ	ዘዘ.
ተጽዕነ	ግ.
ተፀነሰ	ኢግ.
ፅኑስ	ቅ.
ተፅናስ	ዘዘ.
ተፀወነ	ግ.
ፀወን	ዘዘ.
ተፃመረ	ግ.
ፅምረት	ሳዘ.
ተፃረረ	ግ.
ተፃራሪ	ቅ.
ፀር	ዘዘ.
ተፅዕረ	ግ.
ፃዕር	ዘዘ.
ተፈሥሐ	ኢግ.
ፍሡሕ	ቅ.
ፍሥሓ	ዘዘ.
ትፍሥሕት	ምዘ.
ተወፈየ	ርግ.
ተፈግአ	ግ.
ፍግኣ	ዘዘ.
ተፉሕ	ስ.
ተፋሕ	ስ.
ተፍአ	ግ.
ተፋኢ	ቅ.
ትፍአት	ሳዘ.
ትፋእ	ዘዘ.
አትፍአ	አስ.አ.
ተፍዕመ	ርግ.
ፍዕም	ዘዘ.
ቱማ	ስ.
ቲቶ	ተጸ.ስ.
ታሕማ	ስ.
ታሪክ	ስ.
ታቦር	
ታቦት	ስ.
ታቦተ ኖኀ	
ታኦስ	ስ.
ታኦሎጎስ	ቅ.
ታኦፊላ	ተጸ.ስ.
ታግ	ስ.
ቴማን	ስ.
ቴቆሔ	ስ.
ቴቄል	(ሱር.)
ቴውናቅ	ስ.
ቴዳ	ስ.
ቴገነ	ርግ.
ቴገን	ስ.
ቴግሪ	ቅ.
ትሁል	ስ.
ትልሒት	ስ.
ትልም	ስ.
ትሕለ	ርግ.
ተሓሊ	ቅ.
መትሕል	ባቅ.
ትሕዝብት	ስ.
ትማልም	ስ.
ትምክህት	ስ.
ትራፕ	ስ.
ትንንያ	ስ.
ትእምርት	ስ.
ትካት	ስ.
ትክት/ትክቶ	ስ.
ትውጽሕት	ስ.
ትውፊት	ስ.
ትዕይንት	ስ.
ትግራይ	ቅ.
ቶማስ	ተጸ.ስ.
ቶራ	ስ.
ቶሬን	ስ.
ቶርማን	ስ.
ቶተነ	ርግ.
ቶታን	ዘዘ.
ቶታነ አሣዕን	
ኀለለ	ርግ.
ኅለት	ምዘ.
ኈለቈ	ርግ.
ኈላቍ	ቅ.
መኈልቍ	ባቅ.
ኍልቍ	ዘዘ.
ተኈለቈ	ተደ.አ.
ኊሉቍ	ቅ.
ኁላቌ	ዘዘ.
ኀለየ	ሥግ.
ኀላዪ	ቅ.
ተኀለየ	ተደ.አ.
ኅሉይ	ቅ.
ኅሊና	ምዘ.
ኅሊናዊ	ቅ.
ኀለየ	ር/ኢግ.
ኀላዪ	ቅ.
ማኅሌት	ባከ.
ማኅሌታዊ/ማኅሌታይ 	ቅ.
ማኀልይ	ባዘ.
ኀለደ	ርግ.
ኀለፈ	ኢግ.
ኀላፊ	ቅ.
ኅሉፍ	ቅ.
ኅልፈት	ሳዘ.
ኅላፍ	ዘዘ.
አኅለፈ	አስ.አ.
ምኅላፍ	ባዘ.
ተኀልፈ	ተደ.አ.
ተኃለፈ	ተዳ.አ.
ትኅላፍ	ባዘ.
አስተኃለፈ	አዳ.አ.
ኀልቀ	ኢ/ርግ.
ኅሉቅ	ቅ.
ኅልቀት	ሳዘ.
ኅልቅ	ዘዘ.
አኅለቀ	አድ.አ.
ማኅለቅት	ባከዘ.
ተኃለቀ	ተዳ.አ.
አስተኃለለቀ	አዳ.አ.
ኀመሰ	ርግ.
ኀማሲ	ቅ.
መኀምስ	ባቅ.
ተኀመሰ	ተደ.አ.
ኅሙስ	ቅ.
ኅማሴ	ዘዘ.
ኅምስ	ዘዘ.
ኅምስ	
ኀምስ አዋልድ	
ኀምስት/ኀምስቱ 	ተባ.ቅ.
ኅመስቱ ዕደው	
ኀሙስ	ቅ.
ኀምሳ	ቅ.
ኃምስ	ቅ.
ኃምሳይ	ቅ.
ኃምሲት	ስ.
ኀመየ	ርግ.
ኀማዪ	ቅ.
ተኀመየ	ተደ.አ.
ኅሙይ	ቅ.
ኅማዬ	ዘዘ
ማኅሜ	ምዘ.
ኀምር	ስ.
ኀምራዊ	ቅ.
ኀሠሠ	ርግ.
ኀሣሢ	ቅ.
ኀሠሣ	ዘዘ.
ማኀሠሥ	ባዘ.
መኈሥሥ	ባዘ.
ተኀሠ	ተደ.አ.
ኅሡሥ	ቅ.
ኁሣሤ	ዘዘ.
ታኅሣሥ	ባዘ.
ኀሠፈ	ርግ.
ተኀሥፈ	ተደ.አ.
ኀሡፍ	ቅ.
ኀሠፍ	ዘዘ.
ኀሥዐ	ኢግ.
አኅሥዐ	አስ.አ.
ኀረመ	ርግ.
ኅርመት	ምዘ.
ኀረሰ	ርግ.
ኅርስ	ዘዘ.
ኀራስ	ዘዘ.
ኀረወ	ርግ.
ኀራዊ	ቅ.
ተኀርወ	ተደ.አ.
ኅርው	ቅ.
ኅሮ	ዘዘ.
ኀረየ	ርግ.
ኀራዪ	ቅ.
ተኀርየ	ተደ.አ.
ኅሩይ	ቅ.
ኅርየት	ሳዘ.
ኅሬ	ዘዘ.
ኀርፈ	ርግ.
ኀሪፍ	ዘዘ.
ኀስር	ኢግ.
ኅሱር	ቅ.
ኅሳር	ዘዘ.
አኅሰረ	አድ.አ.
ኀበ	መግ.
ኀቤየ	
ኀቤነ	
ኀቤከ	
ኀቤክሙ	
ኀቤኪ	
ኀቤክን	
ኅቤሁ	
ኀቤሆሙ	
ኀቤሃ	
ኀቤሆን	
ኀበኀበ	መዋ.
ኀበለ	ኢ/ርግ.
ኀባሊ	ቅ.
አኅበለ	አስ.አ.
መኀብል	ባቅ.
ተኀበለ	ተደ.አ.
ኅቡል	ቅ.
ኅብል	ዘዘ.
ኀበበ 	ርግ.
ማኅበብ	ባዘ.
ኅባብ	ዘዘ.
ኅበነ	ርግ.
ኅባኔ	ዘዘ.
ኀበዘ	ርግ.
ኀባዚ	ቅ.
ኀብዝ	ዘዘ.
ተኀብዘ	ተደ.አ.
ኅቡዝ	ቅ.
ምኅባዝ	ባዘ.
ማኀበዝ	ባዘ.
ኀብል	ስ.
ኀብረ	ግ.
ኀባሪ	ቅ.
ተኃበረ	ተዳ.አ.
ኅቡር	ቅ.
አኃበረ	አስ.አ.
ኅብረት	ምዘ.
ኅብር	ዘዘ.
ማኅበር	ባዘ.
ማኀበራዊ	ቅ.
ማኅበርት	ባከዘ.
ኀብአ	ርግ.
ኀባኢ	ቅ.
ተኀብአ	ተደ.አ.
ኅቡእ	ቅ.
ኅቡኣዊ	ሳዘ.
ምኅባእ	ባዘ.
ኀተመ	ርግ.
ኀታሚ	ቅ.
ተኀትመ	ተደ.አ.
ኅቱም	ቅ.
ኅትመት	ሳዘ.
መኅተም 	ባዘ.
ኀተወ	ኢግ.
ኅትው	ቅ.
አኅተወ	አድ.አ.
ማኅቶት 	ባከዘ.
መኃትው/መኃትዋት 	ብቁ.
ማኅትው	ባቅ.
ኀነቀ	ርግ.
ኀናቂ 	ቅ.
መኅንቅ	ባቅ.
ተኀንቀ	ተደ.አ.
ኅኑቅ	ቅ
ኅንቀት	ሳዘ.
ኀነፊ	ቅ.
ኀንበበ	ርግ.
ኅንባብ	ዘዘ.
ኀንገዝ	ስ.
ኀንጸጸ	ርግ.
ተኀንጸጸ	ተደ.አ.
ኅንጻጽ	ዘዘ
ኀንፈጠ	ርግ.
ተኀንፈጠ	ተደ.አ.
ኀወወ	ርግ.
ኅዋ	ዘዘ.
ኀዘነ	ግ.
ኅዙን	ቅ.
መኀዝን	ባቅ.
ኀዘዘ	ግ.
ኀዝል	ስ.
ኀየለ	ኢ/ርግ.
ኀያል 	ቅ.
ኅዩል	ቅ.
ኀይል	ዘዘ.
ተኃየለ	ተደራ.አ.
ተኃያሊ	ቅ.
ትኅይልት	ሳዘ.
አስተኀየለ	አስ.አ.
መስተኃይል	ባቅ.
ኀዝኀዘ	ግ.
ኀዝኀዝ	ዘዘ.
ኀየል	ስ.
ኀየሰ	ኢግ.
ኂሳን	ዘዘ.
አኅየሰ	አስ.አ.
ኀየፀ	ርግ.
ኀያፂ	ቅ.
ኀይከል	ስ.
ኀይመት	ስ.
ኀደረ	ኢግ.
ኀዳሪ	ቅ.
ኅዱር	ቅ.
ኅድረት	ሳዘ.
አኅደረ	አስ.አ.
ማኅደር	ባዘ.
ኅዳር	
ኀደገ	ርግ.
ኀዳጊ	ቅ.
አኅደገ	አስ.አ.
ተኀድገ	ተደ.አ.
ኅዱግ	ቅ.
ኅድገት	ሳዘ.
ኅዳግ	ዘዘ.
ኅድገት	ምዘ.
ተኃደገ	ተዳ.አ.
አስተኃደገ	አዳ.አ.
ኀደፈ	ርግ.
ኀዳፊ	ቅ.
መኀድፍ	ባቅ.
ኀዳፍ	ቅ.ዘዘ.
ተኀደፈ	ተደ.አ.
ኅዱፍ	ቅ.
ኅዳፌ	ዘዘ.
ኀድዐ	ግ.
ኅድዓት	ምዘ.
ኅዱዕ	ቅ.
ኀገለ	ግ.
ኀግል	ዘዘ.
ኅጉል	ቅ.
ኀግል	ስ.
ኀጠ	ግ.
ኅጠት	ምዘ.
ኀጣጥ	ስ.
ኀጥአ	ርግ.
ኀጣኢ	ቅ.
ኃጥእ	ቅ.
ተኀጥአ	ተደ.አ.
ኅጡእ	ቅ.
ኅጥአት	ሳዘ.
ኀጢአት	ምዘ.
ኀጸወ	ርግ.
ኀጻዊ	ቅ.
ተኀጽወ	ተደ.አ.
ኅጽው	ቅ.
ኅጽወት	ሳዘ.
ኀጸደ	ርግ.
ኅጻድ	ዘዘ.
ኀጺን	ስ.
ኀጽረ	ግ.
ኀጺር	ቅ.
ኅጹር	ቅ.
ኅጽረት	ሳዘ.
አኅጸረ	አስ.አ.
ኀፀበ	ርግ.
ኀፃቢ	ቅ.
ተኀፅበ	ተደ.አ.
ኅፁብ	ቅ.
ኅፅበት	ሳዘ.
ኅፃብ	ዘዘ.
ምኅፃብ	ባዘ.
ማኅፀብ	ባቅ.
ኀፈጠ	ርግ.
ኀፋጢ	ቅ.
ኀፈደ	ርግ.
ማኅፈድ	ባዘ.
ኀፍረ	ግ.
ኀፋሪ	ቅ.
አኅፈረ	አስ.አ.
አኅፋሪ	ቅ.
ማኅፈሪ	ባቅ.
ተኀፍረ	ተደ.አ.
ኅፉር	ቅ.
ኁፋሬ	ዘዘ.
ኀፍረት	ዘዘ.
ኀፍረተ ብእሲት	
ኀፍረተ ብእሲ	
ማኅፈር	ባቅ.
ምኅፍር	ባቅ.
ማኅፈረት	ባከዘ.
ኃል	ስ.
ኃልት	ስ.
ኃበረ	ግ.
ኃባሪ	ቅ.
ተኃበረ	ተደ.አ.
ኅቡር	ቅ.
ኅብር	ስ.
ኅብረ መጽርይ	
ኅብረ ወርቅ	
ኅብረሐመድ	
ኅብረብሔር	
ኅብረ ትርኢት	
ኄለ	ግ.
ኄረ	ግ.
ኄር	ቅ.
ኂሩት	ሳዘ.
ኄረወ	ርግ.
ኂሩት	ምዘ.
ኂርውና	ምዘ.
ኄጠ	ርግ.
ኀያጢ	ቅ.
ተኅይጠ	ተደ.አ.
ኅይጥ	ቅ.
ኂጠት	ሳዘ.
ኂጣን	ምዘ.
ኅላፍ	ስ.
ኅልቀት	ስ.
ኅልቀተ ወርቅ 	
ሐልቀተ ብሩር	
ኅልድ	ስ.
ኅሥሥት	ስ.
ኅሬ	ስ.
ኅብስት	ስ.
ኅንቅርት	ስ.
ኅንባዝ	ስ.
ኅንብርብሬ	ስ.
ኅንዝዝ	ስ.
ኅንጽዋል	ስ.
ኅውር	ቅ.
ኅዳጥ	ቅ.
ኅጠት	ስ.
ኅዝአት	ስ.
ኅዳር	ስ.
ኅጥሜ	ስ.
ኆሠ	ግ.
ተኀውሠ	ተደ.አ.
ኅውሥ	ቅ.
ኁሠት	ሳዘ.
ኆኅ	ስ.
ኆኅት	ስ.
ኆበር	ርግ.
ኁባሬ	ዘዘ.
ኆፃድ	ስ.
ኆፃ	ስ.
ኆፃባሕር	
ነሀረ	ኢግ.
ነሃር	ዘዘ.
ምንሃር	ባዘ.
ነሐሰ	ርግ.
ነሐሲ	ቅ.
ናሕስ	ዘዘ.
ነሐሴ	ስ.
ነሐበ	ርግ.
ነሐቢ	ቅ.
ምንሓብ	ባዘ.
ነሐብት	መድ.
ነምር	ስ.
ነሥአ	ርግ.
ነሣኢ	ቅ.
ነስረ	ኢግ.
ነስር	ዘዘ.
ንስር	ስ.
ነሰቀ	ርግ.
ንስቀት	ሳዘ.
ነሰተ	ርግ.
ነሳቲ	ቅ.
ንስተት	ሳዘ.
ነሰከ	ርግ.
ነሳኪ	ቅ.
መንሰክ	ባዘ.
መንሰከ አድግ	
ነሰገ	ርግ.
መንስግ	ባዘ.
ነስሐ	ኢግ.
ንስሐ	ዘዘ.
ነሳሒ	ቅ.
ነስነሰ	ርግ.
መነሳንስ	ባዘ.
ነቀለ	ርግ.
ነቈረ	ግ.
ነቋር	ቅ.
ነቀሰ	ርግ.
ነቀበ	ርግ.
ነቀወ	ሥግ.
ነቃዊ	ቅ.
ንቃው	ዘዘ.
ንቃወ አራዊት 	
ዘእንበለ ይንቁ ዶርሆ 	
ነቈጠ	ርግ.
ነቁጥ	ስ.
ነቀፈ	ረግ.
ነቅሐ	ኢግ.
ንቁሕ	ቅ.
ነቂሕ	ንአ.
ንቃሕ	ዘዘ.
ንቅሐት	ሳዘ.
ነቅሪስ	ስ.
ነቅዐ	ኢግ.
ነቅዕ	ዘዘ.
ነቅዘ	ግ.
ነቀዝ	ዘዘ.
ነቅጸ	ኢግ.
ነበረ	ግ.
ንቡር	ቅ.
ነባሪ	ቅ.
መንበር	ባዘ.
ነባር	ቅ.
ምንባር	ባቅ.
ነበርጸወ	ግ.
ነበርጻው	ዘዘ.
ነበበ	ርግ.
ነባቢ	ቅ.
ንባብ	ዘዘ.
ነቢብ	ንአ.
ንበት	ሳዘ.
ምንባብ	ባዘ.
ንበዘ	ግ.
ንቡዝ	ቅ.
ነበየ	ርግ.
ነቢይ	ቅ.
ነበጠ	ኢግ.
እንቡጥ	ባዘ.
አንበጣ	ስ.
ነብሐ	ኢግ.
ንብሐት	ሳዘ.
ነብሕ	ዘዘ.
ነብዐ	ኢግ.
አንብዕ	ባዘ.
ነትረ	ኢግ.
ንቱር	ቅ.
ነትአ	ኢግ.
ነትእ	ዘዘ.
ነትገ	ኢግ.
ንቱግ	ቅ.
ኑታጌ/ንትጋ	ዘዘ.
ነአከ	ርግ.
ናእክ	ዘዘ.
ነአደ	ርግ.
ንኡድ	ቅ.
ነከረ	ርግ.
ነኪር	ቅ.
ነከራ	ዘዘ.
ነከየ	ርግ.
መንካ	ባዘ.
ነክነከ	ርግ.
ነክዐ	ርግ.
አንኩዕ	ባዘ.
ነኮለለ	ኢግ.
ንኩሉል	ቅ.
ነኮለል	ዘዘ.
ነወየ	ርግ.
ንዋይ	ዘዘ.
ንዋየ ለብሓ	
ንዋየ ሐቅል	
ንዋየ ውስጥ	
ንዊኅ	ቅ.
ነዋ	ተግ.
ነዋ ወልድኪ	
ነዌ	ስ.
ነውር	ስ.
ነዐለ	ርግ.
ነዓል	ዘዘ.
ናዕል	ዘዘ.
ነዐተ	ርግ.
ናዕት	ዘዘ.
ነዐወ	ርግ.
ነዓዊ	ቅ.
ተንዕወ	ተደ.አ.
ንዕው	ቅ.
ንዕወት	ሳዘ.
ምንዓው	ባዘ.
ነዐ	ትአ.
መጻእከ	
ትመጽእ	
ትምጻእ	
ነዐ	
ተነዐውከ	
ትትነዐው	
ትትንዐው	
ነዓውልት	ስ.
ነዘረ	ርግ.
አንዘረ	አስ.አ.
እንዚራ	ስ.
ነዘፈ	ርግ.
ነዚፋ	ዘዘ.
ነዝነዘ	ርግ.
ነዝኀ	ግ.(ቀተ.)
ነዛኂ	ቅ.
ተነዝኀ	ተደ.አ.
ንዙኅ	ቅ.
ነየ	ተግ.
ነደለ	ርግ.
ነደቀ	ርግ.
ንድቅ	ዘዘ.
ነዳቂ	ቅ.
ነደቅት	መድ.
ነደ 	ኢግ.
ነዳዲ	ቅ.
ንዱድ	ቅ.
ነድ 	ዘዘ.
ምንዳድ	ባዘ.
ነደፈ	ርግ.
ነዳፊ	ቅ.
ምንዳፍ	ባቅ.
ነድዐ	ርግ.
ነዳዒ	ቅ.
ምንዳዕ	ባዘ.
ነዳዕት	መድ.
ነድየ	ግ.
ነዳይ/ንዱይ	ቅ.
ንድየት/ንዴት	ሳዘ.
ነገረ	ርግ.
ነጋሪ	ቅ.
ነገር	ዘዘ.
ነገርጋር	ስ.
ነጐርጓር	ስ.
ነገደ	ርግ.
ነጋዲ	ቅ.
ነግድ	ዘዘ.
ነገድ	ዘዘ.
መንገድ	ባዘ.
ተአንገደ	ተደ.አ.
እንግዳ	ዘዘ.
ነጐድጓድ	ስ.
ነገፈ	ርግ.
ንጋፍ	ዘዘ.
ነጌ	ስ.
ነግሀ	ኢግ.
ነግህ	ዘዘ.
ነግሠ	ኢግ.
ነጋሢ	ቅ.
ንጉሥ	ቅ.
ንግሥት	ቅ.
ንግሥ	ዘዘ.
መንግሥት	ባከዘ.
ነገሥት	መድ.
ነግሥ	ስ.
ነጠረ	አ./ርግ.
ንጥር	ዘዘ.
ንጥረ መባርቅት	
ነጠፈ	ርግ.
ንጡፍ	ቅ.
ነጥበ	ኢግ.
ነጥብ	ዘዘ.
ነጠብጣብ	ስ.
ነጸረ	ኢግ.
ነጻሪ	ቅ.
መንጽር	ባቅ.
ነጸረ	ርግ.
ነጻሪ	ቅ.
ተነጸረ	ተደ.አ.
ንጹር	ቅ.
መነጽር	ባዘ.
ንጻሬ	ዘዘ.
አንጸረ	አስ.አ.
አንጻር	ዘዘ.
ነጸየ	ርግ.
ነጻዪ	ቅ.
አንጸየ	አስ.አ.
አንጺዋ	ስ.
ነጸፈ	ርግ.
ነጻፊ	ቅ.
ተነጽፈ	ተደ.አ.
ንጹፍ	ቅ.
ነጽፍ	ዘዘ.
መንጸፍ/ምንጻፍ	ባዘ.
ነጽሐ	ኢግ.
ንጹሕ	ቅ.
ንጽሕ	ዘዘ.
ንጽሕና	ምዘ.
ምንጻሕ	ባዘ.
ንጽፈ	ግ.
ነጾራር	ስ.
ነፀወ	ኢግ.
ነፅረረ	ኢግ.
ነፀራር	ቅ.
ንፅራር	ዘዘ.
ነፅኀ	ርግ.
ንፁኀ	ቅ.
ብእሲ ዘያነፅኆ ጋኔን	
ነፈረ	ኢግ.
ነፈሰ	ግ.
ነፍስ	ዘዘ.
ነፍስት	ምዘ.
ነፋስ	ዘዘ.
መንፈስ	ባዘ.
ነፈቀ	ርግ.
ንፍቅ	ቅ.
መንፈቅ	ባዘ.
ንፍቅ	ዘዘ.
መንፈቅ ኅብስት	
መንፈቀዓመት	
ንፍቀ ክበብ	
ነፈየ	ርግ.
መንፌ	ባዘ.
ነፈገ	ርግ.
ንፉግ	ቅ.
ንፍገት	ሳዘ.
ነፈጠ	ግ.
ነፍጥ	ዘዘ.
ነፍጎ	ርግ.
ነፋኂ	ቅ.
ተነፍኀ	ተደ.አ.
ንፉኀ	ቅ.
ምንፋኅ	ባቅ.
ነፍሰ	ግ.
ነፍቅ	ስ.
ነፍነፈ	ኢግ.
ነፍኒፍ	ዘዘ.
ነፍጸ	ግ.
/ኑ/	
/ኒ/	
/አፍቅረ-ኒ/ = አፍቀረኒ	
/አፍርከ-ኒ/=አፍቀርከኒ	
/አፍቀርክ-ኒ/=አፍቀርከኒ	
/አፍቀር-ኡኒ/=አፍቀሩኒ	
/አፍቀር-ኣኒ/=አፍቀራኒ	
/አፍቀርክ-ምኡኒ/=አፍቀርክሙኒ	
/አፍቀርክ-ንኣኒ/= አፍቀርክናኒ	
ኒል	ስ.
ኒቆታ	ስ.
ኒካዑ	ቅ.
/ና/	
(ወልድ-ና)= ወልድና	
ናሁ	ተግ.
ናህብ	ስ.
ናህንሐ	ግ.
ንህኑሕ	ቅ.
ናህክ	ስ.
ናህው	ስ.
ናህይ	ስ.
ናሆም	ተጸ.ስ.
ናላ	ስ.
ናሕስየ	ግ.
ናሕስ	ስ.
ናሕብ	ስ.
ናሕፅ	ስ.
ናሕፈጠ	ርግ.
ናርዱ	ስ.
ናርዶስ	ስ.
ናርፃ	ስ.
ናሴብ	ስ.
ናስታ	ስ.
ናቀት	ስ.
ናብሊስ	ስ.
ናእት	ስ.
ናእክ	ስ.
ናዘዘ	ርግ.
ናዛዚ	ቅ.
ኑዛዜ	ዘዘ.
ናይናን	ግ.
ናይን	ቅ.
ናግራን	ስ.
ናጥራን	ስ.
ናፈቀ	ርግ.
ናፋቂ	ቅ.
መናፍቅ	ባቅ.
ኑፋቄ	ዘዘ.
ናፌል	ቅ.
/ኔ/	
ኔስ	ስ.
ኔባል	ስ.
/ን/	
ንህብ	ስ.
ንህከ	ግ.
ናህክ	ዘዘ.
ንህየ	ኢግ.
ንሁይ	ቅ.
ናህይ	ዘዘ.
አንሀየ	አስ.አ.
መናህይ	ባቅ.
ንሓስ	ስ.
ንሕረ	ግ.
ንሕነ	(ተስ.)
ንሕየ	ርግ.
ንስሕት	ስ.
ንስር	ስ.
ንስቲት	ቅ.
ንብሌስ	ስ.
ንብቲራ	ስ.
ንትፉይ	ስ.
ንኅለ	ግ.
ንኁል	ቅ.
ንእደ	ርግ.
ንኣዲ	ቅ.
ተንእደ	ተደ.አ.
ንኡድ	ቅ.
ንኩህ	ስ.
ንዋይ	ስ.
ንዕሰ	ግ.
ንዑስ	ቅ.
ናዕስ	ዘዘ.
ንዕከ	ግ.
ንዑክ	ቅ.
ንዕደ	ግ.
ንዑድ	ቅ.
ንዝህላል	ስ.
ንጥኑጥ	ስ.
ንጽቢን	ስ.
ኖለወ	ርግ.
ኖላዊ	ቅ.
ኖሎት	
ኖመ	ኢግ.
ንዉም	ቅ.
ንዋሚ	ቅ.
ንዋም	ዘዘ.
ምንዋም	ባዘ.
ኖተወ	ርግ.
ኖታዊ	ቅ.
ኖትያ	ቅ.
ኖኀ	ግ.
ነዊኅ	ቅ.
ኑኅ	ዘዘ.
ኖኅ	ተጸ.ስ.)
ኖን	ስ.
አህለየ	ርግ.
ህልያን	ምዘ.
አለለ	ርግ.
አለሌ	ዘዘ.
አለሚዳን	ስ.
አለስ	ስ.
አለቅት	ስ.
አለደ	ርግ.
ምዕላድ	ባዕ.ቅ.
አለገ	ርግ.
አላ	መፃ.
አላቲኖን	ስ.
አላዳስ	ስ.
አሌ	ተግ.
አሌ ሊተ	
አሌ ለነ	
አሌ ለከ	
አሌ ለክሙ	
አሌ ለኪ	
አሌ ለክን	
አሌ ሎቱ	
አሌ ሎሙ	
አሌ ላ/ላቲ	
አሌ ሎን	
"አለ ለክሙ እለተሐውሩ ኀበ ብእሲተ ብእሲ" 	
አሌለየ	ኢግ.
አሌፍ	
አልሀየ	ርግ.
አልመደ 	ርግ.
አልባስጥሮስ	ስ.
አልቦ	ነግ.
አልብየ	
አልብነ	
አልኀየ	ርግ.
አልኆሰሰ	ሥግ.
ለኆሳስ	ዘዘ.
አልከወ	ርግ.
አልወ	ርግ.
አልው	ስ.
አልያጦን	ስ.
አልጌን	ስ.
አልፈፈ	ግ.
አሐደ	ርግ.
አሐዱ	ዘዘ.
አሐድ	ቅ.
አሐት	
አሐቲ	ቅ.
እሑድ	ስ.
አሕለለ	ርግ.
አሕመልመለ	ግ.
ሐመልማል	ዘዘ.
ሐመልማላዊት	ቅ.
አመልትሐ	ርግ.
አመልታሒ	ቅ.
አመልአ	ግ.
አመሥጠረ	ርግ.
አመሥጣሪ	ቅ.
ምሥጢር	ዘዘ.
አመረ	ርግ.
እሙር	ቅ.
እማሬ	ዘዘ.
ትእምርት	ባከዘ.
ተአምር	ባዘ.
ምእማር	ባዘ.
መስተአምር	ባ.ቅ.
አሚሮ	ቦአ.
አሚር	ስ.
አመረ	ርግ.
አማሪ	ቅ.
ማእምር	ባቅ.
አእመረ	አስ.አ.
አእምሮ	ዘዘ.
ተአምረ	ተደ.አ.
እሙር	ቅ.
አሚሮ	ቦአ.
አመርግሐ	ርግ.
አመርጋሒ	ቅ.
መርግሕ	ዘዘ.
አመስነወ	ርግ.
ምስንው	ቅ.
ምስናዌ	ዘዘ.
አመስከወ	ርግ.
አመስካዊ	ቅ.
አመተ	ርግ.
እመት	ዘዘ.
አመት	ስ.
አመንሰወ	ርግ.
ምንስው	ቅ.
መንሱት	ም.ዘ.
ምንሳዌ	ዘዘ.
አመንተወ	ርግ.
ምንትው	ቅ.
መንታ	ዘዘ.
ምንታዌ	ዘዘ.
አመንዘረ	ኢግ.
አመንዛሪ	ቅ.
አመንዘዘ	ኢ/ርግ.
ምንዛዜ	ዘዘ.
ምንዙዝ	ቅ.
አመክነየ	ግ.
ምክንያት	ም.ዘ.
አመክዐበ	ርግ.
ምክዕቢት	ዘዘ.
አመክዒቦ	ቦአ.
አመዝገነ	ግ.
አመደ	ርግ.
አማዲ	ቅ.
አምድ	ዘዘ.
አመድለወ	ግ.
አመድባሊ	ቅ.
መድበል	ዘዘ.
አመፀ	ርግ.
አማፂ	ቅ.
አመፅ	ዘዘ.
አመፃ	ዘዘ.
አሚን	
አማኑኤል	
አማን	ስ.
አማዑት	ስ.
አማዕቀበ	ግ
ምዕቅብና	ባከዘ.
አማዕበለ	ግ.
ማዕበል	ዘዘ.
አማዕተበ	ርግ.
ማዕተብ	ዘዘ.
አማዕከለ	ርግ.
ማዕከል	ዘዘ.
አሜ	መዋ.
እስከ አሜ ሞትየ	
ፀሐይ ዘአሜክረምት	
አሜሃ	ተግ.
አሜር	ስ.
አሜከላ	ስ.
አሜፌት	ስ.
አምላክ	ስ.
አምሐረ	ርግ.
የመሐረ	አስ.አ.
አምሐራ	
አምሠጠ	ግ.
መምስጥ	ባ.ቅ.
አምረረ	ርግ.
አምበር	ስ.
አምትንት	ስ.
አምነ	ርግ.
አሚን	ዘዘ.
አማኒ	ቅ.
አማን	ዘዘ.
አማናዊ	ቅ.
ምእመን	ባዘ.
እምነት	ሳዘ.
ተአምነ	ተደ.አ.
እሙን	ቅ.
አምአተ	ርግ.
ምእት	ዘዘ.
አምእስት	ስ.
አምዕዐ	ርግ.
አምድ	ስ.
አምጣነ	መግ.
አሠረ	ርግ.
ተአሥር	ተደ.አ.
እሡር	ቅ.
ማእሠር	ባዘ.
አሠር	ስ.
አሥቅ	ስ.
አሥገረ	ርግ.
አሥጋሪ	ቅ.
መሥገርት	ባከዘ.
አረመ	ርግ.
አረም	ዘዘ.
አረሚ	ቅ.
አረቦን	ስ.
አረወ	ርግ.
አርዌ	ዘዘ.
አርዌ ባሕር	
አርዌ ብርት	
አርዌ ቤት	
አርዌ ምድር	
አርዘ	ርግ.
እሩዝ	ቅ.
አራዝ	ዘዘ.
አረጊት	ቅ.
አረጋዊ	ቅ.
አረግ	ስ.
አረፈ	ርግ.
አረፍት	ምዘ.
አሪስ	ስ.
አራራት	ስ.
አራራይ	ስ.
አራሲብ	ስ.
አርመመ	ኢግ.
አርማሚ	ቅ.
አርምሞ	ዘዘ./ንአ.
አርመስመሰ	ርግ.
አርመደ	ርግ.
አርመፀ	ርግ.
ረመፅ	ዘዘ.
አርማሚ	ስ.
አርማስ	ስ.
አርማስቆስ	ስ.
አርሜስ	ስ.
አርሰየ	ርግ.
አርስሐ	ርግ.
አርሰን	ስ.
አርቆማን	ስ.
አርበቅ	ስ.
አርባብ	ስ.
አርባዕ	ስ.
አርብሐ	ርግ.
አርቴው	ስ.
አርኀወ	ርግ.
አርኃዊ	ቅ.
መርኆ	ባዘ.
አርአየ	ርግ.
አርአያ	ዘዘ.
አርአያ	መዋ.
ሐሊ አርአያ ሰብእ	
አርክ	ስ.
አርወየ	ርግ.
አርወየ	ግ.
አርዑት	ስ.
አርዝ	ስ.
አርያም	ስ.
አርዮስ	ተጸስ.
አርድዮን	ስ.
አርጋ	ስ.
አርጋኖን	ስ.
አርጢባስ	ስ.
አርጤምስ	ስ.
አርፖፔ	ስ.
አርድዮን	ስ.
አሰም	ስ.
አሰረ	ርግ.
አሱር	ቅ.
ማእሰር	ባዘ.
ማእሰረ ልሳን	
ማእሰር ተዋስቦ	
አሰሰለ	ርግ.
አሰ	ርግ.
አስት	ስ.
አሶ	ስ.
እሳት	ምዘ.
እሳተገሃነም	
እሳተሕይወት	
እሳተመለኮት 	
እሳታዊ	ቅ.
አስ	
አስሐዊ	ቅ.
አስሐትያ	ስ.
አስሐየ	ርግ.
አስመከ	ርግ.
ምስማክ	ባዘ.
አስራብ	ስ.
አስቀጢን	ስ.
አስቄጥስ	ስ.
አስቆረረ	ርግ.
አስቈቀወ	ግ.
አስተ	
አስተሀበበ	ግ.
አስተላክአ	ርግ.
አስተሐለፈ	ርግ.
አስተሐመመ	ርግ.
አስተሐዘበ	ግ.
አስተሐየወ	ርግ.
አስተሐየፀ	ርግ.
አስተማወቀ	ርግ.
አስተሣነየ	ርግ.
አስተራከበ	ርግ.
አስተርኀቀ	ርግ.
አስተርአየ	አ.ግ.
አስተርእዮ	ስ.
አስተርከበ	ርግ.
አስተርክቦ	ዘዘ.
አስተሰንአለ	ሥግ.
አስተሰንኣሊ	ቅ.
አሰተብረከ	ኢግ.
አስተብቍዐ	ርግ.
መስተብቍዕ	ባቅ.
አስብቋዒ	ቅ.
አስተብፅዐ	ርግ.
ብፁዕ	ቅ.
አስተተ	ርግ.
አስተኃዘለ	ግ.
መስተኃቅር	ባቅ.
አስተናስዐ	ርግ.
አስተናበረ	ርግ.
አስተናደፈ	ርግ.
አስተናገደ	ርግ.
አስተናጕዐ	ርግ.
አንጕዕ	ባዘ.
አስተናጽሐ	ርግ.
አስተንአሰ	ርግ.
አስተአረየ	ርግ.
አስተአኀዘ	ርግ.
አስተአፀበ	ርግ.
አስተዋሐደ	ርግ.
አስተደኀረ	ርግ.
አስተዳለወ	ርግ.
አስተዳጐፀ	ርግ.
አስተጋብዐ	ርግ.
እስትግቡዕ	ቅ.
መስተጋብዕ	ባዕ.ቅ.
አስተጋየፀ	ርግ.
አስተጓህነወ	ርግ.
ጕህና	ዘዘ.
አስተፍነከ	ርግ.
አስትዐ	ርግ.
አስትዓ	ዘዘ.
አስኦዘዘ	ርግ.
አስከሬን	ስ.
አስካል	ስ.
አስካሮን	ስ.
አስኬማ	ስ.
አስክት	ስ.
አስፈሊጡ	ስ.
አስፈሊጥ	ስ.
አስፈሊጦስ	ስ.
አስፈሬድ	ስ.
አስፈር	ስ.
አስፋርስ	ስ.
አስፌድለወ	ሥግ.
አስፌድላዊ	ቅ.
አሶር	ስ.
አሶርዮን	ስ.
አሶት	ስ.
አቀመ	ርግ.
አቂቅ	ስ.
አቃረየ	ርግ.
አቃቂር	ስ.
አቃኒ	ስ.
አቃጥን	ስ.
አቅላሜዳን 	ስ.
አቅሌስያ	ስ.
አቅተወ	ርግ.
አቅዜዘየ	ሥግ.
አቅየሐይሐ	ግ.
አበለ	ግ.
አበሜ	ስ.
አበርጊላ	ስ.
አበሰ	ርግ.
አባሲ	ቅ.
አበሳ	ዘዘ.
አቡስ	ቅ.
አበቀ	ግ.
አበቅ	ዘዘ.
አበቅቴ	ስ.
አበበ	ርግ.
አባ	ስ.
አብ	ስ.
አበላህም	
አበምኔት	
አብና	
አቡን	
አቡን	
አበደም	
አበባ	ስ.
አበነ	ግ.
አእበነ	አስ.አ.
እብን	ዘዘ.
እብነመዳልው	
እብነማእዘንት	
እብነሞፀፍ	
እብነሰንፔር	
እብነበረድ	
እብነአስሐትያ	
እብነ እዝኅ	
እብነ አድማስ	
እብነ ኰኲሕ	
አበየ	ግ.
አበጠ	ርግ.
አቡቀለምቢስ	ስ.
አባል	ስ.
አባጉንባሕ	ስ.
አቤል	ተጸ.ስ.
አቤሜሌክ	ተጸስ.
አብላሊት	ስ.
አብሐ	ርግ.
መባሕት	ባከ.
አብሠረ	ርግ.
አብሣሪ	ቅ.
መበሥር	ባቅ.
ብሥራት	ምዘ.
አብረክሊስ	ስ.
አብርሃም	ተጸስ.
አብቀወ	ርግ.
አብኅዐ	ርግ.
ብኁእ	ዘዘ.
አብነት	ስ.
አብኑስ	ስ.
አብኲሐ	ግ.
ምብኳሕ	ባዘ.
አብደ	ኢግ.
አባዲ	ቅ.
እቡድ	ቅ.
አብድ	ቅ.
እበድ	ዘዘ.
አእበደ	አድ.አ.
አእባዲ	ቅ.
መስተአብድ	ባቅ.
አብደረ	ርግ.
አብጠለ	ርግ.
አብጥሊስ	
አብጥልማሆ	ስ.
አቦሊ	ስ.
አተርጋዎን	ስ.
አተብሰለ	ርግ.
ተብሲል	ዘዘ.
አተተ	ኢግ.
አታቲ	ቅ.
ተአተተ	ተደ.አ.
እቱት	ቅ.
እታቴ	ዘዘ.
አተወ	ኢግ.
አታዊ	ቅ.
አትወት	ሳዘ.
አትሮንስ	ስ.
አትከለ	ርግ.
አኀወ	ግ.
እኅው	ዘዘ.
እኅት	ምዘ.
እኅውና	ምዘ.
ተአኀወ	ተዳ.አ.
አኀዘ	ርግ.
አኃዚ	ቅ.
ተእኅዘ	ተደ.አ.
እኁዝ	ቅ.
አኃዝ	ዘዘ
አስተአዘ	አዳ.አ.
መስተእኅዝ	ባቅ.
አኅዘዘ	ርግ.
አነ	
አነመ	ርግ.
አናሚ	ቅ.
ተአንመ	ተደ.አ.
እኑም	ቅ.
ምእናም	ባቅ.
ቤተምእናም	
አነምት	መድ.ቅ.
ማኅበረ አነምት 	
አነዳ	ስ.
አናሕሰየ	ርግ.
አናሕሳዪ	ቅ.
አናብለሰ	ርግ.
አናብሊስ	ዘዘ.
አናንያ	ተጸ.ስ.
አናጉንስጡስ	ስ.
አን	ምዕ.
አንሐ	ግ.
አንሕስት	ስ.
አንሰሰ	ግ.
አንስሳ	ዘዘ.
አንሳሕለለ	ኢ/ርግ.
አንሳሕስሐ	ሥግ.
አንሳሕሳሒ	ቅ.
አንሳሕስሖ	ዘዘ.
አንሶስወ	ግ.
ነሶሳው	ዘዘ.
አንሶሳዊ	ቅ.
አንሶጠጠ	ግ.
አንትዐ	ርግ.
አንቀልቀለ	ሥግ.
አንቀልቃሊ	ቅ.
አንቀጽ	ስ.
አንቀጽ ዓቢይ	
አንቀር	ስ.
አንቃለል	ስ.
አንቃዕደወ	ሥግ.
አንቃዕዳዊ	ቅ.
አንቄ	ስ.
አንቆራ	ስ.
አንቆቅኆ	ስ.
አንበልበለ	ኢ/ርግ.
ነበልባል	ዘዘ.
አንበረ	ርግ.
አንበሪ	ስ.
አንበስበሰ	ግ.
አንበሳ	ስ.
አንበበ	ርግ.
አንበዘ	ግ.
እንቡዝ	ቅ.
እንባዜ	ዘዘ.
አንበጣ	ስ.
አንባሕቀወ	ርግ.
አንባሕብሐ	ግ.
አንብዐ	ርግ.
አንብዕ	ዘዘ.
አንቦጣ	ስ.
አንከረ	ርግ.
ንኩር	ቅ.
መንክር	ባቅ.
አንኰርኰረ	ርግ.
መንኰራኲር	ባዘ.
ነኰርኳር	ዘዘ.
አንክሶ	ስ.
አንኮለለ	ግ.
ነኮላል	ዘዘ.
አንወረ	ርግ.
ንውር	ቅ.
ነውር	ዘዘ.
አንዘረ	ርግ.
እንዚራ	ዘዘ.
አንዛሪ	ቅ.
አንዛህለለ	ግ.
አንደደ	ርግ.
አንደባራ	ስ.
አንገለገ	ሥግ.
አንግልጋ	ዘዘ.
አንገዝ	ስ.
አንገፈ	ርግ.
አንጐድጐደ	ርግ.
ነጐድጓድ	ዘዘ.
አንጐገወ	ግ.
ነጐጋው	ዘዘ.
እንጒግው	ቅ
አንጒዐ	ርግ.
አንጒዕ	ዘዘ.
አንጌቤን	ስ.
አንጌገየ	ሥግ፣
አንጊጉይ	ቅ.
አንጦለለ	ርግ.
አንጠበጠበ	ርግ.
ነጠብጣብ	ዘዘ.
አንጠየ	ርግ.
አንጠጠ	ርግ.
አንጸረ	ርግ.
አንጸረረ	ግ.
አንጸዋ	ስ.
አንጸፈ	ርግ.
አንጸፍጸፈ	ርግ.
አንፀብረቀ	ርግ.
ነፀብራቅ	ዘዘ.
አንፄዋ	ስ.
አንፆረረ	ግ.
አንፈረ	ርግ.
አንፈርዐፀ	ግ.
ነፈርዓፅ	ዘዘ.
አንፈሰ	ኢ/ርግ.
አንፍ	ስ.
አአትረኮን	ስ.
አኤል	ስ.
አኤናዎን	ቅ.
አእመረ	ግ.
አእማሪ	ቅ.
አእመነ	ግ.
አእተተ	ርግ.
አእኰተ	ርግ.
አከለ	ግ.
አኰተ	ርግ.
አኳቲ	ቅ.
እኳቴ	ዘዘ.
አኰቴት	ምዘ.
ማእኰት	ባዘ.
ተኣኰተ	ተደ.አ.
እኩት	ቅ.
አእኰተ	አስ.አ.
አእኳቲ	ቅ.
አከክ	ስ.
አካሂ	ስ.
አካል	ስ.
አካዕ	
አክሊል	ስ.
አክላስ	ስ.
አክለፎስ	ስ.
አክሞሰሰ	ሥግ.
አክሞሳሲ	ቅ.
አክሞተተ	ርግ.
አክርማ	ስ.
አክራጦን	ስ.
አክሲማሮስ	
አክወሰ	ርግ.
አክዮስ	ትአ.
አክፋር	ስ.
አኮሰ	ርግ.
አኮት	ስ.
አኮኑ	መግ.
አኮ	
አከፈ	ርግ.
አወሰ	ርግ.
አወተ	ርግ.
አወት	ዘዘ.
አወፈየ	ግ.
አው	መፃ.
አውለወ	ግ.
አውል	ስ.
አውልዕ	ስ.
አውሎ	ስ.
አውሎአ	ስ.
አውሎጊያ	ስ.
አውሎግሶን	ትአ.
አውሐሰ	ርግ.
አውሐደ	ርግ.
አውራቂስ	ስ.
አውርሐስ	ስ.
አውሰበ	ርግ.
አውስቦ	ዘዘ.
ተወሰበ	ተዳ.አ.
ተዋስቦ	ዘዘ.
አስተዋሰበ	አዳ.አ.
አውስት	ስ.
አውስአ	ርግ.
ተዋስአ	ተዳ.አ.
ተዋስኦ	ዘዘ.
አስተዋስአ	አዳ.አ.
አውቀረ	ርግ.
ውቅሮ	ዘዘ.
መዋቅር	ባዘ.
አውቀየ	ርግ.
አውቀፈ	ርግ.
አውቃፍ	ዘዘ.
አውተረ	ኢ/ርግ. 
አውታር	ዘዘ.
አውቴ	ስ.
አውከበ	ርግ.
አውከተ	ግ.
አውከከ	ርግ.
አውኪያኖስ	ስ.
አውዐየ	ርግ.
አውዕ	ስ.
አውየነ	ርግ.
ወይን	ዘዘ.
አውየወ	ግ.
አውያት	ምዘ.
አውደደ	ርግ.
አውገበ	ርግ.
አውጸበ	ርግ.
ውጽቦ	ዘዘ.
አውጽአ	ርግ.
አውጽሐ	ርግ.
አውጻሒ	ቅ.
አዕለወ	ርግ.
አዕረፈ	ግ.
አዕቀጸ	ርግ.
አዕቃጺ	ቅ.
ተዐቅጸ	ተደ.አ.
ዕቁጽ	ቅ.
አዕቀፈ	ርግ.
አዕቃፊ	ቅ.
ዕቅፍት	ምዘ.
አዕዳል	ስ.
አዘለ	ኢ/ርግ.
አዛል	ቅ.
መአዝል	ባቅ.
አዘቅት	ስ.
አዘቅተኲስሕ	
አዘበ	ርግ.
አዛቢ	ቅ.
ተአዘበ	ተደ.አ.
እዙብ	ቅ.
አዛብ	ዘዘ.
አኣዘበ	አስ.አ.
ሚዘብ	ባዘ.
ዝብ	ስ.
ዘየአዝብ ኀበ አረፍተ	
አዘነ	ርግ.
አዛኒ	ቅ.
መኣዝን	ባቅ.
እዝን	ስ.
እዝናዊ	ቅ.
ማእዘን	ባዘ.
ምእዙን	ቅ.
አዘዘ	ርግ.
አዛዚ	ቅ.
ተአዘዘ	ተደ.አ.
ተአዛዚ	ቅ.
እዙዝ	ቅ.
ትእዛዝ	ዘዘ.
እዘዝ	ዘዘ.
አዚዝ	ቅ.
አዛርያ	ተጸ.ስ.
አዜብ	ስ.
አዝለፈ	ርግ.
ዘልፍ	ዘዘ.
ዘልፈ	ተግ.
አዝመረ	ርግ.
አዝመር	ስ.
አዝኀ	ርግ.
እዝኅ	ዘዘ.
አየር	ስ.
አየራዊ	ቅ.
አየሰ	ግ.
አየት	ስ.
አየነ	ርግ.
ተአየነ	ተደ.አ.
አየየ	ርግ.
አያይ	ዘዘ.
አየገ	ግ.
አይግ	ዘዘ.
አያት	ስ.
አያያት	ስ.
አይ	ተስ.
አይቴ	
አይኀ	ርግ.
አይኅ	ዘዘ.
አይኅአ	ርግ.
አይድዐ	ርግ.
አይዳዒ	ቅ.
አይገን	ስ.
አደመ	ኢግ.
አዳም	ቅ.
አዳም	ተጸ.አ.
አደምደመ	ግ.
አደስ	ስ.
አደወ	ርግ.
አዳዊ	ቅ.
እድው	ቅ.
እዳው	ዘዘ.
እድ	ስ.
እድ	
እድ	
እደአትሮንስ	
እደኀጺን	
እደኲናት	
እደ መንሠግ	
እንደሰይፍ	
እድ	
አደገ	ርግ.
አድግ	ዘዘ.
እድግት	ስ.
አድገገዳም	
አድገመረብ	
አደፍ	ስ.
አዲማ	ስ.
አዲም	ስ.
አዲር	ስ.
አዲሮት	ስ.
አዴራ	ስ.
አድለወ	ግ.
አድላዊ	ቅ.
አድልዎ	ዘዘ.
አድለቅልቀ	ርግ.
ድልቅል	ዘዘ.
አድል	ስ.
አድመፀ	ግ.
አድማስ	ስ.
አድምዐ	ርግ.
አድረገ	ርግ.
አድራማሌክ	ስ.
አድቀቀ	ርግ.
አድኀረ	ርግ.
አድኀፀ	ርግ.
አድነነ	ርግ.
አድያማ	
አድያም	ስ.
አዶኒ	
አዶናይ	
አገለ	ርግ.
አግል	ዘዘ.
አገረ	ግ.
አጋር	ቅ.
አጋራዊ	ቅ.
እግር	ዘዘ.
እግር	
እግር	
እግረፀሐይ	
እግረደቂቅ	
እግረማጣ	
እግረመራሁት	
እግራዊ	ቅ.
እግራዊ	
አገበረ	ርግ.
አገባሪ	ቅ.
አገን	ስ.
አገዳ	ስ.
አጋም	ስ.
አጋዘን	ስ.
አግሀደ	ርግ.
ገሃድ	ዘዘ.
ተግህደ	ተደ.አ.
አግልዕት	ስ.
አግመረ	ርግ.
አግማሪ	ቅ.
አግሙስ	ስ.
አግረረ	ርግ.
መግረሪ	ቅ.
አግብዐ	ርግ.
አግኀሠ	ርግ.
አግን	ስ.
አግአዘ	ርግ.
አግኣዚ	ቅ.
ግእዝ	ዘዘ.
አግዘዘ	ርግ.
አግዛዒ	ቅ.
አግያ	ስ.
አግዮስ	ቅ.
አግደመ	ርግ.
አግደምደመ	ርግ.
አጠቀን	ስ.
አጣእጥአ	ርግ.
ጥእጡእ	ቅ.
አጥለቀ	ግ.
አጥሐረ	ርግ.
አጥመቀ	ርግ.
አጥማቂ	ቅ.
መጥምቅ	ባቅ.
ጥምቀት	ሳዘ.
ተጠምቀ	ተደ.አ.
ጥሙቅ	ቅ.
አጥመገ	ርግ.
አጥረቀ	ግ.
አጥራቂ	ስ.
አጥረስካ	ስ.
አጥበቀ	ርግ.
አጥበበ	ርግ.
አጥነነ	ርግ.
አጥናን	ቅ.
አጥዐወ	ርግ.
ጣዖት	ስ.
አጰርግዮስ	ስ.
አጰንገለ	ርግ.
አጰጰሰ	ርግ.
ጳጳስ	ዘዘ.
አጵሎን	ስ.
አጶርጌ	ስ.
አጸበ	ርግ.
አጽብ	ዘዘ.
አጸብጺብ	ስ.
አጸንሕሐ	ርግ.
ጽንሐሕ	ዘዘ.
አጸንግአ	ርግ.
ምጽንጋእ	ባዘ.
አጸየ	ግ.
እጼ	ስ.
አጻመተ	ርግ.
አጽለለ	ግ.
ምጽላል	ባዘ.
አጽሐሰ	ኢግ.
አጽሕሶ	ዘዘ
አጽሐበ	ግ.
አጽሐፈ	ግ.
አጽመተ	ርግ.
አጽምዐ	ርግ.
አጽረረ	ግ.
አጽረሰ	ርግ.
አጽርአ	ግ.
አጽበረ	ርግ.
ጽቡር	ዘዘ.
አጽት	ስ.
አጽነነ	ርግ.
አጽናዋል	ስ.
አጽንሐ	ርግ.
አጽንዐ	ርግ.
አጽዕልት	ስ.
አጽፋር	ስ.
አጽፋት	ስ.
አፅባዕት	ስ.
አፈረ	ግ.
አፈር	ዘዘ.
አፈወ	ርግ.
አፋዊ	ቅ.
አፍ	ስ.
አፈሞት	
አፈሰይፍ	
አፈባሕር	
አፈእቶን 	
አፈጽባሕ	
አፈው 	ዘዘ.
አፈደ	ርግ.
ኤፉድ	ዘዘ.
አፈፈ	ርግ.
ማእፈፍ	ባዘ.
አፍኪያ	ስ.
አፌር	ስ.
አፌዝ	ስ.
አፍለስ	ርግ.
አፍላጢስ	ስ.
አፍረሰ	ርግ.
አፍራቅያ	
አፍሶት	ስ.
አፍቀረ	ርግ.
አፍቃሪ	ቅ.
መፍቀሪ	ባቅ.
ፍቅር	ዘዘ.
ተፈቅረ	ተደ.አ.
ፍቁር	ቅ.
መስተፋቅር	ባቅ.
ተፈቅሮ	ዘዘ.
አስተፋቀረ	አስ.አ.
አስተፋቃሪ	ቅ.
አፍቁጽ	ስ.
አፍትሖ	ስ.
አፍኒን	ተጸ.ስ.
አፍኣ	ስ.
አፍአዊ	ቅ.
አፍክያ	ስ.
አፍጠነ	ርግ.
ፍጡን	ቅ.
አፍጣኒ	ቅ.
አፎት	ስ.
ኡባል	ስ.
ኢትዮጵያ	
ኢትዎፕስ	
ኢትዮጵያዊ	ቅ.
ኢኑሊ	ስ.
ኢየሩሳሌም	
ኢየሱስ	
ኢያሚን	ስ.
ኢያሪኮ	
ኢያሰጲደ	ስ.
እያሱ	ተጸስ.
ኢያሴሜር	ስ.
እያሴቡ	ስ.
ኢያቄም	ተጸስ.
ኢያዜቡ	ስ.
ኢይ	ስ.
ኢዮር	ስ.
ኢዮቤልዩ	ስ.
ኢዮቤል	ስ.
ኤሊ	ተጸስ.
ኤል	
ኤልሳቤጥ	ተጸስ.
ኤልኮረፕ	ስ.
ኤሎሄ	
ኤረር	
ኤረግ	ስ.
ኤርሚያስ	ተጸስ.
ኤርሞን	ስ.
ኤርትራ	
ኤርጋብ	ስ.
ኤሰ	ግ.
ኤስኬዴሬ	ስ.
ኤስፒ	ስ.
ኤይኣ	ስ.
ኤዶም	
ኤጲስቆጶስ	ስ.
ኤጲፋንያ 	ስ.
ኤጴሜዴስ	ስ.
ኤጴሞስ	ስ.
ኤጴሞድ	ስ.
ኤፉድ	ስ.
ኤፌሶን	
ኤፍራጥስ	
ኤፍሬም	ተጸስ.
ኤፎት	ስ.
እለ	መግ.
እልመክኑን	
እል	
እልሰድስ	ስ.
እልታሕ	ስ.
እልፍ	
እመ	መግ.
እመቅ	ስ.
እመት	ስ.
እሙንቱ	
እማሁት	ስ.
እማኄ	
እማንቱ	
እምሄውት	ስ.
እም	ስ.
እመምኔት	
እመ አህጉር	
እም	መዋ.
እምነ	መዋ.
እምዘ	መዋ.
እራኀ	ስ.
እርሳስ	ስ.
እርኩባት	ስ.
እርጋሄ	ስ.
እሳት	ስ.
እስመ	መግ.
እስራኤል	
እስራኤላዊ	ቅ.
እስከ	መዋ.
እስኩ	መግ.
እስኪት	ስ.
እስትግቡዕ	ቅ.
እቀን	ስ.
እብን	ስ.
እንቈራ	ስ.
እንቃስ	ስ.
እንበለ	መዋ.
እንበይነ	መዋ.
እንታለም	ስ.
እንትኩ	
እንትኮ	
እንከ	መፃ.
እንጋ	ተግ.
እንግልጋ	ስ.
እንግዳ	ስ.
እንግድዓ	ስ.
እወ	
እየት	ስ.
እድ	ስ.
እድ	ስ.
እድው	ስ.
እገሌ	
እጓለማውታ	ስ.
እግር	ስ.
እግዚእ	
እግዚኦ	
እፎ	
ኦሆ	
ኦሪት	ስ.
ኦርቶዶክስ	ስ.
ኦርና	ስ.
ኦርያሬስ	ስ.
ኦርድዮን	ስ.
ኦኦ	
ኦፋን	ስ.
ከሀነ	ርግ.
ከሀኒ	ቅ.
ተክህነ	ተደ.አ.
ክሁን	ቅ.
ካህን	ዘዘ.
ክህነት	ምዘ.
ተክህኖ	ዘዘ.
ልብሰተክህኖ	
ከሃ	ቅ.
ከለለ	ርግ.
ከላሊ	ቅ.
መከልል	ባቅ.
አክሊል	ባዘ.
ተከለለ	ተደ.አ.
ክሉል	ቅ.
ክላሌ	ዘዘ.
ተክሊል	ባዘ.
ከለሜዳ	ስ.
ከለበ	ግ.
ከልብ	ስ.
ከልባዊ	ቅ.
ከለየ	ርግ.
መክሊት	ባከዘ.
ከል	ስ.
ከልሐ	ኢግ.
ከላሒ	ቅ.
ክላሕ	ዘዘ.
ከልሰሰ	ርግ.
ከላስስ	ዘዘ.
ከልበኔ	ስ.
ከልብ	ስ.
ከልተፈ	ግ.
ክልቱፍ	ቅ.
ከልትሐ	ርግ.
ከልአ	ርግ.
ከላኢ	ቅ.
ምክላእ	ባዘ.
ተከልአ	ተደ.አ.
ክሉእ	ቅ.
ካልዐ	ርግ.
ካልዕ	ቅ.
ክልዔ	ዘዘ.
ክልዔት	
ክልዔቱ	
ክልዔቲ	አን.
ክልዔ	
ከሎ	ስ.
ከሕክሐ	ርግ.
ከመ መዋ.	
(ከም-ኣየ) = ከማየ	
(ከም-ኣኪ) = ከማከ	
(ከም-ኣኪ) = ከማኪ	
ከም-ኣሁ) = ከማሁ	
(ከም-ኣሃ) = ከማሃ	
(ከም-ኣክሙ) = ከማክሙ	
(ከም-ኣክን) = ከማክን	
(ከም-ኣሆሙ) = ከማሆሙ	
(ከም-ኣሆን) = ከማሆን 	
ከመመ	ርግ.
ከማሚ	ቅ.
ተከመ	ተደ.አ.
ክሙም	ቅ.
መክምም	ባቅ.
ከመረ	ርግ.
ክምር	ዘዘ.
ከመዝ	ስ.
ከመዝ	ተግ.
ከሙን	ስ.
ከሚኒም	ስ.
ከሚን	ስ.
ከማት	ስ.
ከሜሌዎን	ስ.
ከምር	ስ.
ከምሰሰ	ኢግ.
ከሠተ	ርግ.
ከሣቲ	ቅ.
መክሥት	ባቅ.
ክሥተት	ሳዘ.
ተከሥተ	ተደ.አ.
ክሡት	ቅ.
ከርመ	ግ.
ከራሚ	ቅ.
ከርም	ዘዘ.
ክረምት	ምዘ.
አክረመ	አድ.አ.
ምክራም	ባዘ.
ከረሠ	ርግ.
ከርሥ	ዘዘ.
ከረ	ግ.
ክሩር	ቅ.
ከረር	ዘዘ.
ከርቀ	ግ.
ኬርቃ	ዘዘ.
ከረበ	ርግ.
ከረብ	ዘዘ.
ኰረበ	ርግ.
ከረየ	ርግ.
ከራዪ	ቅ.
መክርይ	ባዘ.
ከረጺት/ኸረጺት 	ስ.
ከረፕ	ስ.
ኰራኪ	ስ.
ከራድዮን	ስ.
ኰርሐ	ርግ.
ኲርሕ	ዘዘ.
ከርሚል	ስ.
ከርተስ	ርግ.
ክርታስ	ዘዘ.
ከርከረ	ርግ.
መከርክር	
ከርከንድ	ስ.
ከርከዴን	ስ.
ከርካዕ	ስ.
ከርጐነ	ርግ.
ኲርጓኔ	ዘዘ.
ከሰበ	ርግ.
ክስበት	ሳዘ.
መክሰብ	ባዘ.
ኰስኰስ	ስ.
ኰሰየ	ርግ.
መኲሲ	ባዘ.
ኰስሐ	ግ.
ኲስሕ	ዘዘ.
ኰስተረ	ርግ.
ኰስታሪ	ቅ.
ምኲስታር	ባዘ.
ከበለ	ርግ.
ከበሎ	ስ.
ከበሰ	ርግ.
ተከብሰ	ተደ.አ.
ክቡስ	ቅ.
ክብስ	ዘዘ.
ክብሶ	ዘዘ.
ከበበ	ርግ.
ከባቢ	ቅ.
አክበበ	አስ.አ.
መክብብ	ባቅ.
ተከበ	ተደ.አ.
ክቡብ	ቅ.
ክበብ	ዘዘ.
ከበተ	ርግ.
ከባቲ	ቅ.
ተከበተ	ተደ.አ.
ክቡት	ቅ.
ተከብቶ	ዘዘ.
ክብተት	ሳዘ.
ከበታ	ዘዘ.
ከበወ	ርግ.
ከበዘ	ርግ.
ከብረ	ኢግ.
ተከበረ	ተደ.አ.
ክቡር	ቅ.
ክብረት	ሳዘ.
ክቡር	ዘዘ.
ክብርና	ምዘ.
አክበረ	አስ.አ.
አክባሪ	ቅ.
ከብረው	ርግ.
ከበሮ	ዘዘ.
ከብከበ	ኢግ.
ከብካብ	ዘዘ.
ከብከቦ	ስ.
ከብደ	ግ.
ክቡድ	ቅ.
ክቡደሑረት	
ክብደመዝራዕት	
ክቡዳነ አቅርንት	
ክቡዳነጾር	
ክበድ	ዘዘ.
አክበደ	አስ.አ.
አስተካበደ	አዳ.አ.
ከተመ	ርግ.
ከተማ	ዘዘ.
ከተማዊ	ቅ.
ተከትመ	ተደ.አ.
ተንከተም	ስ.
ከተረ	ርግ.
ከታሪ	ቅ.
ከታር	ዘዘ.
ከታሪት	ስ.
ከተበ	ርግ.
ከታቢ	ቅ.
ክታብ	ዘዘ.
ተከትበ	ተደ.አ.
ክቱብ	ቅ.
ከተ	ርግ.
የካቲት	
ከተፈ	ርግ.
ክቱፍ	ቅ.
ከነሰ	ርግ.
ከናሲ	ቅ.
መከንስ	ባቅ.
ከኒሳ	ዘዘ.
ተከነሰ	ተደ.አ.
ክኑስ	ቅ.
ክናሴ	ዘዘ.
መክነስ	ባዘ.
ከነነ	ርግ.
መኩኑን	ባቅ.
እመክኑን	
ኰነነ	ርግ.
ኰናኒ	ቅ.
መኰንን	ዘዘ.
ኲነኔ	ዘዘ.
ምኲናን	ባዘ.
ተኰነነ	ተደ.አ.
ኲኑን	ቅ.
ኲናኔ	ዘዘ.
ከነዓን	ተጸስ.
ከኒሳ	ስ.
ከንበሎ	ስ.
ከንተረ	ርግ.
ኰንተረ	ርግ.
ኰንተር	ዘዘ.
ከንቱ	ቅ.
ከንትሮስ	ስ.
ከንዐ	ግ.
ከነዓን	
ከንፈር	ስ.
ከንፈ	ኢግ.
ክንፍ/ክነፍ	ዘዘ.
ኰከመ	ርግ.
ኰከም	ዘዘ.
ኰኲሕ	ስ.
ከወረ	ርግ.
ኮራ	ዘዘ.
ኮሬ	ስ.
ከወሰ	ርግ.
ኮስ	ስ.
ተከውሰ	
ክዉስ	ቅ.
ከወወ	ሥግ.
ክዋው	ቅ.
ከወር	ርግ.
ከዋላ	ስ.
ከዋኒት	ስ.
ከዐወ	ርግ.
ከዓዊ	ቅ.
ክዕወት	ሳዘ.
ተክዕወ	ተደ.አ.
ክዕው	ቅ.
ኰዐተ	ርግ.
ኰዓቲ	ቅ.
ኲዕንት	ዘዘ.
ከየሰ	ርግ.
ከይሲ	ዘዘ.
ኪስ	ዘዘ.
ከየነ	ኢ/ርግ.
ከያኒ	ቅ.
ኪነት	ሳዘ.
ከየደ	ርግ.
ተካየደ	ተዳ.አ.
ኪዳን	ዘዘ.
ከደነ	ርግ.
ከዳኒ	ቅ.
መክድን/መክደኒ	ባቅ.
ተከድነ	ተደ.አ.
ክዱን	ቅ.
ክድነት	ሳዘ.
ክዳን	ዘዘ.
መክደን/ምከዳን 	ባዘ.
ከፈለ	ርግ.
ከፋሊ	ቅ.
ተከፍለ	ተደ.አ.
ክፉል	ቅ.
ክፍለት	ሳዘ.
ክፍል	ዘዘ.
መክፈልት	ባዘ.
ኩፋሌ	ዘዘ.
ከፈረ	ርግ.
ኩፋር	ዘዘ.
ክፋር	ስ.
ከፈር	ስ.
ከፉር	ስ.
ከፈነ	ርግ.
ከፈን	ስ.
ከፈየ	ርግ.
ከፈይ	ዘዘ.
መክፌ	ባዘ.
ከፍአ	ግ.
ክፉእ	ቅ.
ክፍአት	ሳዘ.
ኩልኩል	ስ.
ኩታራ	ስ.
ኩፋር	ስ.
ኲሓ	ስ.
ኪሩብ	
ኪሩባዊ	ቅ.
ኩሩይ	ስ.
ኪራላይሰን	
ኲናት	ስ.
ኪናዊ	
ኪን	
ኪዛ	ስ.
ኪያ	ምዕ.
[ኪያ-የ] = ኪያየ	
ኪያነ	
ኪያከ	
ኪያኪ	
ኪያክሙ	
ኪያክን	
ኪያሁ	
ኪያሃ	
ኪያሆሙ	
ኪያሆን	
ኪዳን	ስ.
ካሂ	ስ.
ኳሄላ	ስ.
ካህን	ስ.
ካም	ስ.
ካቶሊክ/ኮቶሊክ	ስ.
ካዕሴ	ስ.
ዝኬ ውእቱ	
ወይንኬ አልቦሙ	
ነዐኬ እኁየ	
ኬሌሜዎን	ስ.
ኬልቄዶን	ስ.
ኬነወ	ኢግ.
ኪንው	ቅ.
መኬንው	ባቅ.
ኬነውት	መድ.
ኬንያ	ዘዘ.
ኪን	ዘዘ.
ኪነት	ሳዘ.
መኪና	ባዘ.
ኬክሮስ	
ኬደ	ርግ.
ከያዲ	ቅ.
ተካየደ	ተዳ.አ.
መከየድ	ባዘ.
ምክያድ	ባዘ.
አኬደ	አስ.አ.
ተከይደ	ተደ.አ.
ክዩድ	ቅ.
ኬጥሮጋውሎስ	ብቁ.
ክህለ	ግ.
ክሂሎ	ቦአ.
ከሃሊ	ቅ.
ተክህለ	ተደ.አ.
አክሃለ	አስ.አ.
ክሁል	ቅ
ተካሃለ	ተዳ.አ.
አስተካሃለ	አዳ.አ.
ኲለት	ስ.
ኲላ	ስ.
ኲል	ቅ.
[ኲል-ኡ] = ኲሉ	
[ኲል-ኣ] = ኲልነ 	
[ኲል-ክሙ] = ኲልክሙ	
[ኲል-ክን] = ኲልክን 	
[ኲል-ኦሙ] = ኲሎሙ	
[ኲል-ኦን] = ኲሎን	
ኲልሄ/ኲለሄ 	
ኲላዊ	
ኲለንታ	
ኲለንታዊ	
ክሕደ	ርግ.
ከሓዲ	ቅ.
ተክሕደ	ተደ.አ.
አክሐደ	አስ.አ.
ተካሐደ	ተዳ.አ.
አስተካሐደ	አዳ.አ.
ክሕደት	ሳዘ.
ካሕድ	ዘዘ.
ኲሕል	ስ.
ኲሕ	ስ.
ኲሕሰ	ግ.
ኲሕስ	ዘዘ.
ክመ	ተግ.
ክሣድ	ስ.
ክሩዝ	ስ.
ክርስቲሎቤ	ስ.
ክርስቲያን	ቅ.
ክርስትና	ስ.
ክርስቶስ	
ክርስቶሳዊ	ቅ.
ኲርናዕ	ስ.
ክርዕ	ስ.
ክርዳድ	ስ.
ኲራፒታ	ስ.
ኲስኲስት 	ስ.
ክበበርእስ	ስ.
ክብሪት	ስ.
ክቦ	ስ.
ክታን	ስ.
ክንፋር	ስ.
ክንፍ	ስ.
ክዋኒት	ስ.
ክዑብ	ስ.
ክዑት	ስ.
ኲዕሰ	ርግ.
ኲዕስ	ዘዘ.
ኲዒስ	
ክግዮን	ስ.
ኲጥጥሜ	ስ.
ኲፌት	ስ.
ኮል	ስ.
ኮሞል	ስ.
ኮሞስ	ስ.
ኮራ	ስ.
ኮሬ	
ኮር	ስ.
ኮብስ	ስ.
ኮራታሪት	ስ.
ኮነ	ኢግ.
ከዋኒ	ቅ.
ክዋኔ	ዘዘ.
ኩነት	ሳዘ.
ክዉን	ቅ.
ከወንት	መድ.ቅ.
ከዋኒት	ምዘ.
መካን	ባዘ.
ኮኢስ	ስ.
ኮከብ	ስ.
ኮከወ	ግ.
ኮክህ	ስ.
ኮጥሚ	ስ.
ወ ፣ ዋዌ	
ወሀበ	ርግ.
ይሁብ	ትንአ.
የሀብ	ዘአ/ትአ.
ውሂብ/ውሂቦት	ንአ.
ወሃቢ	ቅ.
ተውህበ	ተደ.አ.
ውሁብ	ቅ.
ሀብሀበ	ስ.
ሀብት	ምዕ.ዘ.
ወለቀ	ኢግ.
ወለበ	ኢግ.
አውለበ	አድ.አ.
ወልብ	ዘዘ.
ወለባ	ጥዘ.
ወለት	ስ.
ወለደ	ርግ.
ወላዲ	ቅ.
መውልድ	ባቅ.
ሙላድ	ባዘ.
ተወልደ	ተደ.አ.
ተወላዲ	ዘዘ.
ወለድእግዚአብሔር-ሥግው	
ውሉደእግዚአብሔር	
ውሉደአዳም	
ውሉደቤት	
ውሉደብርሃን	
ወልደህጉል	
ወልደኃይል	
ውሉደጥምቀት	
ውሉደመንግሥት	
ወልደዕጓለእመሕያው	
ወልድና	ዘዘ.
ልደት	ሳዘ.
ትውልድ	ባዘ.
ወለገ	ግ.
ልገት	ምዘ.
ወለጠ	ርግ.
ወላጢ	ቅ.
ተወለጠ	ተደ.አ.
ውሉጥ	ቅ.
ውልጤ	ዘዘ.
ተውላጥ	ዘዘ.
ወልተወ	ርግ.
ተወልተወ	ተዳ.አ.
ውልትው	ቅ.
ውልታዌ	ዘዘ.
ወልታ	ዘዘ.
ወልወለ	ኢግ.
ወልካ	ስ.
ወለኘ	ስ.
ወሐከ	ርግ.
ወሓኪ	ቅ.
ወሐሰ	ርግ.
ወሓሲ	ቅ.
አውሐሰ	አስ.አ.
አውሐሲ	ቅ.
ተውሕስ	ተደ.አ.
ውሑስ	ቅ.
ውሕስት	ሳዘ.
ዋሕስ	ዘዘ.
ሕስት	ምዘ.
ልብሰ ሕሰት	
ወማይ	ስ.
ወረሰ	ርግ.
ወራሲ	ቅ.
ርስት	ምዘ.
ውርስ	ዘዘ.
ወረቀ	ርግ.
ወረቀት	ምዘ.
ምራቅ	ባዘ.
ወርቅ	ዘዘ.
ወረበበ	ርግ.
ወረባቢ	ቅ.
ወረኃ	ቅ.
ወረወ	ርግ.
ወራዊ	ቅ.
ወረዘ	ርግ.
ወረየ	ርግ.
ወራዩ	ቅ.
ወሬ	ስ.
ወረደ	ሥግ.
ወራዲ	ቅ.
ውሩድ	ቅ.
ርደት	ሳዘ.
አውረደ	አድ.አ.
ውርድ	ዘዘ.
ወራውሬ	ስ.
ወርኅ	ስ.
ወርኀዊ	ቅ.
ወርአ	ርግ.
ሞራእ	ባዘ.
ወርዘወ	ኢግ.
ውርዝው	ቅ.
ወሬዛ	ዘዘ.
ውርዙት	ምዘ.
ውርዛዌ/ውርዝውና	ዝከ.
ወሰቀ	ርግ.
ተወሰቀ	ተደ.አ.
ውሱቅ	ቅ.
ወሰበ	ርግ.
ውስበት	ሳዘ.
አውሰበ	አስ.አ.
ተዋሰበ	ተዳ.አ.
አስተዋሰበ	አስ.አ.
ሰብሳብ	ምዘ
ወሰነ	ርግ.
ውሳኒ	ቅ.
ተወሰነ	ተደ.አ.
ውሱን	ቅ.
ውሳኔ	ዘዘ.
ወሰከ	ርግ.
ወሳኪ	ቅ.
ተወሳክ	ዘዘ.
ውሳኬ	ዘዘ.
ወሰደ	ርግ.
ወሳዲ	ቅ.
መውሰድ	ባቅ.
ወሰጠ	ግ.
ውስጣዊ/ውሳጣዊ	ቅ.
ውስጥ/ውሳጥ	ዘመ.
ውሳጤ/ውስጠ	መዋ.
ወስከምት	ስ.
ወቀሠ	ርግ.
ወቃሢ	ቅ.
ሙቃስ	ባዘ.
ተወቅሠ	ተደ.አ.
ውቁሥ	ቅ.
ተዋቀሠ	ተዳ.አ.
ቅሥት	ምዘ.
ወቀረ	ርግ.
ወቃሪ	ቅ.
ሞቀር	ባዘ.
ውቅሮ	ርግ.
ውቁይ	ቅ.
ውቅየት	ሳዘ.
ውቄት	ስ.
ወቅሐ	ርግ.
ይወቅሕ	ትንአ.
ይቃሕ	ዘአ/ትአ.
ሞቅሕ	ባዘ.
ወቅት	ስ.
ወቅፍ	ስ.
ወባ	ስ.
ወቦ	ስ.
ወተረ	ርግ.
ወትር	ዘዘ.
አውተረ	አስ.አ.
ተወትረ	ተደ.አ.
ወተር	ስ.
ወተ	ኢግ.
ወተገ	ርግ.
ወናግ	ስ.
ወናግ ሰገድ	
ወንጌል	ስ.
ወንጌላዊ	ቅ.
ወከለ	ርግ.
ውኩል	ቅ.
ትውክልት	ሳዘ.
ትውክልና	ዘዘ.
ወከበ	ርግ.
ውኩብ	ቅ.
አውከበ	አድ.አ.
ወከተ	ግ.
ተዋከተ	ተዳ.አ.
ውካታ	ዘዘ.
ወከ	ግ.
አውከከ	አስ.አ.
ወከፈ	ርግ.
ተወክፈ	ተዳ.አ.
ተወካፊ	ቅ.
ውኩፍ	ቅ.
ውካፌ	ዘዘ.
ወክሐ	ግ.
ወክሕ	ዘዘ.
ወክዐ	ግ.
ወውዐ	ግ.
ወዋዒ	ቅ.
ውውዓ	ዘዘ.
ውዋዔ	ዘዘ.
ወዐለ	ግ.
ወዓሊ	ቅ.
ውዑል	ቅ.
ዕለት	ምዘ.
አውዐለ	አስ.አ.
አውዓሊ	ቅ.
መውዕል	ባቅ.
ሙዓል	ባዘ.
መዓልት	ባከ.
ተዋዐለ	ተዳ.አ.
ውዕል	ዘዘ.
ወዐረ	ግ.
ወዕር	ዘዘ
ውዑር	ቅ.
ወዕር	ስ.
ወዘረ	ርግ.
ወዚር	ዘዘ.
ወዘፈ	ርግ.
ትውዝፍት	ባከ.ዘ.
ወይለየ	ግ.
ወይሌ	ዘዘ.
ወይል	
ወይ	ተግ.
ወይጠል	ስ.
ወደሰ	ርግ.
ወዳሲ	ቅ.
መወድስ	ባዘ.
ተወደሰ	ተደ.አ.
ውዱስ	ቅ.
ውዳሴ	ዘዘ.
ወደየ	ርግ.
ወዳዪ	ቅ.
ሙዳይ	ባዘ.
ሙዳየበለስ	
ሙዳየዘቢብ	
ሙዳየማይ	
ሙዳየምጽዋት	
ሙዳየ ዕጣን	
ሙዳየ ዕፍረት	
ሙዳየ ኤረግ	
ሙዳየ ቀለም	
ሙዳየ ቀርጠሎን	
ውድየት	ሳዘ.
ውዴት	ሳዘ.
ወደደ	ርግ.
ውዱድ	ቅ.
ድድ	ዘዘ.
ውድቀ	ኢግ.
ውዱቅ	ቅ.
ድቀት	ባዘ.
መውድቅ	ባዘ.
ወድእ	ርግ.
ውዳኤ	ዘዘ.
ወድአ	ተግ.
ወገል	ስ.
ወገረ	ርግ.
ወጋሪ	ቅ.
ተወግረ	ተደ.አ.
ውጉር	ቅ.
ውግረት	ሳዘ.
ሙጋር	ባዘ.
ዋግራ	ስ.
ወግር	ዘዘ.
ሞገር	ባዘ.
ወገርት	ባከ.
ወገሰ	ኢግ.
ሞገስ	ባዘ.
ወገበ	ግ.
ግብት	ምዘ.
ግብታዊ	ቅ.
ወገዘ	ርግ.
አውገዘ	አስ.አ.
ተወግዘ	ተደ.አ.
ውጉዝ	ቅ.
ውግዘት	ሳዘ.
ወገደ	ኢግ.
ሞገድ	ባዘ.
ሞገዳዊ	ቅ.
ሙጋድ	ባዘ.
ወገገ	ግ.
ውጋገን	ምዘ.
ወገግ	
ወግረጳ	ስ.
ወግአ	ርግ.
ወጋኢ	ቅ.
ተወግአ	ተደ.አ.
ውጉእ	ቅ.
ውግአት	ሳዘ.
ሞግእ	ባዘ.
ወግዐ	ርግ.
ውግዐት	ሳዘ.
ወግዕ	ስ.
ወግዓዊ	ቅ.
ወጠነ	ርግ.
ወጣኒ	ቅ.
ተወጥነ	ተደ.አ.
ውጡን	ቅ.
ወጥነት	ሳዘ.
ውጣኔ	ዘዘ.
ጥንት	ምዘ.
ጥንታዊ	ቅ.
ወጥሐ	ርግ.
ውጣሔ	ዘዘ.
ተወጥሐ	ተደ.አ.
ውጡሕ	ቅ.
ሞጣሕ/ሞጣሕት 	ባዘ.
ሙጣሔ	ዘዘ.
ወጥሰ	ግ.
ወጥስ	ዘዘ.
ወጸበ	ርግ.
ውጽቦ	ዘዘ.
ውጽሐ	ርግ.
ሞጻሕት	ባከ.ዘ.
ጻሕጻሕ	ምዘ.
መፀፈ	ርግ.
ወፃፊ	ቅ.
ሞፀፍ	ባዘ.
ሞፀፍት	ባከ.
ወፀፍ	ዘዘ.
መፅኀ	ርግ.
መፅአ	ግ.
መፃኢ	ቅ.
ውፁእ	ቅ.
ፀአት	ሳዘ.
ሙፃእ	ባዘ.
ፃእፃእ	ዘዘ.
ወፈረ	ግ.
ወፋሪ	ቅ.
ውፍረት	ሳዘ.
ወፍር	ዘዘ.
አውፈረ	አስ.አ.
ሞፈር	ባዘ.
ወፈየ	ርግ.
አወፈየ	አስ.አ.
ተወፈየ	ተደ.አ.
ውፉይ	ቅ.
ውፍየት	ሳዘ.
ትውፊት	ባከዘ.
ወፈጠ	ርግ.
ወፋጢ	ቅ.
ሞፈጥ	ባዘ.
ወፈፈ	ኢግ.
ወፋፊ	ቅ.
ዋልም	ስ.
ዋልጋ	ስ.
ዋሐየ	ግ.
ዋሓዪ	ቅ.
ውሑይ	ቅ.
ዋሐደ	ግ.
ውሑድ	ቅ.
ዋህድና	ዘዘ.
ተዋሐደ	ተደ.አ.
ተዋሕዶ	ዘዘ.
ዋሕድ	ቅ.
ዋሕስ	ስ.
ዋነየ	ግ.
ዋኖስ	ስ.
ዋከየ	ግ.
ውኩይ	ቅ.
አዋከየ	አሰ.አ.
ዋካ	ዘዘ.
ዋዌ	ስ.
ዋዕላ	ስ.
ዋዕማ	ስ.
ውሕዘ	ግ.
ውሑዝ	ቅ
ውሒዝ	ዘዘ.
ውሕዘት	ሳዘ.
ውኀዘ	ግ.
ውኅደ	ግ.
ውኁድ	ቅ.
ውኅደት	ሳዘ.
አውኀደ	አድ.አ.
ውኅጠ	ርግ.
ውኃጢ	ቅ.
ውእቱ	
ውእደ	መግ.
ውዕየ	ግ.
ወዑይ	ቅ.
ውዳሴ	ስ.
ወዴት	ስ.
ዐለለ	ርግ.
ዐለላ	ዘዘ.
ዐለመ	ርግ.
መዐልም	ባቅ.
ዓለም	ዘዘ.
ዓለማዊ	ቅ.
ዐለወ	ርግ.
ዐላዊ	ቅ.
ዕልው	ቅ.
ዐመቀ	ግ.
ዕሙቅ	ቅ.
ዕመቅ	ዘዘ.
ማዕምቅ	ባዘ.
ዐመደ	ኢ/ርግ.
ዐማዲ	ቅ.
ዐምድ	ዘዘ.
ዐመፀ	ግ.
ዐማፂ	ቅ.
ዐመፃ	ዘዘ.
ዐሠረ	ርግ.
ዕሡር	ቅ.
ዐሡር	ዘዘ.
ተዐሠረ	ተደ.አ.
ዐሥሩ	
ዐሠርቱ	ቅ.
ዐሥር	
ዕሥራ	
ዓሥራት	
ዐረረ	ርግ.
ማዕረር	ባዘ.
ዐረር	ስ.
ዐረቀ	ርግ.
ተዐርቀ	ተደ.አ.
ዕሩቅ	ቅ.
ዕራቅ	ቅ.
ዕርቃን	ምዘ.
ዐረቀ	ግ.
ዐራቂ	ቅ.
ዕርቅ	ዘዘ.
ዐረከ	ርግ.
ተዐረከ	ተደ.አ.
ዐርክ	ዘዘ.
ዐርኬ	ስ.
ዐረዘ	ርግ.
ተዐረዘ	ተደ.አ.
ዕሩዝ	ቅ.
ዐራዝ	ዘዘ.
ዕርዝት	አን.ቅ.
ዐረዘ	ግ.
ተዐርዘ	ተደ.አ.
ዕሩዝ	ቅ.
ዕርዝና	ዘዘ.
ዐረየ	ርግ.
ዕሩይ	ቅ.
ዕርየት	ሳዘ.
ዕሪና	ዘዘ.
ዐረፈ	ግ.
ዕሩፍ	ቅ.
ዕረፍት	ሳዘ.
ምዕራፍ	ባዘ.
ዐረፈ	ርግ.
ዕርፍ	ዘዘ.
ዐረፍት	ስ.
ዐራት	ስ.
ዐረበ	ግ.
ዕርበት	ሳዘ.
ዐረብ	ዘዘ.
ምዕራብ	ባዘ.
ምዕራባዊ	ቅ.
ዐረብ	ስ.
ዐርብ	
ዐርቢ	
ዐረባዊ	
ዐረቦን	
ማዕረብት	
ዐርገ	ኢግ.
ዐራጊ	ቅ.
ዕርገት	ሳዘ.
ዕርገተ ዕጣን	
ዕርገተ ቁርባን	
አዕረገ	አስ.አ.
ማዕረግ/መዓረግ	ባዘ.
ምዕራግ	
ዐሰቀ	ርግ.
ዐሰቅ	ዘዘ.
ዐሰበ	ርግ.
ዐሳቢ	ቅ.
ዐሳብ/ዕሱብ	ቅ.
ዐስብ	ዘዘ.
ዐሰበ	ርግ.
መዓስብ	ባዘ.
ምዕስብና	ዘዘ.
ዐሰየ	ርግ.
ዐሳዪ	ቅ.
ተዐሰየ	ተደ.አ.
ዕሱይ	ቅ.
ዕሴት	ምዘ.
ዐቀለ	ርግ.
ምዕቃል	ባዘ.
ዐቅል	ዘዘ.
ዐቀመ	ርግ.
ዐቃሚ	ቅ.
ዐቅም	ዘዘ.
ዕቃሜ	ዘዘ.
ዐቈረ	ርግ.
ተዐቁረ	ተደ.አ.
ዕቁር	ቅ.
ዕቊር	ዘዘ.
ዐቀበ	ርግ.
ዐቃቢ	ቅ.
መዓቅብ	ባቅ.
ዕቅበት	ሳዘ.
ተዐቅበ	ተደ.አ.
ዕቁብ	ቅ.
ዕቅብት	አን.ቅ.
ዐቀብ	ዘዘ.
አማዕበቀ	አስ.አ.
ምዕቅብና	ዘዘ.
ዐቃቤሥራይ	ስ.
ዐቃቢተሥራይ	
ዐቈነ	ርግ.
ዕቋን	ዘዘ.
ዐቀደ	ርግ.
ተዐቅደ	ተደ.አ.
ዕቁድ	ቅ.
ዐቅድ	ዘዘ.
ዐቀጸ	ግ.
ዕቁጽ	ቅ.
ተዐቅጸ	ተደ.አ.
አዕቀጸ	አስ.አ.
አዕቃጺ	ቅ.
ዐቀፈ	ግ.
ዐቃፊ	ቅ.
ማዕቀፍ	ባዘ.
ዕቅፍት	ምዘ.
ዐቃም	ስ.
ዐቃር	ስ.
ዐቅመ	መፃ.
ዐቅራብ	ስ.
ዐበለ	ግ.
ማዕበል	ባዘ.
ዐበለ	ርግ.
መዐብል 	ባዘ.
ዐበረ	ኢግ.
ዕቡር	ቅ.
ዐባር	ዘዘ.
አዕበረ	አስ.አ.
ዕቤር	ስ.
ዕቤራዊ/ዕቤራይ 	ቅ.
ዕብራዊ	ቅ.
ዕብራይስጥ/ጢ	ስ.
ዐበየ	ግ.
ዕቡይ	ቅ.
ትዕቢት	ምዘ.
ዐብየ	ግ.
ዐቢይ	ቅ.
ዕበይ	ዘዘ.
ዐበይት	መቅ.
ተዓበየ 	ተደ.አ.
ተዓብዮ	ንአ.
ዐተመ	ግ.
መዓትም	ባቅ.
ዐተር	ስ.
ዐተበ	ርግ.
ዐታቢ	ቅ.
ተዐትበ	ተደ.አ.
ዕቱብ	ቅ.
ዕትበት	ሳዘ.
ዑታቤ	ዘዘ.
ዐነቀ	ርግ.
ዐናቂ	ቅ.
ተዐነቀ	ተደ.አ.
ዕኑቅ	ቅ.
አዕነቀ	አስ.አ.
ዐነገ	ርግ.
ዐንግ	ዘዘ.
ዐንገት	ስ.
ዐንጉጋ	
ዐንጉግ	ስ.
ዐንሰበ	ርግ.
መዓንሰብ	ባቅ.
ዐንስር	ስ.
ዐንበዘ	ግ.
ዕንቡዝ	ቅ.
ዕንቡዘ-ልብ	ቅ.
ዐከወ	ርግ.
ዐከተ	ምቅ.
ዐኮት	ስ.
ዐዋዲ	ቅ.
ዐውሎ	ስ.
ዐውየወ	ግ.
ዐውያት	ምዘ.
ዐውድ	ስ.
ዐውደነገሥት	
ዐውደዓመት 	
ዐውደፍትሕ	
ዐዘረ	ርግ.
ተዐዝረ	ተደ.አ.
ምዕዛር	ባዘ.
ማዕዘር	ባዘ.
ዐዘቀ	ርግ.
ዐዘቅት	ምዘ.
ዐዘዘ	ግ.
ዐዚዝ	ቅ.
ዕዙዝ	ቅ.
ዕዘዝ	ዘዘ.
ዐየረ	ርግ.
ተዐየረ	ተደ.አ.
ዕዩር	ቅ.
ትዕይርት	ምዘ.
ዐየነ	ርግ.
ዐይን	ዘዘ.
ዐይነማኀተም	
ዐይነምድር	
ተዐየነ	
ዕዩን	ቅ.
ትዕይንት	ምዘ.
ዐየየ	ርግ.
ዕዩይ	ቅ.
ዐይገን	ስ.
ዐይግ	ስ.
ዐደመ	ርግ.
ተዐደመ	ተደ.አ.
ዕዱም	ቅ.
ዕድሜ	ዘዘ.
ዐደወ	ርግ.
ዓዳዊ	ቅ.
ምዕዳው	ባዘ.
አዕደወ	አስ.አ
አዕዳዊ	ቅ.
ማዕዶት	ባዘከ.
ተዐደወ	ተደ.አ.
ተዐዳዊ	ቅ.
ዐደየ	ርግ.
ዐዳዪ	ቅ.
ዕዳ	ዘዘ.
ዕዳዊ	ቅ.
ዐደይ	ስ.
ዐድል	ስ.
ዐገለ	ርግ.
ዐግል	ዘዘ.
ዐግላ	ዘዘ.
ዕጓል	ስ.
ዕጐልት	ስ.
ዕጓለማውታ	
ዕጓለእመሕያው	
ወልደ ዕጓለእመሕያው	
ዐገለ	ርግ.
ዐጋሊ	ቅ.
ተዐገለ	ተደ.አ.
ዕጉል	ቅ.
ትዕግልት	ምዘ.
መስተዓግል	ባቅ.
ዐገሠ	ር/ኢግ.
ዐጋሢ	ቅ.
ተዐገሠ	ተደ.አ.
ተዓጋሢ	ቅ.
መስተዓግሥ	ባቅ.
ዐገተ	ርግ.
ዐጋቲ	ቅ.
ዕግተት	ሳዘ.
ማዕገት	ባዘ.
ዐጌ	ስ.
ዐጠሰ	ግ.
ዕጠስ	ዘዘ.
ዐጠቀ	ርግ.
ዐጣቂ	ቅ.
ዕጡቅ	ቅ.
ዕጠቅ	ዘዘ.
ዐጠነ	ርግ.
ዐጣኒ	ቅ.
ዐጠንት	መድ.ቅ.
ማዕጠንት	ባዘከ.
ምዕጣን	ባዘ.
ተዐጥን	ተደ.አ.
ዕጡን	ቅ.
ዕጥነት	ሳዘ.
ዕጣን	ዘዘ.
ዕጣነ ሞገር	
ዐጠፈ	ርግ.
ዐጣፊ	ቅ.
ተዐጥፈ	ተደ.አ.
ዕጡፍ	ቅ.
ዐጥፍ	ዘዘ.
ዐጸረ	ርግ.
ዐጻሪ	ቅ.
ተዐጸረ	ተደ.አ.
ዕጹር	ቅ.
ዐጺር	ዘዘ.
ዐፀቀ	ኢግ.
ዐጽቅ	ዘዘ.
ዐጸበ	ግ.
ዕጹብ	ቅ.
ዕጸብ	ዘዘ.
ዕጽበት	ሳዘ.
ዐጸባ	ዘዘ.
አስተዐጸበ	አድ.አ.
ዐጸወ	ርግ.
ዐጻዊ	ቅ.
ዐጸውት	መድ.ቅ.
ማዕጾ	ዘዘ.
ተዐጽወ	ተደ.አ.
ዕጽው	ቅ.
ዕጽወት	ሳዘ.
ዐጸደ	ርግ.
ዐጻዲ	ቅ.
ዐጸድ	መድ.ቅ.
ማዕጸድ	ባዘ.
ተዐጽደ	ተደ.አ.
ዕጹድ	ቅ.
ዐጸድ	ዘዘ.
ዐቢይ ዐጸድ	
ዐጸደ ቤተ ትምህርት 	
ዐጸደ ሐምል	
ዐጸደ ቤተ ክ.	
ዐጸፈ	ግ.
ተዐጽፈ	ተደ.አ.
ዑጹፍ	ቅ.
ዑጻፌ	ሳዘ
ዐጽፍ	ዘዘ.
ዐፀመ	ግ.
ዐፅም	ዘዘ.
ዐፀበ	ርግ.
ዕፁብ	ቅ.
ዐፀወ	ግ.
ዕፅ	ዘዘ.
ዐፀየ	ግ.
ዕፄ	ዘዘ.
ዐፀ	ግ.
ዐፅ	ዘዘ.
ዕፅ	ዘዘ.
ዕፀሳቤቅ	
ዑባል	ስ.
ዓለም	ስ.
ዓም	ስ.
ዓሣ	ስ.
ዓሣነባሪ	
ዓው	ስ.
ዓይን	ስ.
ዓዲ	ተግ.
ዔለ	ግ.
ዐያሊ	ቅ.
አዔለ	አስ.አ.
ዔላ	ዘዘ.
ዔመ	ርግ.
ዔሰ	ርግ.
ዔናቅ	ቅ.
ዔና	ስ.
ዔዴን	ስ.
ዕለት	ስ.
ዕልገት	ስ.
ዕረፍት	ስ.
ዕርቅ	ስ.
ዕርበት	ስ.
ዕርገት	ስ.
ዕሴት	ስ.
ዕቤር	ስ.
ዕብራዊ	ቅ.
ዕብራይስጢ	ስ.
ዕብሬት	ስ.
ዕብሮዲ	
ዕንቈራ	ስ.
ዕንቍ	ስ.
ዕንቋዕ	ተግ.
ዕንዚራ	ስ.
ዕንጐት	ስ.
ዕውር	ቅ.
ዕዋል	ስ.
ዕዝል	
ዕዝን	ስ.
ዕዳው	ስ.
ዕድው	ስ.
ዕድ	ስ.
ዕጐልት	ስ.
ዕጕስታር	ስ.
ዕጓል	ስ.
ዕፃ	ስ.
ዕፍረት	ስ.
ዖረ	ግ.
ዕውር	ቅ.
ዑረት	ሳዘ.
አዖረ	አስ.አ.
ዖቀ	ርግ.
ተዐውቀ	ተደ.አ.
ዕዉቅ	ቅ.
ዕውቀት	ሳዘ.
ዖም	ስ.
ዖደ	ርግ.
ዐዋዲ	ቅ.
ቃለዐዋዲ	
ዑደት	ሳዘ.
ዐውድ	ዘዘ.
ዐውደርእይ	
ዐውደትምህርት	
ዐውደጥናት	
ዐውደፍትሕ	
ዖፈ	ግ.
ዖፍ	ዘዘ.
ዘ	መግ.
ዘሀረ	ግ.
ዝሁራ	ዘዘ.
ዝሁር	ቅ.
ዘለ	ርግ.
ምዝላል	ባዘ.
መዝለል	ባዘ.
ዘለለ	ርግ.
ዝልል	ዘዘ.
ዘሊላ	ስ.
ዘለሰ	ርግ.
ዘለሳ	ዘዘ.
ዘለቀ	ግ.
ዘለገ	ግ.
ዝልግልግ	ዘዘ.
ዘለፈ	ኢ/ርግ. 
ዘላፊ	ቅ.
ተዘልፈ	ተደ.አ.
ዝሉፍ	ቅ.
ዝልፈት	ሳዘ.
መዝለፊ	ባቅ.
ዘለፋ	ዘዘ.
ተዛለፈ	ተዳ.አ.
ተዛላፊ	ቅ.
ዘልገሰ	ግ.
ዝልጉስ	ቅ.
ዝልጋሴ	ዘዘ.
ዘሐቀ	ርግ.
ዘሓቂ	ቅ.
ዝሕቅ	ዘዘ.
ተዝሕቀ	ተደ.አ.
ዝሑቅ	ቅ.
ምዝሓቅ	ቅ.
ዘሐብ	ስ.
ዘሕዝሐ	ርግ.
ዝሕዙሕ	ቅ.
ዘመ	ርግ.
ዝማም	ዘዘ.
ዘመመ	ርግ.
ዘማሚ 	ቅ.
አማሜ	ዘዘ.
ዘመረ	ርግ.
ዘማሪ	ቅ.
መዘምር	ባቅ.
መዝሙር	ባዘ.
ዝማሬ	ዘዘ.
ዘመነ	ኢ/ርግ.
ዘመን	ዘዘ.
ዘመናዊ	ቅ.
ዘመወ	ኢ/ርግ.
ዘማዊ	ቅ.
ዝማዌ	ዘዘ.
ዝሙት	ዘዘ.
ዘማ	ዘዘ.
አዘመወ	አስ.አ.
መዘምው	ባቅ.
ዘመደ	ርግ.
ዘመድ	ዘዘ.
ተዘምደ	ተደ.አ.
ዝሙድ	ቅ.
ዝምደት	ሳዘ.
ትዝምድ	ባዘ.
አዝሙድ	ባዘ.
ዘረ	ርግ.
አዝራር	ባዘ.
ዘራት	ስ.
ዘረቀ	ርግ.
ዘርቅ	ዘዘ.
ምዝራቅ	ባዘ.
ዘረበ	ርግ.
ዘርብ	ዘዘ.
መዝረብ	ባዘ.
ዘረወ	ርግ.
ዘራዊ	ቅ.
ተዘርወ	ተደ.አ.
ዝርው	ቅ.
ዝርወት	ሳዘ.
ዘሮ	ዘዘ.
ዘረየ	ርግ.
ዘረፈ	ርግ.
ዘራፊ	ቅ.
ዘርፍ	ዘዘ.
ዘረቦን	ስ.
ዘራካፕ	ስ.
ዘርሐ	ርግ.
ዝሩሕ	ቅ.
ዘርቅሐ	ርግ.
ዘርበተ	ርግ.
ዘርቤት	ዘዘ.
ዘርቤን	ስ.
ዘርቤዶ	ስ.
ዘርቦን	ስ.
ዘርከየ	ርግ.
ዘርካዪ	ቅ.
መዘርክይ	ባቅ.
ተዘርከየ	ተደ.አ.
ዝርኩይ	ቅ.
ዘርዐ	ርግ.
ዘራዒ	ቅ.
ተዘርዐ	ተደ.አ.
ዝሩዕ	ቅ.
ዝርዐት	ሳዘ.
ዘርዕ	ዘዘ.
መዝርዕ	ባዘ.
መዝራዕት	ባከዘ.
መዝርዕ	ስ.
ዘርዘረ	ርግ.
ዘርዛሪ	ቅ.
ተዘርዘረ	ተደ.አ.
ዝርዙር	ቅ.
ዘርዘር	ዘዘ.
ዘርዜቀ	ሥግ.
ዘርቤቅ	ዘዘ.
ዘርገፈ	ግ.
ዝርግፍ	ዘዘ.
ዘቀ	ግ.
ዝቅ	ዘዘ.
ዘበለ	ርግ.
ዝብል	ዘዘ.
መዝበል	ባዘ.
ዘበረ	ርግ.
ዘብርት	ምዘ.
ዘበነ	ርግ.
ዘባን	ዘዘ.
ዘባናዊ	ቅ.
ዘበየ	ርግ.
ዘቢብ	ስ.
ዘበጠ	ርግ.
ዘባጢ	ቅ.
መዝበጥ	ባዘ.
ተዘብጠ	ተደ.አ.
ዝቡጥ	ቅ.
ዝብጠት	ሳዘ.
ዝብጦ	ዘዘ.
ተዛበጠ	ተዳ.አ.
ዘብጥ	አማ.
ዘብሐ	ርግ.
ዘባሒ	ቅ.
ተዘብሐ	ተደ.አ.
ዝቡሕ	ቅ.
ምዝባሕ	ባዘ.
መዝብሕ	ቅ.
ዘብአ	ግ.
ዘብዘበ	ግ.
ዘብድው	ስ.
ዘትር	ስ.
ዘነቀ	ርግ.
ዘነበ	ርግ.
ዘነብ	ዘዘ.
ዝንብ	ስ.
ዘነየ	ግ.
ዝንየት	ሳዘ.
ዘፈነ	ርግ.
ዘፋኒ	ቅ.
ዘፈን	ዘዘ.
አዝፈነ	አስ.አ.
ምዝፋን	ባዘ.
ዙፋን	ስ.
ዘናና	ስ.
ዘንመ	ግ.
አዝነመ	አድ.አ.
ዝናም	ዘዘ.
ዘንቢር	ስ.
ዘንጐጐ	ርግ.
ዘንጓጕ	ቅ.
ተዘንጐጐ	ተደ.አ.
ዝንጉግ	ቅ.
ዝንጓጌ	ዘዘ.
ዘንግሐ	ርግ.
ዘንግዐ	ርግ.
አዘንግዐ	አስ.አ.
አዘንጋዒ	ቅ.
ተዘንግዐ	ተደ.አ.
ዝንጉዕ	ቅ.
ዝንጋዔ	ዘዘ.
ዘከረ	ርግ.
ዘካሪ	ቅ.
አዘከረ	አስ.አ.
መዘክር	ቅ.
ምዝካር	ባዘ.
ተዘከረ	ተደ.አ.
ዝኩር	ቅ.
ዝክረት 	ሳዘ.
ዝክር	ዘዘ.
ተዝካር	ባዘ.
ዘከ	ግ.
ዘካርያስ	ተጸስ.
ዘኬዎስ	ተጸስ.
ዘወረ	ርግ.
ዘዋሪ 	ቅ.
መዘውር	ባቅ.
ዘውር	ዘዘ.
ዘውግ	ስ.
ዘዌ	ስ.
ዘዘ	መዋ.
ዘይቶን	ስ.
ዘገበ	ርግ.
ዘጋቢ	ቅ.
መዝገብ	ባዘ.
መዝገበቃላት	ጥቃ.
ተዘግበ	ተደ.አ.
ዝጉብ	ቅ.
ዘገባ	ዘዘ.
ዘግባ	ስ.
ዘገነ	ርግ.
ዝግን	ዘዘ.
መዝገን	ባዘ.
ዘግሐ	ርግ.
ዘጋሒ	ቅ.
ተዘግሐ	ተደ.አ.
ዝጉሕ	ቅ.
ዝጉሓዊ	ቅ.
ዝግሐት	ሳዘ.
መዝግሕ	ባዘ.
ዘግዐ	ርግ.
ዘፈር	ስ.
ዘፈተ	ርግ.
ዝፍት	ዘዘ.
ዘፈነ	ኢግ.
ዘፋኒ	ቅ.
ዘፈን	ዘዘ.
አዝፈነ	አስ.አ.
ምዝፋን	ባዘ.
ዙፋን	ዘዘ.
ዙሐል	ስ.
ዚኣ	
/ዚኣ - የ/ = ዚኣየ	
ዚኣነ	
ዚኣከ	
ዚኣክሙ	
ዚኣኪ	
ዚኣክን	
ዚኣሁ	
ዚአሆሙ	
ዚኣሃ	
ዚኣሆን	
ዚፋል	ስ.
ዛ.	
ዛህለለ	ግ.
ንዝህላል	ባቅ.
ዛልታቴዳ	ስ.
ዛር	ስ.
ዛራዊ	ቅ.
ዛርት	ስ.
ዛብሎን	ተጸስ.
ዛተ	
ዛቲ	
ዛኅነነ	ርግ.
ዝኅንን	ዘዘ.
ዛኅን	ስ.
ዛወፈ	ግ.
ዛውፍ	ዘዘ.
ዛዕጐል	ስ.
ዛጐል	ስ.
ዜመ	ርግ.
ዘያሚ	ቅ.
ዜማ	ዘዘ.
ዜማዊ	ቅ.
ዜቡስ	ስ.
ዜቡስ	ስ.
ዜነ	ርግ.
ዘያኒ	ቅ.
መዘይን	ቅ.
ዜነወ	ሥግ.
ዜናዊ	ቅ.
መዜንው	ባቅ.
ዜና	ዘዘ.
ዜናመዋዕል	
ጦማረዜና	
መጽሐፈ ዜና 	
ዜውስ	ስ.
ዝ	ቅ.
ዝህመ	ግ.
ዝህም	ዘዘ.
ዝህተ	ግ.
ዛህት	ዘዘ.
ዝሉፍ	ቅ.
ዝሕለ	ግ.
ዘሓሊ	ቅ.
ዝሑል	ቅ.
ዛሕል	ዘዘ.
አዝሐለ	አስ.አ.
አዝሓሊ	ቅ.
ዙሐል	ስ.
ዝማም	ስ.
ዝርፕ	ስ.
ዝስኩ	ቅ.
ዝቅ	ስ.
ዝብል	ስ.
ዝብድ	ስ.
ዝብድይ	ስ.
ዝኅረ	ግ.
ተዝኅረ	አድ.አ.
ዝኁር	ቅ.
ዝኁራዊ	ቅ.
ትዝኅርት	ምዘ.
ዝኅር	ስ.
ዝኅነ	ግ.
ዝኁነ	ቅ.
ዝኅነት	ሳዘ.
ዛኅነ	ዘዘ.
ዝኆን	ስ.
አዝኀነ	አስ.አ.
አዝኃኒ	ቅ.
ዝናር	ስ.
ዝንቱ	ቅ.
ዝእብ	ስ.
ዝኩ	ቅ.
ዝክቱ	ቅ.
ዝዕላ	ስ.
ዝየ	
ዝያቆን	ስ.
ዝግራ	ስ.
ዞም	ስ.
ዞሪት	ስ.
ዞዐ	ግ.
ዛውዕ	ዘዘ.
ተዛውዐ	ተደ.አ.
ዝዉዕ	ቅ.
ዞገ	ርግ.
ተዘውገ	ተደ.አ.
ዝዉግ	ቅ.
ተዛወገ	ተዳ.አ.
ተዛዋጊ	ቅ.
ዘወግ	ዘዘ.
ዞጲ	ስ.
የመመ	ርግ.
ያም	ዘዘ.
የመነ	ግ.
የማን	ዘዘ.
ይምን	ዘዘ.
የማናዊ	ቅ.
አይመነ	አድ.አ.
የመን	
የመናዊ	ቅ.
የሱስ	
የበበ	ርግ.
የባቢ	ቅ.
ይባቤ	ዘዘ.
የብስ	ኢግ.
ይቡስ	ቅ.
ይብስት	ሳዘ.
የብስ	ዘዘ.
አይበስ	አድ.አ
አይባሲ	ቅ.
የካተት	
የውሀ	ርግ.
የዋሂ	ቅ.
ተየውሀ	ተደ.አ.
የዋህ	ቅ.
የውሀት	ምዘ.
ይዋሄ	ዘዘ.
የውጣ	
የድዐ	ርግ.
አይድዐ	አስ.አ.
ተየድዐ	ተደ.አ.
ይዱዕ	ቅ.
ዳዒ	ዘዘ.
እንዳዒ	ተግ.
ያህ	
ያሬድ	ተጸስ.
ያርብሕ	ስ.
ያቁም	ስ.
ያኖስ	ስ.
ያክንት	ስ.
ያዕቆብ	ተጸስ.
ያፌስ	ቅ.
ያፌት	ተጸስ.
ይሁዳ	ተጸስ.
አይሁዳዊ	ቅ.
ይሆዋ	
ይሳኮር	ተጸስ.
ይስሐቅ	ተጸስ.
ይቤ	
ይብል	ዘአ/ትአ.
ብሂል/ብሂሎት	
ቤለ	ኀአ.
ይቤ	ትን.አ.
ይእቲ	
ይእቲ መጽአት	
ይእቲ ብእሲት መጽአት	
እኅትየ ይእቲ ሰሎሜ	
ይእዜ	የጊዜ ተግ.
ዮሐንስ	ተጸስ.
ዮም	የጊዜ ተግ.
የማዊ	ቅ.
ዮርዳኖስ	
ዮሴፍ	ተጸስ.
ዮቅጣን	ተጸስ.
ዮቶር	ተጸስ.
ዮና	ስ.
ዮናስ	ተጸስ.
ዮናን	ተጸስ.
ዮናናዊ	ቅ.
ዮናኒ	ስ.
ዮን	ስ.
ዮዳ	
ዮጊ	ተግ.
ዮፍታሔ	ተጸስ.
ደለለ	ርግ.
ድሉል	ቅ.
ድላሌ	ዘዘ.
ደሊላ	ስ.
ደለቀ	ግ.
አድለቅልቀ	አስ.
ድልቅልቅ	ዘዘ.
ደለወ	ርግ.
ደላዊ	ቅ.
መድሎት	ባከዘ.
አድለወ	አስ.አ.
አድላዊ	ቅ.
መደልው	ባቅ.
መድልው	ቅ.
ተደለወ	ተደ.አ.
ድልው	ቅ.
ድልወት	ሳዘ.
ተድላ	ባዘ.
ደገለ	ርግ.
ድሉግ	ቅ.
ተዳለገ	ተዳ.አ.
ድላግ	ዘዘ.
ደሐረ	ርግ.
ደሐሪ	ቅ.
ደሐየ	ርግ.
ደሐዪ	ቅ.
መድሔ	ባዘ.
ደሐፈ	ርግ.
ድሑፍ	ቅ.
ደመመ	ኢ/ርግ.
ደማሚ	ቅ.
አድመመ	አስ.አ.
መድምም	ቅ.
ድማም	ዘዘ.
ደማሚት	ባዘ.
ደመረ	ርግ.
ደማሪ	ቅ.
መደምር	ባቅ.
ተደመረ	ተደ.አ.
ድሙር	ቅ.
ድማሬ	ዘዘ.
ትድምርት	ባከ.
ደመራ	ዘዘ.
ደመቀ	ርግ.
ድሙቅ	ቅ.
ድምቀት	ሳዘ.
ደመቅ	ዘዘ.
ደመነ	ግ.
ድሙን	ቅ.
ድማኔ	ዘዘ.
ደመና	ዘዘ.
ደመንሚን 	ምዘ.
ደመአስካል	ስ
ደመወ	ግ.
ድምው	ቅ.
አድመወ	አድ.አ.
ደም	ዘዘ.
ደማዊ	ቅ.
ደመነፍስ	
ደመትክቶ	(ጥቃ.)
ደማሊ	ስ.
ደማስቆ	ስ.
ደምሐ	ርግ.
መድምሕ	ባቅ.
ደምረዝ	ስ.
ደምሰ	ግ.
ድሙስ	ቅ.
ደምሰሰ	ርግ.
ድምሳሲ	ቅ.
ተደምሰስ	ተደ.አ.
ድምሱስ	ቅ.
ድምሳሴ	ዘዘ.
ደምኀ	ግ.
ድማኅ	ዘዘ.
ደምዐ	ርግ.
አድምዐ	አስ.አ.
ደምደመ	ርግ.
ድምድማ	ዘዘ.
ደምፀ	ግ.
ድሙፅ	ቅ.
አድመፀ	ተደ.አ.
መድመፅ	ባዘ.
ደረመን	ስ.
ደረ	ርግ.
ድራሪ	ቅ.
ተደረ	ተደ.አ.
ድሩር	ቅ.
ድራር	ዘዘ.
ደረሰ	ርግ.
ደራሲ	ቅ.
ድርሰት	ሳዘ.
ተደርሰ 	ተደ.አ.
ድሩስ	ቅ.
ድርሳን	ምዘ.
ተደራሲ	ባቅ.
ደረበ	ርግ.
ደራቢ	ቅ.
ደረከ	ግ.
ድሩክ	ቅ.
መድረክ	ባዘ.
ደረገ 	ርግ.
አድረገ	አስ.አ.
ድሩግ	ቅ.
ድርገት	ሳዘ.
ደርግ	ዘዘ.
ደርጉ	ስ.
ደረጸ	ርግ.
ዶርጻ	ቅ.
ደርሰኔ	ስ.
ደርበየ	ርግ.
ደርባዪ	ቅ.
ደርከኖ	ስ.
ደርዐ	ግ.
ድሩዕ	ቅ.
ድርዕ	ዘዘ.
ደርግሐ	ርግ.
ድርጋሕ	ዘዘ.
ደሰ	ርግ.
ዳስ	ዘዘ.
ዳሳ	ዘዘ.
ደሰየ	ርግ.
ደሴት	ምዘ.
ደስቀን	ስ.
ደስከን	ስ.
ደስካና	ስ.
ደስጴዳ	ስ.
ደቀሰ	ግ.
ድቁስ	ቅ.
ድቃስ	ዘዘ.
ምድቃስ	ባዘ.
ደቀ	ኢግ.
ድቁት	ቅ.
ደቅ.	ዘዘ.
ደቀመዝሙር	(ጥቃ.)
ደቀጽርሕ	(ጥቃ.)
ደቂቃ	ስ.
አድቀቀ	አድ.አ.
መድቅቅ	ባቅ.
ደቅሐ	ርግ.
መድቅሕ	ባቅ.
ደበለ 	ርግ.
መድበል	ባዘ.
ተዳበለ	ተደ.አ.
ደብል	ሮማ.
ደበረ	ርግ.
ደባሪ	ቅ.
መደብር	ባቅ.
ደብር	ዘዘ.
ደበርቢር	ስ.
ደበበ	ርግ.
ደባቢ	ቅ.
ድባብ	ዘዘ.
ደቡብ	ዘዘ.
ደቡባዊ	ቅ.
ተደበ	ተደ.አ
ድቡት	ቅ.
ድቡተ	ተግ.
ደበወ	ኢግ.
ድብ	ዘዘ.
ደበየ	ርግ.
ደባዪ	ቅ.
ደብተረ	ርግ.
ደብተራ 	ዘዘ.
ደብተራዊ	ቅ.
ተደብተረ	ተደ.አ.
ድብቱር	ቅ.
ድብታሬ	ዘዘ.
ደብደበ	ኢ/ርግ.
ድብዱብ	ቅ.
ደኀረ	ኢ/ርግ.
ደኃሪ	ቅ.
ደኃራዊ	ቅ.
ድኅር	ዘዘ.
ድኅረት	ምዘ.
ተድኅረ	ተደ.አ.
ድኁር	ቅ.
አድኀረ	አስ.አ.
አድኃሪ	ቅ.
ደኀየ	ርግ.
ደኃ	ቅ.
ተድኅየ	ተደ.አ.
ድኁይ	ቅ.
ደኅኅ	ኢ/ርግ.
ድኁኅ	ቅ.
ደነሰ	ኢ/ርግ.
ድኑስ	ቅ.
ደነስ	ዘዘ.
ዐስበደነስ	(ጥቃ.)
ደንሳዊ	ቅ.
ዳንስ	ሮማ
ደነቀ	ኢግ.
ድንቀት	ሳዘ.
ደነነ	ኢግ.
ደኑን	ቅ.
አድነነ	አስ.አ.
አድናኒ	ቅ.
ድናኔ	ዘዘ.
ምድናን	ባዘ.
ደነከ	ርግ.
ድኑክ	ቅ.
ደነክ	ዘዘ.
ድንክ	ቅ.
ደነዘ 	ኢግ.
ደንቀል	ስ.
ደንቀወ	ኢግ.
ድንቅው	ቅ.
ድንቃዌ	ዘዘ.
አደንቀወ	አድ.አ.
አደንቃዊ	ቅ.
ደንበዘ	ርግ.
ስንሳዝ	ዘዘ.
ደንዘዘ	ኢግ.
ድንዙዝ	ቅ.
ድንዛዜ	ዘዘ.
ደንደር	ስ.
ደንደነ	ግ.
ድንዱን	ቅ.
ደንግለ	ርግ.
ተደንገለ	ተደ.አ.
ድንጉል	ቅ.
ድንግል	ዘወቅ.
ድንግላዊ	ቅ.
ድንጋሌ	ዘዘ.
ድንግልና	ጥዘ.
ድንጐላ	ስ.
ደንገገ	ርግ.
ደንጋጊ	ቅ.
ተደንገገ	ተደ.አ.
ድንጉግ	ቅ.
ድንጋጌ	ዘዘ.
ድንጋግ	ዘዘ.
ደንገፀ	ግ.
ድንጉፅ	ቅ.
ድንጋፄ	ዘዘ.
አደንገፀ	አስ.አ.
መደንግፅ	ቅ.
ደንጸወ	ኢግ.
ደንጻዊ	ቅ.
ድንጽው	ቅ.
ድንጻዌ	ዘዘ.
ደአመ	ርግ.
ደኣሚ	ቅ.
ደከመ	ኢግ.
ድኩም	ቅ.
ድካም	ዘዘ.
ድክመት	ሳዘ.
ድክምና	ምዘ.
አድከመ	አድ.አ.
አድካሚ	ቅ.
መድክም	ቅ.
ደክተመ	ግ.
ድክቱም	ቅ.
ደክታም	ቅ.
ድክትምና 	ምዘ.
ድክታሜ	ዘዘ.
ደወለ	ርግ.
ደወል	ዘዘ.
ደወረ	ርግ.
ድር	ዘዘ.
ደወየ	ኢግ.
ድውይ	ቅ.
ደዌ	ዘዘ.
አድወየ	አድ.አ.
አድዋዪ	ቅ.
ደውርሀ	ግ.
ዶርሆ	ስ.
ደየነ	ርግ.
ዳያኒ	ቅ.
መደይን	ባቅ.
ደይን	ዘዘ.
ተደየነ	ተደ.አ.
ድዩን	ቅ.
ደደቀ	ኢ/ርግ.
ተደደቀ	ተደ.አ.
ድድቅ	ዘዘ.
ደደከ	ስ.
ደገል	ስ.
ደገመ	ርግ.
ደጋሚ	ቅ.
ምድጋም	ባዘ.
ድጋም	ዘዘ.
ተደግመ	ተደ.አ.
ድጉም	ቅ.
ዳግም	ቅ.
ዳግማዊ	ቅ.
ዳግመ	ተግ.
ደጐረ	ርግ.
ድጒር	ዘዘ.
ደገገ	ግ.
ደጋ	ዘዘ.
ደጉጸ	ርግ.
ደጋጺ	ቅ.
መድጐጽ	ባዘ.
ድጕጸት 	ሳዘ.
ተደጒጸ	ተደ.አ.
ድጒጽ	ቅ.
ደገፈ	ርግ.
ደጋፊ	ቅ.
ተደግፈ	ተደ.አ.
ድጉፍ	ቅ.
ደጋን	ስ.
ደጒዓሌ	ስ.
ደግደገ	ኢግ.
ድግዱግ	ቅ.
ደግዲግ	ዘዘ.
ድጓ	
ደጐብያ	ስ.
ደፈረ	ርግ.
ደፋሪ	ቅ.
ድፍረት	ሳዘ.
ተደፍረ	ተደ.አ.
ደፈር	ዘዘ.
ደፈነ	ርግ.
ደፋኒ	ቅ.
ተደፍነ	ተደ.አ.
ድፉን	ቅ.
ድፍነት	ሳዘ.
ዳፍንት	ምዘ.
መድፍን	ባዘ.
ደፍዐ	ርግ.
ደፋዒ	ቅ.
መድፍዕ	ባዘ.
ድፍዕ	ዘዘ.
ደፍዕ	ዘዘ.
ደፍደፈ	ርግ.
ድፍድፍ	ዘዘ.
ዱራፒ	ስ.
ዱራፕ	ስ.
ዱር	ስ.
ዲሎሳን	ስ.
ዲራግቦ	ስ.
ዲበ	መዋ.
ዲባግ	ስ.
ዲብዲቆን	ስ.
ዲናር	ስ.
ዲያቆን	ስ.
ዲያቆናዊ	ቅ.
ዲያቆናይ	ቅ.
ዲያብሎስ	ስ.
ድዮርስቆሮስ	ተጸስ.
ዲዮስጶራ	ስ.
ዲዲሞስ	ተጸስ.
ዲድስቅልያ	ስ.
ዲፈት	ስ.
ዳሂ	ስ.
ዳህመመ	ርግ.
ዳህማሚ	ቅ.
ዳሌ	ስ.
ዳረገ	ርግ.
ዳራጊ	ቅ.
ተዳረገ	ተዳ.አ.
ድሩግ	ቅ.
ድርጎ	ዘዘ.
ደራጎን	
ዳርቃስ	ስ.
ዳርዮስ	ተጸስ.
ዳቤላ	ስ.
ድመት	ስ.
ድራሞ	ስ.
ድርህም	ስ.
ድርሙስ	ስ.
ድርንቅ	ስ.
ድራር	ስ.
ድርክሜ	ስ.
ድስቡጣ	ስ.
ድብ	ስ.
ድኅር	ስ.
ድኅነ	ግ.
ድኁን	ቅ.
አድኀነ	አድ.አ.
አድኃኒ	ቅ.
መድኅን	ቅ.
መድኃኒት	ምዘ.
ዳኅን	ዘዘ.
ዳኅና	ዘዘ.
ድኅፀ	ግ.
ድኁፅ	ቅ.
ደኃፂ	ቅ.
ዳኅፅ	ዘዘ.
ድንግል	ቅ.
ድንታር	ስ.
ድንት	ስ.
ድያስ	ስ.
ድዮስ	ስ.
ድድክሜ	ስ.
ድድ	ስ.
ድጒዓ	
ድግድግ	ስ.
ደርሆ	ስ.
ዶር	ስ.
ዶርቃስ	ስ.
ዶድ	ስ.
ዶዶ	ስ.
ገሀደ	ርግ.
ገሃዲ	ቅ.
ገሃደ	ተግ.
ተግህደ	ተደ.አ.
ግሁድ	ቅ.
ግህደት	ሳዘ.
ግህድና	ምዘ.
ገሀድ	ዘዘ.
አግሀደ	አስ.አ.
አግሃዲ	ቅ.
መግህድ	ባቅ.
ገሀፈ	ርግ.
ገሃፊ	ቅ.
ተግህፈ	ተደ.አ.
ግሁፍ	ቅ.
ገሀፍት	መድ.ቅ.
ገሃነም	ስ.
ገሃነማዊ	ቅ.
ገህሀ	ኢግ.
ገሃህ	ዘዘ.
ጐሀነ	ርግ.
ጐሃኒ	ቅ.
ጕህን	ዘዘ.
ጒህና	ምዛ.
ገለ	ርግ.
ተገለ	ተደ.አ.
ግሉል	ቅ.
ግላል	ዘዘ.
ገሊላ	
ገሊላዊ	ቅ.
ገለለ	ርግ.
ግላስ	ዘዘ.
ገለበ	ርግ.
ገላቢ	ቅ.
ገለብ	ስ.
መግለብ	ባዘ.
ገለወ	ርግ.
ገላዊ	ቅ.
ተገልወ	ተደ.አ.
ግልው	ቅ.
ግላ	ዘዘ.
ገለየ	ርግ.
ገለዪ	ቅ.
አግለየ	አስ.አ.
እገሌ	ተው.ስ.
ገለደ	ርግ.
ተግሊድ	ባዘ.
ገለፈ	ርግ.
ገላፊ	ቅ.
ተግልፈ	ተደ.አ.
ግሉፍ	ቅ.
ግልፎ	ዘዘ.
ገለዓድ	
ገላሜዎስ	ስ.
ገላውቅያ	ስ.
ገልሚን	ስ.
ገልበበ	ርግ.
ገልባቢ	ቅ.
ተገልበበ	ተደ.አ.
ግልቡብ	ቅ.
ግልባቤ	ዘዘ.
ጐለተ	ርግ.
ጒልት	ዘዘ.
ጐልሐ	ግ.
ጒልሕ	ቅ.
ገልዕ	ስ.
ጐሐለ	ርግ.
ጐሓሊ	ቅ.
ገሐሠ	ኢግ.
ገሓሢ	ቅ.
ግሑሥ	ቅ.
ግሕሠት	ሳዘ.
አግሐሠ	አስ.አ.
አግሓሢ	ቅ.
ምግሓስ	ባዘ.
ገሐየ	ግ.
ግሔ	ስ.
ጐሐየ	ርግ.
ምጒሕያ	ባዘ.
ገሐፈ	ርግ.
ገሓፊ	ቅ.
ተግሕፈ	ተደ.አ.
ግሑፍ	ቅ.
ግሕፈት	ሳዘ.
ምግሓፍ	ባዘ.
ጋሕፍ	ዘዘ.
ገመል	ግ.
ገመላዊ	ቅ.
ገመረ	ርግ.
ተገምረ	ተደ.አ.
ግሙር	ቅ.
አግመር	አስ.አ.
ትግምርት	ባከዘ.
ገመር	ስ.
ጎሞር	ስ.
ገመሰ	ርግ.
ገማሲ	ቅ.
ተገምሰ	ተደ.አ.
ግሙስ	ቅ.
ገመስ	ዘዘ.
ገመተ	ርግ.
ገመታ	ዘዘ.
ገመነ	ኢግ.
ግሙን	ቅ.
ግማኔ	ዘዘ.
ግመን	ዘዘ.
ገመደ	ርግ.
ገማዲ	ቅ.
ተገምደ	ተደ.አ.
ግሙድ	ቅ.
ግማዴ	ዘዘ.
ግማድ	ዘዘ.
ገሚድ	ዘዘ.
ገመድ	ዘዘ.
ገሙስ	ስ.
ጐማሪ	ስ.
ጐሜእ	ስ.
ገምአ	ርግ.
ገማኢ	ቅ.
ግሙእ	ቅ.
ግምእት	ሳዘ.
ግማኤ	ዘዘ.
ገሞራ	
ገሞራዊ	ቅ.
ገሠሠ	ርግ.
ገሣሢ	ቅ.
ተገሠ	ተደ.አ
ግሡሥ	ቅ.
ግሥ	ዘዘ.
ገሠጸ	ርግ.
ገሣጺ	ቅ.
መገሥጽ	ባቅ.
ተገሠጸ	ተደ.አ
ግሡጽ	ቅ.
ግሣጼ	ዘዘ.
ተግሣጽ	ባዘ.
ጐሥዐ	ኢ/ርግ.
ጐሣዒ	ቅ.
ጒሥዓት	ሳዘ.
ገረመ	ግ.
ግሩም	ቅ.
ግርማ	ዘዘ.
ግርምት	ባከዘ.
ገሪማ	ተጸሰ.
ግራም	
ገረሠ	ርግ.
ገርሣ	ዘዘ.
ገርሥ	ስ.
ገረረ	ግ.
ገራሪ	ቅ.
ርጉር	ቅ.
ግረት	ሳዘ.
ግረት	ስ.
አግረረ	አስ.አ.
አግራሪ	ቅ.
መግረሪ	ቅ.
ጐረጸ	ርግ.
መጕረጽ	ባቅ.
ገረፈ	ርግ.
ገሪፍ	ዘዘ.
ምግራፍ	ባዘ.
ገርሀ	ርግ.
ገራሂ	ቅ.
ገራህት	ምዘ.
ገርሐ	ርግ.
ገራሒ	ቅ.
ተገርሐ	ተደ.አ.
ግሩሕ	ቅ.
ገርሕ	ቅ.
ገርሳ	ስ.
ጐርዐየ	ርግ.
ጕርዔ	ዘዘ.
ጕርዔያዊ	ቅ.
ገርዜን	ስ.
ገርገረ	ርግ.
ገርጋሪ	ቅ.
ገበበ	ርግ.
ግብ	ዘዘ.
ግበዓይን	
ገበታ	ስ.
ገበዘ	ርግ.
ገበዝ	ዘዘ.
ገበጣ	ስ.
ገብአ	ርግ.
ገባኢ	ቅ.
ግቡእ	ቅ.
ግብአት	ሳዘ.
ግብዓተመሬት	
ምግባእ	ባቅ.
አግብአ	አድ.አ.
አስተጋብአ	አስ.አ
መስተጋብእ	ባቅ.
ገብላ	ስ.
ገብረ	ሥግ.
ገባሪ	ቅ.
ግብር	ዘዘ.
ተገብረ	ተደ.አ
ግቡር	ቅ.
ግብረት	ሳዘ.
ምግባር	ባዘ.
ተግባር	ባዘ.
ገብር	ስ.
ገብርኤል	
ገብሮናሂ	ስ.
ገብሮዳኒ	ስ.
ገቦ	ስ.
ገብገብ	ስ.
ገተ	ርግ.
ገታቲ	ቅ.
ተገተ	ተደ.አ.
ግቱት	ቅ.
ግተት	ዘዘ.
ገነበ	ርግ.
ገናቢ	ቅ.
ተገንበ	ተደ.አ.
ግንባት	ምዘ.
ገንቦ	ስ.
ግንቦት	
ገነት	ስ.
ገነወ	ርግ.
ገናዊ	ቅ.
ገነውት	መድ.ቅ.
ገንዘ	ርግ.
ገናዚ	ቅ.
ተገንዘ	ተደ.አ.
ግኑዝ	ቅ.
ግንዘት	ሳዘ.
ገንዘብ	ባዘ.
ገነየ	ርግ.
ገናዪ	ቅ.
ግናይ	ዘዘ.
ጐነደ	ግ.
ጕንድ	ዘዘ.
ጒንድመስቀል	
ጕንደማኀፈድ	
ጕንደዳዊት	
ገነጰ	ርግ.
ገነጳ	ዘዘ.
ገነፈ	ርግ.
ገናፊ	ቅ.
ገንሐ	ኢግ.
ገናሒ	ቅ.
ግኑሕ	ቅ.
ገንሕ	ዘዘ.
ግናሕ	ዘዘ.
ገንተተ	ግ.
ገንታ	ዘዘ.
ጐንደየ	ኢግ.
ጒንዱይ	ቅ.
ጉንዳን	ምዛ.
ገንደር	ስ.
ገንጰለ	ርግ.
ገንጳሊ	ቅ.
ግንጳሌ	ዘዘ.
ገንፈለ	ርግ.
ግንፉል	ዘዘ.
ገአዘ	ኢ/ርግ.
ገአዚ	ቅ.
መግእዝ	ባቅ.
ተግእዘ	ተደ.አ.
ግኡዝ	ቅ.
ግእዘት	ሳዘ.
ተጋአዘ	ተዳ.አ.
ጋእዝ	ዘዘ.
ገወለ	ርግ.
ጎል	ዘዘ.
ገውዝ	ስ.
ገዐረ	ግ.
ገዓሪ	ቅ.
ገዓር	ዘዘ.
አግዐረ	አስ.አ.
አግዓሪ	ቅ.
ገዐተ	ርግ.
ገዓቲ	ቅ.
ገዐት	ዘዘ.
ጋዕት	ዘዘ.
ጐዕተየ	ርግ.
ጒዕቱይ	ቅ.
ጒዕትያ	ዘዘ.
ገዘመ	ርግ.
ገዛሚ	ቅ.
ገዝም	ዘዘ.
ተገዝመ	ተደ.አ.
ግዙም	ቅ.
ግዝመት	ሳዘ.
ገዘረ	ርግ.
ገዛሪ	ቅ.
ተገዝረ	ተደ.አ.
ግዙር	ቅ.
ግዝረት	ሳዘ.
ገዘ	ርግ.
ገዛዚ	ቅ.
መግዝዝ	ባቅ.
መግዘዝ	ባዘ.
ገዝአ	ርግ.
ገዛኢ	ቅ.
ገዛእት	መድ.ቅ.
መግዝእ	ባዘ.
አግዝአ	አስ.አ.
እግዚእ	ቅ.
እግዝእት	ቅ.
እግዚኦ	
እግዚአብሔር	
እግዚእ	
ተገዝአ	ተደ.አ.
ግዙእ	ቅ.
ግዝአት	ሳዘ.
ግዝእ	ዘዘ.
ገዝፈ	ኢግ.
ግዙፍ	ቅ.
ግዘፍ	ዘዘ.
ግዝፈት	ሳዘ.
ገየለ	ርግ.
ገላይ 	ዘዘ.
ገየረ	ርግ.
ተገየረ	ተደ.አ.
ግዩር	ቅ.
ግይርና 	ምዘ.
ጐየ	ኢግ.
ጐያዪ	ቅ.
ጒዩይ	ቅ.
ጒየት	ሳዘ.
ጒያ	ዘዘ.
ጓያ	ስ.
አጒየየ	አስ.አ.
አጒያዪ	ቅ.
ምጒያይ	ባዘ.
ጐየጸ	ግ.
ጒይጽ	ዘዘ.
ገይብ	ስ.
ገደለ	ርግ.
ገዳሊ	ቅ.
ተገድለ	ተደ.አ.
ግዱል	ቅ.
ገደላ	ዘዘ.
ገደል	ዘዘ.
ተጋደለ	ተዳ.አ.
ተጋዳሊ	ቅ.
ገድል	ዘዘ.
አስተጋደለ	አዳ.አ.
አስተጋዳሊ	ቅ.
መስተጋድል	ባቅ.
ጐደለ	ግ.
ጐደሎ	ዘዘ.
ጒድለት	ሳዘ.
ገደመ	ኢ/ርግ.
ገዳሚ	ቅ.
ግድም	ዘዘ.
ገዳም	ዘዘ.
ገዳማዊ	ቅ.
ጐደበ	ርግ.
ጒድባ	ዘዘ.
ጒድብ	ዘዘ.
ገደወ	ርግ.
ጋዳ	ዘዘ.
ገደ	ርግ.
ግዱድ	ቅ.
ግድ	ዘዘ.
ገደድ	ዘዘ.
ግደት	ሳዘ.
ገደፈ	ርግ.
ገዳፊ	ቅ.
ተገድፈ	ተደ.አ.
ግዱፍ	ቅ.
ግድፈት	ሳዘ.
ጕድፍ	ዘዘ.
ጐድዐ	ርግ.
ጒዱዕ	ቅ.
ጕድዓት	ሳዘ.
ገድገደ	ርግ.
ገድገድ	ዘዘ.
ጐድጐደ	ርግ.
ጐድጓዲ	ቅ.
ገገጸ	ግ.
ግጋጼ	ዘዘ.
ጐጒዐ	ኢግ.
ጐጓዒ	ቅ.
ጕጉዕ	ግ.
ጒጒዓ/ጒጓዔ	ዘዘ.
ጐጠየ	ርግ.
ጐጠዪ	ቅ.
ምጒጣይ	ባቅ.
ጕጠት	ዘዘ.
ገጸወ	ግ.
ግጽው	ቅ.
ግጽው	
ግጻዌ	ዘዘ.
ገጽ	ዘዘ.
ግጽፈረ	ርግ.
ጒጽፈር	ዘዘ.
ገፈ	ርግ.
ገፋፊ	ቅ.
ገፍትዐ	ርግ.
ገፍታዒ	ቅ.
ግፍታዔ	ዘዘ.
ገፍዐ	ርግ.
ገፋዒ	ቅ.
ተገፍዐ	ቅ.
ግፉዕ	ቅ.
ግፍዓት	ሳዘ.
ግፍዕ	ዘዘ.
ጉማዕ	ስ.
ጉንባሕ	ስ.
ጉዛ	ስ.
ጉጋ	ስ.
ጊሜ	ስ.
ጊዛን	ስ.
ጊዜ	ስ.
ጊዮርጊስ	ተጸስ.
ጊጳ	ስ.
ጋሌ	ስ.
ጋልመት	ስ.
ጓልኳ	ስ.
ጓሕለወ	ርግ.
ጓሕላዊ	ቅ.
ጒሕላዌ	ዘዘ.
ጋሕር	ስ.
ጋሕፍ	ስ.
ጋርሳ	ስ.
ጋብአ	ርግ.
ተጋብአ	ተደ.አ.
አስተጋብአ	አስ.አ.
አስተጋብዒ	ቅ.
መስተጋብዕ	ባቅ.
እስትጉቡእ	ቅ.
ጉባዔ	ዘዘ.
ጉባዔቃና	ጥቃ.
ጋኔን	ስ.
ጋዛ.	
ጋየደ	ግ.
ጋይስ	ስ.
ጋዲ	
ጋጋ	ስ.
ገልጌላ	ስ.
ጌልጌል	ስ.
ጌልያ	ስ.
ጌመ	ርግ.
ጊሜ	ዘዘ.
ጌሠ	ግ.
ገያሢ	ቅ.
ጊሠት	ሳዘ.
ጌሠም	ምዘ.
ጌራ	ስ.
ጌቴሴማኒ	
ጌናስ	ስ.
ጌና	ስ.
ጌዶር	ቅ.
ጌገየ	ሥግ.
ጌጋዪ	ቅ.
ጊጉይ	ቅ.
ጌጋይ	ዘዘ.
አጌገየ	አስ.አ.
ግላ	ስ.
ግላውቃ	ስ.
ግልየት	ስ.
ጒሎ	ስ.
ግሔ	ስ.
ጒሕሉት	ስ.
ጒሕቈ	ግ.
ጒሕቊ	ቅ.
ጕሕቈት	ሳዘ.
ጒሕን	ስ.
ጒሕየ	ግ.
ጒሕያ	ዘዘ.
ጒመሮ	ስ.
ግሙራ	ተግ.
ግምዔ	ስ.
ግረት	ስ.
ግረጳ	ስ.
ግራ	ስ.
ግራብ	ስ.
ግርባብ	ስ.
ጒርን	ስ.
ግብነት	ስ.
ግብት	ስ.
ግንቦት	
ግእዘ	ርግ.
ግኡዝ	ቅ.
ግእዘት	ሳዘ.
ግእዝ	ዘዘ.
ግእዛን	ምዘ.
ግእዝና	ምዘ.
ጋእዝ	ዘዘ.
አግአዘ	አድ.አ.
አግኣዚ	ቅ.
ግእዝ	ዘዘ
ጕዕ	ስ.
ግዝት	ስ.
ግዮን	ስ.
ግጻዌ	ስ.
ጎል	ስ.
ጎልጎታ	ስ.
ጎሐ	ግ.
ጎሕ	ዘዘ.
ተጋውሐ	ተደ.አ.
ጎሞር	ስ.
ጎረ	ግ.
ጎርየመ	ሥግ.
ጎሬም	ቅ.
ጎግ	ስ.
ጠሀረ	ግ.
ጥሁር	ቅ.
ጣህር	ዘዘ.
ጥህረት	ሳዘ.
አጥሀረ	አድ.አ.
ጠለ	ግ.
ጥሉል	ቅ.
ጠል	ዘዘ.
አጥለለ	አድ.አ.
መጥለሊ	ባቅ.
መጥለል	ባዘ.
ጠለስ	ስ.
ጠለቀ	ኢ/ርግ.
ጠላቂ	ቅ.
አጥለቀ	አድ.አ.
ጥሉቅ	ቅ.
ጥልቀት	ሳዘ.
ጥላቄ	ጥዘ.
ጠለየ	ግ.
ጠሊ	ዘዘ.
ጣሊታ	ምዘ.
ጠሊሳን	ስ.
ጠልሰ	ግ.
ጠለስ	ዘዘ.
አጥላስ	ባዘ.
ጠልሰም	ስ.
ጠሐለ	ርግ.
ጠሓሊ	ቅ.
ጠሐልት	መድ.ቅ.
ተጥሕለ	ተደ.አ
ጥሑል	ቅ.
ጣሕል	ዘዘ.
ጠሐነ	ርግ.
ጥሕን	ዘዘ.
ጠመ	ግ.
ጠመቀ	ርግ.
ጠማቂ	ቅ.
መጥምቅ	ቅ.
መጥምቃዊ	ቅ.
አጥመቀ	አድ.አ.
አጥማቂ	ቅ.
ተጠምቀ	ተደ.አ
ጥሙቅ	ቅ.
ጥምቀት	ሳዘ.
ጠመኔ	ስ.
ጠምዐ	ርግ.
ጥሙዕ	ቅ.
ጥምዓት	ሳዘ.
ጠረሰ	ርግ.
ጥርስ	ዘዘ.
ጠረቀ	ርግ.
ጠራቂ	ቅ.
ጥርቆ	ዘዘ.
ተጠርቀ	ተደ.አ.
ጥሩቅ	ቅ.
ጠረዘ	ርግ.
ጠራዚ	ቅ.
ጥራዝ	ዘዘ.
ጠርዝ	ዘዘ.
ጠረየ	ርግ.
ጠራዪ	ቅ.
ጥሪት	ምዘ.
ጥር	ዘዘ.
ጥሬ	ዘዘ.
ተጠርየ	ተደ.አ.
ጥሩይ	ቅ.
ጠረጴዛ	ስ.
ጠርቤንቶስ	ስ.
ጠርአ	ርግ.
ጠራኢ	ቅ.
ጥርእ	ዘዘ.
ጠርዐ	ግ.
ጠራዒ	ቅ.
ጠርዜቤጤል	ስ.
ጠርየ	ርግ.
ጣሳዪ	ቅ.
ጠስ	ስ.
ጠቀለ	ግ.
ጠቃሊ	ቅ.
መጥቁል	ባቅ.
ጠቀመ	ርግ.
ጠቃሚ	ቅ.
ተጠቅመ	ተደ.አ.
ጥቁም	ቅ.
ጥቅም	ዘዘ.
ጥቅምት	
ጠቀረ	ግ.
ጠቀራ	ዘዘ.
ጠቀር	ዘዘ.
ጠቀሰ	ርግ.
ጥቅስ	ዘዘ.
ጠቀበ	ርግ.
ጠቃቢ	ቅ.
ተጠቅበ	ተደ.አ.
ጥቁብ	ቅ.
ጥቅበት	ሳዘ.
መጥቀብት	ባከቅ.
ጠቅለለ	ርግ.
ጠቅዐ	ርግ.
ጠቃዒ	ቅ.
መጥቅዕ	ባዘ.
ተጠቅዐ	ተደ.አ.
ጥቁዕ	ቅ.
ጠበለ	ርግ.
ጠበል	ዘዘ.
ጠበሰ	ርግ.
ጠባሲ	ቅ.
ተጠብሰ	ተደ.አ
ጥብስት	ሳዘ.
ጥብስ	ዘዘ.
መጥበስ	ባዘ.
ጠበቀ	ርግ.
ተጣበቀ	ተዳ.አ.
ጥብቅ	ቅ.
ጠበ	ግ.
ጠቢብ	ቅ.
ጥበብ	ዘዘ.
ጥበበ ሲራክ	ዝከ.
አጥበበ	አስ.አ.
መጥበቢ	ባቅ.
ጠበብት	መድ.ቅ.
ተጥባብ	ባዘ.
ጠበጠበ	ርግ.
ጠበወ	ርግ.
ጠባዊ	ቅ.
ጥብ	ዘዘ.
አጥበወ	አድ.አ.
አጥባዊ	ቅ.
ጠብለለ	ርግ.
ጠብላሊ	ቅ.
ተጠብለለ	ተደ.አ.
ጥብሉል	ቅ.
ጥብላሌ	ጥዘ.
ጠብሐ	ርግ.
ጠባሒ	ቅ.
ተጠብሐ	ተደ.አ.
ጥቡሕ	ቅ.
ጥብሕ	ዘዘ.
ጥብሐት	ሳዘ.
ምጥባሕ	ባዘ.
መጥባሕት	ባከዘ.
መጥባሕታዊ	ቅ.
ጠብጠበ	ርግ.
ጠብጣቢ	ቅ.
ተጠብጠበ	ተደ.አ.
ጥብጡብ	ቅ.
ጥብጣቤ	ዘዘ.
ጠብዐ	ግ.
ጥቡዕ	ቅ.
ጥብዓት	ሳዘ.
ጥብዕ	ዘዘ.
ጠኀረ	ግ.
ጥኅረት	ሳዘ.
ጥኅር	ዘዘ.
ጠነ	ግ.
ጥን	ዘዘ.
ጠነየ	ርግ.
ጠነይ	ዘዘ.
ጠንቀቀ	ርግ.
ጠንቃቂ	ቅ.
ተጠንቀቀ	ተደ.አ.
ጥንቁቅ	ቅ.
ጥንቁቀ	ተግ.
ጥንቃቄ	ዘዘ.
ጥንቃቅ	ዘዘ.
ጠንቈለ	ግ.
ጠንቋሊ	ቅ.
መጠንቁል	ባቅ.
ጥንቋሌ	ዘዘ.
ጠንትዮን	ስ.
ጠንፍሐ	ግ.
ጠአቀ	ርግ.
ጠወመ	ርግ.
ጠዋሚ	ቅ.
ተጠውመ	ተደ.አ.
ጥዉም	ቅ.
ጥዋሜ	ዘዘ.
ጠወቀ	ርግ.
ተጠውቀ/ተጠወቀ	ተደ.አ.
ጥዉቅ	ቅ.
ጥውቀት	ሳዘ.
ጠወየ	ግ.
ጠዋይ	ቅ.
ጥውየት	ሳዘ.
ጠውስ	ስ.
ጠዐመ/ጥዕመ	ግ.
ጥዑም	ቅ.
ጣዕም	ዘዘ.
ጥዕመት	ሳዘ.
ጠዐወ	ርግ.
ጠዓዊ	ቅ.
መጥዕው	ባቅ.
ጣዕዋ	ዘዘ.
ጣዖት	ባዘ.
አጥዐወ	አስ.አ.
አጥዓዊ	ቅ.
መጥዕው/መጥዓዊ	ባቅ.
ጠየቀ	ግ.
ጥዩቅ	ቅ.
ጥያቄ	ዘዘ.
ጠየረ	ግ.
ተጠየረ	ተደ.አ.
ተጠያሪ	ቅ.
አጠየረ	አድ.አ.
መጠይር	ባቅ.
ጠያር	ዘዘ.
ጠግዐ	ግ.
ጠጋዒ	ቅ.
ጥግዕ	ዘዘ.
ጥግዓት	ሳዘ.
ጠፈር	ስ.
ጠፍልሐ	ርግ.
ጠፋልሕ	ዘዘ.
ጠፍሐ	ርግ.
ጠፍንሐ	ርግ.
ጥፍንሕ	ቅ.
ጠፍንቄስ	ስ.
ጠፍዐ	ግ.
ጥፉዕ	ቅ.
ጡጥ	ስ.
ጢሮስ	ስ.
ጣቃ	ስ.
ጣእጥአ	ኢ/ርግ.
ጥእጡእ	ቅ.
ተጣእጥአ	ተደ.አ.
ጥእጣኤ	ጥዘ.
ጣወር	ስ.
ጣዎስ	ስ.
ጣዕፍ	ስ.
ጣፍያ	ስ.
ጤሜን	ስ.
ጤሰ	ግ.
ጢስ	ዘዘ.
ጤቀለ	ርግ.
ጤበ	ርግ.
ጤዐ	ርግ.
ጥዩዕ	ቅ.
ጤገነ	ግ.
ጤገን	ዘዘ.
ጥልማ	ስ.
ጥልማኮስ	ስ.
ጥሕረ	ግ.
ጥሑር	ቅ.
ጥሕረት	ሳዘ.
ባሕር	ዘዘ.
አጥሐረ	አስ.አ.
ጥምአት	ስ.
ጥራይ	ቅ.
ጥር	ስ.
ጥስን	ስ.
ጥቅ	ቅ.
ጥቀ	ተግ.
ጥቃ	ስ.
ጥቅምት	ስ.
ጥብ	ስ.
ጥነት	ስ.
ጥንፍ	ስ.
ጥንት	ስ.
ጥዕየ	ሥግ.
ጥዑይ	ቅ.
ጥዒና	ባዘ.
አጥዐየ	አድ.አ.
አጥዓዪ	ቅ.
ምጥዓይ	ባቅ.
ጥዕጡዕ	ቅ.
ጥፉሕ	ስ.
ጦመ	ርግ.
ጠዋሚ	ቅ.
ጦመረ	ርግ.
ጦማር	ዘዘ.
ጦዐ	ርግ.
ጠዋዒ	ቅ.
ጰሊስ	ስ.
ጰላንትያ	ስ.
ጰላንዮስ	ስ.
ጰላጢኖስ	ስ.
ጰልንትዮ	ስ.
ጰራልያ	ስ.
ጰራቅሊጦስ	ስ.
ጰርቀመ	ርግ.
ጰርፍርዮና	ስ.
ጰሰደ	ርግ.
ጰሳዲ	ቅ.
ጵስድ	ዘዘ.
ጰስጠመ	ርግ.
ጰንገለ	ርግ.
ጰንጋሊ	ቅ.
ጵንጋሌ	ዘዘ.
ጰንጠቆስጤ	ስ.
ጵጥሮማ	ስ.
ጲላጦስ	ተጸስ.
ጲክሰን	ስ.
ጳራሂ	ስ.
ጳሬኑ	ስ.
ጳስፎርያ	ስ.
ጳኩሚስ	ስ.
ጳውሎስ	ተጸስ.
ጳውቂና	ስ.
ጳዝዮን	ስ.
ጳጉሜን	ስ.
ጳጦስ	ስ.
ጳጳስ	ስ.
ጴልጣስ	ስ.
ጴርካ	ስ.
ጴጥራ	ስ.
ጴጥሮስ	ተጸስ.
ጵልንትያ	ስ.
ጵሩጳጣ	ስ.
ጵሩጳጥቄ	ስ.
ጵራስስ	ስ.
ጵርስቅላ	ስ.
ጵርስፎራ	ስ.
ጵርድክይሴ	ስ.
ጵርፍዮና	ስ.
ጵስጥቂስ	ስ.
ጵጵስና	ስ.
ጶሊስ	ስ.
ጶርዮን	ስ.
ጶደሬ	ስ.
ጸለለ	ኢግ.
ጸላሊ	ቅ.
ጽላል	ዘዘ.
ጸላሎት 	ምዘ.
ምጽላል	ባዘ.
ጸለለ	ርግ.
ጸላሊ	ቅ.
ተጸለለ	ተደ.አ.
ጽሉል	ቅ.
ጽላሌ	ዘዘ.
ጸለበ	ርግ.
ጸላቢ	ቅ.
ጸልቦ	ዘዘ.
ተጸልበ	ተደ.አ.
ጽሉብ	ቅ.
ጸለተ	ርግ.
መጸለት	ባዘ.
ጸለወ	ርግ.
ጽልው	ቅ.
ጸለየ	ርግ.
ጸላዪ	ቅ.
ጸሎት	ምዘ.
መጸልይ	ባቅ.
ጽሌ	ዘዘ.
ጽላት	ምዘ.
ጸለጠ	ርግ.
ጸልመ	ግ.
ጸሊም	ቅ.
ጽሉም	ቅ.
ጽልመት	ሳዘ.
አጽለመ	አድ.አ.
መጽልም	ባቅ.
ጸልሐወ	ርግ.
ጸልሓዊ	ቅ.
ጽልሑት	ምዘ.
ተጸልሐወ	ተደ.አ.
ጽልሕው	ቅ.
ጸልአ	ርግ.
ጸለኢ	ቅ.
ጽልእ	ዘዘ.
ጽልአት	ሳዘ.
ተጸልአ	ተደ.አ.
ጽሉእ	ቅ.
ጸላእት	መድ.
ጸልዐ	ግ.
ጽልዕ	ዘዘ.
ጸሐለ	ርግ.
ጻሕል	ዘዘ.
ምጽሐል	ባዘ.
ጸሐመ	ግ.
ጸሓም	ቅ.
ጽሕም	ዘዘ.
ጸሐረ	ርግ.
ጽሕርት	ምዘ.
ጸሐፈ	ርግ.
ጸሓፊ	ቅ.
ጽሕፈት	ሳዘ.
ጻሕፍ	ዘዘ.
ተጽሕፈ	ተደ.አ.
ጽሑፍ	ቅ.
መጽሐፍ	ባዘ.
መጽሓፍ	ባቅ.
ጸሐፍት	መድ.
ጸመ	ርግ.
ጽሙም	ቅ.
መጽመሚ	ባቅ.
ጸመተ	ግ.
ጽሚት	ዘዘ.
ጽሚተ	ተግ.
ጸመወ	ግ.
ጽምው	ቅ.
ጽማዌ/ጽሙና	ዘዘ.
ጸምላጥ	ቅ.
ጸምሐየ	ሥግ.
ጽምሑይ	ቅ.
ጸምአ	ግ.
ጽሙእ	ቅ.
ጽምእ	ዘዘ.
ጽምአማይ	
ጸረቀ	ርግ.
ጸሪቅ	ዘዘ.
ጸሪቅ	ዘዘ.
ጸረቀ	ርግ.
ጸርቅ	ዘዘ.
ጸረበ	ርግ.
ጸራቢ	ቅ.
ተጸርበ	ተደ.አ.
ጽሩብ	ቅ.
ጸርብ	ዘዘ.
ጽርበት	ሳዘ.
መጽረብ	ባዘ.
ምጽራብ	ባቅ.
ጸረፈ	ርግ.
ጸራፊ	ቅ.
ጽርፈት	ሳዘ.
ተጸርፈ	ተደ.አ.
ጽሩፍ	ቅ.
ጸራኢት	ስ.
ጸርሐ	ርግ.
ጸራሒ	ቅ.
ጽራሕ	ዘዘ.
ጸርሰ	ግ.
ጽርስ/ጽረስ 	ዘዘ.
ጸርአ	ኢግ.
ጽሩእ	ቅ.
ጽርአት	ሳዘ.
ጸርየ	ግ.
ጽሩይ	ቅ.
ጽርየት	ሳዘ.
ጸቈነ	ርግ.
ጸቈን	ዘዘ.
ጽቁንቁን	ስ.
ጸቀወ	ግ.
ጸቃውዕ	ምዘ.
ጸበለ	ግ.
ጽቡል	ቅ.
ጸበል	ዘዘ.
ጸበረ	ኢ/ርግ.
ጽቡር	ቅ.
ጸብር	ዘዘ.
ጸበርት	ስ.
ጸበተ	ግ.
ጸባቲ	ቅ.
ጸብት	ዘዘ.
ጸበ	ኢግ.
ጽቡብ	ቅ.
ጽበት	ሳዘ.
አጽበበ	አድ.አ.
መጽብብ	ባቅ.
ጸበወ	ግ.
ጽብው	ቅ.
ጸበየ	ግ.
ጽቡይ	ቅ.
ጸብሐ	ግ.
ጽባሕ	ዘዘ.
ጽባሓዊ	ቅ.
ጽብሐት	ሳዘ.
ጸብሐ	ርግ.
ጸባሒ	ቅ.
ጸባሕት	ምዘ.
መጸብሕ	ባቅ.
መጸብሓዊ	ቅ.
ጸብሰ	ግ.
ጽቡስ	ቅ.
ጽብሰት	ሳዘ.
ጸብኀ	ግ.
ጸባኂ	ቅ.
ጸብኅ	ዘዘ.
መጽብኅ	ባዘ.
ጸብአ	ኢግ.
ጸባኢ	ቅ.
ጸባኢት	ቅ.
ጸብእ	ዘዘ.
ምጽባእ	ባዘ.
ተጸብአ	ተደ.አ.
ጽቡእ	ቅ.
ጸብዐ	ርግ.
አጽባዕት	ባከዘ.
ጸተመ	ግ.
ጽቱም	ቅ.
ጸታም	ዘዘ.
ጸነሰ	ግ.
ጽኑስ	ቅ.
ተጸነሰ	
ተጽናሰ	ባዘ.
ጽናሴ	ጥዘ.
ጸነ	ግ.
ጸናኒ	ቅ.
ጽነት	ሳዘ.
ጽናኔ	ዘዘ.
አጽነነ	አድ.አ.
ጽኑን	ቅ.
ጸንሐ	ኢግ.
ጸናሒ	ቅ.
ጽኑሕ	ቅ.
ጽንሕ	ዘዘ.
ጽንሐት	ሳዘ.
ጸንሕሐ	ግ.
ጽንሓሕ	ዘዘ.
ጸንበለ	ርግ.
ጸንቢል	ዘዘ.
ጸንአ	ርግ.
ጸናዒ	ቅ.
ጽናዕ	ዘዘ.
ምጽናዕ	ባቅ.
ጸንዐ	ግ.
ጽኑዕ	ቅ.
ጽንዓ	ዘዘ.
ጽንዐት	ሳዘ.
አጽንዐ	አድ.አ.
አጽናዒ	ቅ.
መጽንዕ/መጽንዒ	ባቅ.
ጻንጐለ	ርግ.
ጽንጉል	ዘዘ.
ጸንጐነ	ግ.
ጽንጉን 	ዘዘ.
ጸንግአ	ግ.
ምጽንጋእ	ባዘ.
ጸንጰወ	ርግ.
ጽንጵው	ቅ.
ጸንጸለ	ርግ.
ጸንጻሊ	ቅ.
ጸንጸል	ዘዘ.
ጸንጸነ	ግ.
ጽንጹን	ቅ.
ጽንጽንያ	ምዘ.
ጸንፈር	ስ.
ጸንፈ	ርግ.
ጸናፊ	ቅ.
ጽንፍ	ዘዘ.
ጽንፋዊ	ቅ.
ጸአመ	ግ.
መጽአሞ	ባዘ.
ጸአበ	ርግ.
ጸአቢ	ቅ.
ጽእበት	ሳዘ.
ጸዕአ	ግ.
ጸዓእ	ዘዘ.
ጸክ	ስ.
ጸወበ	ርግ.
ጸዋቢ	ቅ.
ጸውብ	ስ.
ጸውዐ	ርግ.
ጸዋዒ	ቅ.
ጽውዓ	ዘዘ.
ጽዋዔ	ዘዘ.
ተጸውዐ	ተደ.አ.
ጽውዕ	ቅ.
ጽዋዕ	ዘዘ.
ጸዋት	ስ.
ጸዐለ	ርግ.
ጸዓሊ	ቅ.
መጽዕል	ተደ.አ.
ጽዑል	ቅ.
ጽዕለት	ሳዘ.
ጸዐረ	ግ.
ጽዑር	ቅ.
ጻዕር	ዘዘ.
ጻዕረሞት	
መጽዕር	ባቅ.
ጸዐቀ	ግ.
ጽዑቅ	ቅ.
ጻዕቅ	ዘዘ.
አጽአቀ	አስ.አ.
ጸዐነ	ርግ.
ጸዓኒ	ቅ.
መጽዕን	ባቅ.
ተጽዕነ	ተደ.አ.
ጽዑን	ቅ.
መስተጽዕን	ባቅ.
መስተጽዕነፈረስ	
ጸዐደ	ርግ.
ጸዓዲ	ቅ.
ተጽዕደ	ተደ.አ.
ጽዑድ	ቅ.
ጽዕደት	ሳዘ.
ምጽዓድ	ባዘ.
ጸዐጠ	ርግ.
ጸዓጢ	ቅ.
መጽዕጥ	ባቅ.
ተጽዕጠ	ተደ.አ.
ጽዑጥ	ቅ.
ጻዕጥ	ዘዘ.
ጸየቀ/ጼቀ	ግ.
ጸያቂ	ቅ.
ጸየፈ 	ግ.
ጸያፍ	ቅ.
ጸይሕ	ስ.
ጸደለ	ግ.
ጽዱል	ቅ.
ጸዳል	ዘዘ.
አጽደልደለ	ግ.
ጸደናት	ስ.
ጸደና	ስ.
ጸደየ	ግ.
ጸደይ	ዘዘ.
ጸድቀ	ርግ.
ጻድቅ	ቅ.
መጽደቂ	ባቅ.
ጽድቅ	ዘዘ.
ተጸደቀ	ግ.
ተጻዳቂ	ቅ.
ጻድፈ	ግ.
ጽዱፍ	ቅ.
ጸድፍ	ዘዘ.
ጽድፈት	ሳዘ.
ጸገወ	ርግ.
ጸጋዊ	ቅ.
መጸግው	ባቅ.
ጸጋ	ዘዘ.
ተጸገወ	ተደ.አ.
ጽግው	ቅ.
ጽጋዌ	ዘዘ.
ጸገየ	ሥግ.
ጸጋዪ	ቅ.
ጽጉይ	ቅ.
ጽጌ	ዘዘ.
ጸጐረ	ግ.
ጸጓር	ቅ.
ጸጒር	ዘዘ.
ጸጐጐ	ግ.
ጽጐጒ	ዘዘ.
ጸጋም	ስ.
ጸጋማዊ/ጸጋማይ	ቅ.
ጸግበ	ግ.
ጽጉብ	ቅ.
ጽጋብ	ዘዘ.
ጸጥ	ትአ.
ጸጸምር	ስ.
ጸፈረ	ርግ.
ጸፋሪ	ቅ.
ጽፍር	ዘዘ.
ተጸፈረ	ተደ.አ.
ጽፉር	ቅ.
ጸፈቀ	ርግ.
ጽፉቅ	ቅ.
ጽፍቀት	ሳዘ.
ጸፈነ	ርግ.
ተጸፍነ	ተደ.አ.
ጽፉን	ቅ.
ጽፍነት	ሳዘ.
ጸፍነ	ርግ.
ጽፍን	ዘዘ.
ጻፍዐ	ርግ.
ጸፋዒ	ቅ.
ተጸፍዐ	ተደ.አ.
ጽፉዕ	ቅ.
ጽፍዓት	ሳዘ.
ጸፍጸፈ	ርግ.
ጽፍጹፍ	ቅ.
ጸፍጸፍ	ዘዘ.
ጹግ	ስ.
ጺላሕ	ስ.
ጻሕብ	ስ.
ጻሕው	ስ.
ጻሕየየ	ሥግ.
ተጻሕየየ	ተደ.አ.
ጽሕዩይ	ቅ.
ጽሕያይ	ዘዘ.
ጽሕጽሕ	ስ.
ጻእጻእ	ስ.
ጻዕደወ	ሥግ.
ጻዕዳዊ	ቅ.
ጽዕድው	ቅ.
ጽዕዳዌ	ዘዘ.
ጻዐዳ	ቅ.
አጻዕደወ	አድ.አ.
አጻዕዳዊ	ቅ.
ጸዐድዒድ	ቅ.
ጻጹት	ስ.
ጻጾት	ስ.
ጻፄ	ስ.
ጼሐ	ርግ.
ጸያሒ	ቅ.
ጼቃ	ስ.
ጼተሎ	ስ.
ጼናታም	ስ.
ጼአ	ግ.
ጽዩእ	ቅ.
ጺአት	ሳዘ.
ጼዴን	ስ.
ጼዴንያ	ስ.
ጽልሑት	ስ.
ጽልመት	ስ.
ጽልመት ጽፍቅ	
ጽልንትዮ	ስ.
ጽልው	ቅ.
ጽሕርት	ስ.
ጽሕቀ	ርግ.
ጽሑቅ	ቅ.
ጻሕቅ	ዘዘ.
ጽሕወ	ግ.
ጽሕው	ቅ.
ጽሕወት	ሳዘ.
ጽሕደ	ግ.
ጽሑድ	ቅ.
ጽሕደት	ሳዘ.
ጽሕድ	ዘዘ.
ጽርሕ	ስ.
ተጽራሕ 	
ጽሩፊም	ቅ.
ድራግማሠሬ	ስ.
ጽራር	ስ.
ጽርኒ	ስ.
ጽርንእ	ስ.
ጽርንዕት	ስ.
ጽብን	ስ.
ጽነፍ	ስ.
ጽንብል	ስ.
ጽንጽንት	ስ.
ጽንጽንያ	ስ.
ጽዋዕ	ስ.
ጽዕጠ	ግ.
ጽዑጥ	ቅ.
ጽዒጥ	ዘዘ.
ጽዮን	ስ.
ጽጋግ	ስ.
ጽግነት	ስ.
ጽጎ	ስ.
ጽፍሕ	ስ.
ጽፍነት	ስ.
ጾሀር	ስ.
ጾላዕ	ስ.
ጾመ	ርግ.
ጸዋሚ	ቅ.
ጽዉም	ቅ.
ጾም	ዘዘ.
ጾማዕት	ስ.
ፀሐሰ	ግ.
ፀሐሲ	ቅ.
ፃሕስ	ዘዘ.
አፅሐሰ	አሰ.አ.
መፅሕስ	ባቅ.
ፀሐይ	ስ.
ፀመረ	ርግ.
ፀማሪ	ቅ.
ፅሙር	ቅ.
ፅምረት	ሳዘ.
ፅማሬ 	ዘዘ.
መፅምር	ባቅ.
መፅምርት	ባከዘ.
አስተፃመረ	አስ.አ.
መስተፃምር	ባቅ.
ፀምር	ዘዘ.
ፀመርት	ስ.
ፀመደ	ርግ.
ፀማዲ	ቅ.
ተፀምደ	ተደ.አ.
ፅሙድ	ቅ.
ፀማድ	ቅ.
ፅምድ	ዘዘ.
ፀረረ	ግ.
ፀራሪ	ቅ.
ፅሩር	ቅ.
ፀር	ዘዘ.
ፀራዊ	ቅ.
አስተፃረረ	አስ.አ.
መስተፃርር	ባቅ.
ፀርሰ	ኢግ.
ፅርስ	ዘዘ.
ፀረፈ	ርግ.
ፀራፊ	ቅ.
ፅርፈት	ሳዘ.
ተፀርፈ	ተደ.አ.
ፅሩፍ	ቅ.
ፀበጠ	ርግ.
ፀባጢ	ቅ.
ፀብጥ	ዘዘ.
ተፀብጠ	ተደ.አ.
ፅቡጥ	ቅ.
ፀብሰ	ግ.
ፅቡስ	ቅ.
ፅብስ	ዘዘ.
ፅብሰት	ሳዘ.
ፀንሰ	ርግ.
ፀናሲ	ቅ.
ፅንስ	ዘዘ.
ፅንሰት	ሳዘ.
ተፀንሰ	ተደ.አ.
ፅኑስ	ቅ.
ፀንግዐ	ኢግ.
ምፅንጋዕ	ባዘ.
ፀወገ	ኢግ.
ፀዋግ	ቅ.
ፅዉግ	ቅ.
ፁግ	ዘዘ.
ፁገት	ሳዘ.
ፀወሰ	ግ.
ፅዉስ	ቅ.
ፀገመ	ግ.
ፀጋም	ዘዘ.
ፅግም	ዘዘ.
ፀጋማዊ	ቅ.
ፀግዐ	ግ.
ፀጋዒ	ቅ.
ፅጉዕ	ቅ.
ፅግዕ	ዘዘ.
አፅግዐ	አስ.አ.
ምፅጋዓ	ባቅ.
ምፃጉዕ	ባዘ.
ፀፈረ	ርግ.
ፀፋሪ	ቅ.
ተፀፍረ	ተደ.አ.
ፅፉር	ቅ.
ፅፍረት	ሳዘ.
ፅፍሮ	ዘዘ.
መፅፈርት	ባከ.
ፃመወ	ሥግ.
ፃማዊ	ቅ.
ፃማ	ዘዘ.
ፄነወ	ግ.
ፄና	ዘዘ.
ፄናዊ	ቅ.
ፄወወ	ሥግ.
ፄዋዊ	ቅ.
ፄዋ	ዘዘ.
ተፄወወ	ተደ.አ.
ፂዉው	ቅ.
ፄዋዌ	ዘዘ.
ፄው	ስ.
ፅሕየ	ግ.
ፀሐይ	ዘዘ.
ፆረ	ርግ.
ፀዋረ	ቅ.
ፆር	ዘዘ.
ተፀውረ	ተደ.አ.
ፀመርት	መድ.ቅ.
ፀወርተመንበር	
ፃታ	ስ.
ፈሀቀ	ግ.
ፈሃቂ	
ፋህቅ	ዘዘ.
ፈለሰ	ኢ/ርግ.
ፈላሲ	ቅ.
ፍሉስ	ቅ.
ፍልሰት	ሳዘ.
መፍልስ	ባቅ.
መፍልስት	ባከዘ.
ፍልስጥኤም	
ፍልስጥኤማዊ	ቅ.
ፈለቀ	ግ.
ፈላቂ	ቅ.
ፈለከ	ርግ.
ፈለክ	ዘዘ.
ፋሌክ	ስ.
ፈለየ	ግ.
ፈለገ	ርግ.
ፍሉግ	ቅ.
ፈለግ	ዘዘ.
ፈለጠ	ርግ.
ተፈልጠ	ተደ.አ.
ፍሉጥ	ቅ.
ፍልጣን	ምዘ.
ፈለጸ	ርግ.
ፈላጺ	ቅ.
ፍልጽ	ዘዘ.
ፈልሐ	ግ.
ፍሉሕ	ቅ.
ፍልሐት	ሳዘ.
መፍልሕ	ባቅ.
ፈልሰፈ	ግ.
ፍልሱፍ	ቅ.
ፈላስፋ/ፊሎሶፍ	ስ.
ፍልሳፌ	ዘዘ.
ፈልፈለ	ርግ.
ፈልፈል	ዘዘ.
ፈሐለ	ግ.
ፈሓሊ	ቅ.
ፍሑል	ቅ.
ፈሓል/ፍሕል	ዘዘ.
ፈሐረ	ርግ.
ፈሓሪ	ቅ.
ተፍሕረ	ተደ.አ.
ፍሑር	ቅ.
ፈሐሰ	ርግ/
ፈሓሲ	ቅ.
ተፍሕሰ	ተደ.አ.
ፍሑስ	ቅ.
ፍሕሶ	ዘዘ.
ፈሐቀ	ርግ.
ፈሓቂ	ቅ.
ተፍሕቀ	ተደ.አ.
ፍሑቅ	ቅ.
ምፍሓቅ	ባቅ.
ፈሐጠ	ርግ.
ፈሓጢ	ቅ.
ፈረሰ	ርግ.
ፈረስ	ዘዘ.
ፈረሳዊ	ቅ.
ፈሪሳዊ	ቅ.
ፈረቀ	ርግ.
ፈራቂ	ቅ.
ፍርቃን	ባዘ.
አፍራቅያ	ባከዘ.
ተፈርቀ	ተደ.አ
ፍሩቅ	ቅ.
ፈርቅ	ዘዘ.
ፈርየ	ርግ.
ፈራዪ	ቅ.
ፍርየት	ሳዘ.
ፍሬ	ዘዘ.
ፈረደ	ርግ.
ፈራዲ	ቅ.
ፍርድ	ዘዘ.
ፈርድ	ዘዘ.
ፈረደ	ርግ.
ፈርድ	ዘዘ.
ፈርሀ	ግ.
ፈራሂ/ፈራህ	ቅ.
ፍርሀት	ሳዘ.
ተፈርሀ	ተደ.አ.
ፍሩህ	ቅ.
አፍርሀ	አሰ.አ.
መፍርህ/መፍርሂ	ቅ.
ፈርነሰ	ርግ.
ፈርናሲ	
ተፈርነስ	ተደ.አ.
ፍርኑስ	ቅ.
ፍራንስ	
ፍርከሊስ	ስ.
ፍርዐጸ	ግ.
ፍርዑጽ	ቅ.
ነፈርዓጽ	ባዘ.
ፈርዐጽ	ስ.
ፈርዘዘ	ርግ.
ፍርዙዝ	ቅ.
ፍርዛዜ	ዘዘ.
ፍርዝ	ዘዘ.
ፈርፈረ	ርግ.
ፍርፍር	ዘዘ.
ፈርገገ	ግ.
ፈርገግ	ዘዘ.
ፈሰሰ 	ግ.
ፈሳሲ	ቅ.
ፈሰስ	ዘዘ.
ተፋሰሰ	ተደ.አ.
ፋስ	ስ.
ፈሰወ	ግ.
ፈሰው/ፈስው 	ዘዘ.
ፈቀረ	ግ.
ፈቀደ	ርግ.
ፈቃዲ	ቅ.
ተፈቅደ	ተደ.አ.
ፍቁድ	ቅ.
ፈቃድ	ዘዘ.
ፈቃደሥጋ	
መፍቅድ	ባዘ.
ፈቅዐ	ርግ.
ፈቃዒ	ቅ.
ተፈቅዐ	ተደ.አ.
ፍቁዕ	ቅ.
ፍቅዓት	ሳዘ.
ፈተለ	ርግ.
ፈታሊ	ቅ.
ተፈትለ	ተደ.አ.
ፍቱል	ቅ.
ፍትለት	ሳዘ.
ፈትል	ዘዘ.
ፈተተ	ርግ.
ፈታቲ	ቅ.
ተፈተተ	ተደ.አ.
ፍቱት	ቅ.
ፍታቴ	ዘዘ.
ፍት	ዘዘ.
ፈተነ	ርግ.
ፈታኒ	ቅ.
መፍተኒ	ባቅ.
ተፈትነ	ተደ.አ.
ፍቱን	ቅ.
ፍትነት	ሳዘ.
ፈተና	ዘዘ.
ፈተወ	ርግ.
ፈታዊ	ቅ.
ተፈትወ	ተደ.አ.
ፍትው	ቅ.
ፍትወት	ሳዘ.
ፍትወታዊ	ቅ.
መፍትው	ባቅ.
ፈትሐ	ርግ.
ፈታሒ	ቅ.
መፍትሒ	ባቅ.
መፍትሕ	ባቅ.
ፍትሕ	ዘዘ.
ፍትሐነገሥት	
ፍትሐት	ሳዘ.
ተፈትሐ	ተደ.አ.
ፍቱሕ	ቅ.
ፈኀረ	ርግ.
ፈኃሪ	ቅ.
ተፍኅረ	ተደ.አ.
ፍኁር	ቅ.
ፍኅረት	ሳዘ.
ፈነወ	ርግ.
ፈናዊ	ቅ.
ተፈነወ	ተደ.አ.
ፍንው	ቅ.
ፍናዌ	ዘዘ.
ፍና	ዘዘ.
ፍኖት	ምዘ.
ፈንቀለ	ርግ.
ፈንጻጻ	ስ.
ፈአመ	ርግ.
ፈአሚ	ቅ.
ተፍእመ	ተደ.አ.
ፍኡም	ቅ.
ፋእም	ዘዘ.
ፈከረ	ርግ.
ፈካሪ	ቅ.
መፈክር	ባቅ.
ፍካሬ	ዘዘ.
ፍካሬኢየሱስ	ጥቃ.
ፍካሬከዋክብት	
ፈወሰ	ርግ.
ፈዋሲ	ቅ.
መፈውስ	ባቅ.
ፈውስ	ዘዘ.
ተፈወሰ	ተደ.አ.
ፍዉስ	ቅ.
ፈዋ	ስ.
ፈዐቀ	ግ.
ፈዐወ	ግ.
ፈየተ	ርግ.
ፈያት	ቅ.
ፈያታዊ	ቅ.
ምፍያት	ባዘ.
ፈደለ	ርግ.
ፊደል	ዘዘ.
ፈደየ	ርግ.
ደዳዪ	ቅ.
መፍዴ	ባዘ.
ምፍዳይ	ባዘ.
ተፈድየ	ተደ.አ.
ፍድየት	ሳዘ.
ፍዳ	ዘዘ.
ፍዳ 	መዋ.
ፈድፈደ	ኢግ.
ፍድፉድ	ቅ.
ፍድፋዴ	ዘዘ.
ፍድፍድና	ዘዘ.
ፊድፋደ	ተግ.
አፈድፈደ	አድ.አ.
መፈድፍድ	ባቅ.
ፈገረ	ግ.
ፈገገ	ግ.
ፍጉግ	ቅ.
ፍገግ	ዘዘ.
ፈገ	ግ.
ፈግዐ	ግ.
ፍጉዕ	ቅ.
ፈጊዕ	ዘዘ.
ፍግዕ	ዘዘ.
ትፍግዕት	ባከዘ.
ፍግዓ	ዘዘ.
ፈጠረ	ርግ.
ፈጣሪ	ቅ.
ተፈጥረ	ተደ.አ.
ፍጡር	ቅ.
ፍጥረት	ሳዘ.
ፍጥረታዊ	ቅ.
ፈጠራ	ዘዘ.
ፈጠራዊ	ቅ.
ምፍጣር	ባቅ.
ፈጠነ	ኢግ.
ፈጣን	ቅ.
ፍጡን	ቅ.
ፍጡነ	ተግ.
ፍጥነት	ሳዘ.
መፍጠኒ	ባቅ.
አፍጠነ	አስ.አ
አፍጣኒ	ቅ.
አስተፋጠነ	አስ.አ.
መስተፋጥን 	ባቅ.
ፈጸመ	ርግ.
ፈጻሚ	ርግ.
መፈጽም	ባቅ.
ተፈጸመ	ተደ.አ.
ፍጹም	ቅ.
ድጹመ	ተግ.
ፍጹምና	ዘዘ.
ፍጻሜ	ዘዘ.
ተፍጻም/ተፍጻሜት	ባከ.
ፍጽም	ዘዘ.
ፈጽሐ	ርግ.
መፍጽሕ	ባዘ.
ፈፀመ	ርግ.
ፈፃሚ	ቅ.
ተፈፅመ	ተደ.አ.
ፍፁም	ቅ.
ፈፀነ	ርግ.
ፈፃኒ	ቅ.
ፈፀንት	ምዘ.
ፉል	ስ.
ፊላቅ	ስ.
ፊልሞን	ስ.
ፊልጶስ	ተጸ.ስ
ፊሎን	ስ.
ፊቃር	ስ.
ፊኒቆን	ስ.
ፊንቆን	ስ.
ፊካትም	ስ.
ፍል	ስ.
ፍልስ	ስ.
ፋሎ	ስ.
ፋርስ	ስ.
ፋርሳዊ	
ፋርን	ስ.
ፋሲካ	ስ.
ፋዚቅ	ስ.
ፋጸየ	ግ.
ፋጻ	ዘዘ.
ተፋጸየ	ተደ.አ.
ፌልቲ	ስ.
ፌማ	ስ.
ፌቃፅ	ስ.
ፌንሙ	ስ.
ፌጎር	ስ.
ፌጠ	ግ.
ፈያጢ	ቅ.
ፍልፍል	ስ.
ፍሕለ	ግ.
ፍሕመ	ግ.
ፍሕም	ዘዘ.
ፍሕሶ	ስ.
ፍራንስ	ስ.
ፍርም	ስ.
ፍርፍርት	ስ.
ፍቅር	ስ.
ፍንዱቅ	ስ.
ፍንድ	ስ.
ፍንጋ	ቅ.
ፍንፍንት	ስ.
ፍያል	ስ.
ፍግዓ	ስ.
ፍጻሜ	ስ.
ፍጽም	ስ.
ፎሐ	ርግ.
ፎቃንስ	ስ.
ፎንቃስ	ስ.
ፎዘ	ርግ.
ፈያዚ	ቅ.
ፎደት	ስ.
ፐፒረለይ	ስ.
ፐፒራ	ስ.
ፒሉፖዴር	ተጸ.ስ
ፒላስ	ስ.
ፒርልዩ	ስ.
ፒሳ	ስ.
ፓሲካ	ስ.
ፓትርያርክ	
ፓና	ስ.
ፓፒራ	ስ.
ፓፓ	ስ.
ፔ	ስ.
ፔልስጦስ	ስ.
ፔንሙ	ስ.
ፔካ	ስ.
ፕስልቴ	ስ.
ፕንትዮስ	ስ.
ፕፕሬ	ስ.
